Disease,City,State,Date,Population_Affected,Number_of_Deaths,Survived,Doctors_Available,Hospitals_Available
Heat Stroke,Amritsar,Punjab,2018-01-01,3264,158,3106,45,5
Heat Stroke,Amritsar,Punjab,2018-02-01,2412,29,2383,52,8
Heat Stroke,Amritsar,Punjab,2018-03-01,3466,261,3205,126,9
Heat Stroke,Amritsar,Punjab,2018-04-01,4641,332,4309,160,4
Heat Stroke,Amritsar,Punjab,2018-05-01,2283,69,2214,159,7
Heat Stroke,Amritsar,Punjab,2018-06-01,2283,161,2122,55,8
Heat Stroke,Amritsar,Punjab,2018-07-01,4716,287,4429,157,5
Heat Stroke,Amritsar,Punjab,2018-08-01,3627,46,3581,16,10
Heat Stroke,Amritsar,Punjab,2018-09-01,1968,49,1919,96,8
Heat Stroke,Amritsar,Punjab,2018-10-01,3325,276,3049,131,3
Heat Stroke,Amritsar,Punjab,2018-11-01,1976,116,1860,11,6
Heat Stroke,Amritsar,Punjab,2018-12-01,1973,66,1907,200,7
Heat Stroke,Amritsar,Punjab,2019-01-01,2922,73,2849,174,10
Heat Stroke,Amritsar,Punjab,2019-02-01,78,0,78,139,7
Heat Stroke,Amritsar,Punjab,2019-03-01,283,10,273,57,6
Heat Stroke,Amritsar,Punjab,2019-04-01,1843,46,1797,103,8
Heat Stroke,Amritsar,Punjab,2019-05-01,1239,0,1239,146,4
Heat Stroke,Amritsar,Punjab,2019-06-01,3019,251,2768,49,2
Heat Stroke,Amritsar,Punjab,2019-07-01,1379,108,1271,97,7
Heat Stroke,Amritsar,Punjab,2019-08-01,703,9,694,153,4
Heat Stroke,Amritsar,Punjab,2019-09-01,4564,246,4318,30,10
Heat Stroke,Amritsar,Punjab,2019-10-01,2295,54,2241,123,6
Heat Stroke,Amritsar,Punjab,2019-11-01,2688,114,2574,17,7
Heat Stroke,Amritsar,Punjab,2019-12-01,686,27,659,58,3
Heat Stroke,Amritsar,Punjab,2020-01-01,1867,70,1797,81,8
Heat Stroke,Amritsar,Punjab,2020-02-01,2746,297,2449,132,5
Heat Stroke,Amritsar,Punjab,2020-03-01,1053,39,1014,71,4
Heat Stroke,Amritsar,Punjab,2020-04-01,3101,82,3019,113,5
Heat Stroke,Amritsar,Punjab,2020-05-01,1792,49,1743,71,1
Heat Stroke,Amritsar,Punjab,2020-06-01,2206,177,2029,79,4
Heat Stroke,Amritsar,Punjab,2020-07-01,1790,3,1787,170,6
Heat Stroke,Amritsar,Punjab,2020-08-01,4989,139,4850,48,1
Heat Stroke,Amritsar,Punjab,2020-09-01,2579,237,2342,145,8
Heat Stroke,Amritsar,Punjab,2020-10-01,1178,67,1111,106,4
Heat Stroke,Amritsar,Punjab,2020-11-01,3701,205,3496,77,6
Heat Stroke,Amritsar,Punjab,2020-12-01,960,107,853,44,1
Heat Stroke,Amritsar,Punjab,2021-01-01,2878,164,2714,48,5
Heat Stroke,Amritsar,Punjab,2021-02-01,78,0,78,69,2
Heat Stroke,Amritsar,Punjab,2021-03-01,816,34,782,99,4
Heat Stroke,Amritsar,Punjab,2021-04-01,2861,48,2813,137,1
Heat Stroke,Amritsar,Punjab,2021-05-01,3588,310,3278,91,2
Heat Stroke,Amritsar,Punjab,2021-06-01,2827,188,2639,94,4
Heat Stroke,Amritsar,Punjab,2021-07-01,2442,202,2240,102,4
Heat Stroke,Amritsar,Punjab,2021-08-01,2193,187,2006,131,7
Heat Stroke,Amritsar,Punjab,2021-09-01,614,23,591,139,1
Heat Stroke,Amritsar,Punjab,2021-10-01,1632,36,1596,36,5
Heat Stroke,Amritsar,Punjab,2021-11-01,1979,96,1883,92,5
Heat Stroke,Amritsar,Punjab,2021-12-01,4016,99,3917,169,3
Heat Stroke,Amritsar,Punjab,2022-01-01,3058,167,2891,39,2
Heat Stroke,Amritsar,Punjab,2022-02-01,232,19,213,110,8
Heat Stroke,Amritsar,Punjab,2022-03-01,3032,136,2896,98,10
Heat Stroke,Amritsar,Punjab,2022-04-01,2081,113,1968,77,1
Heat Stroke,Amritsar,Punjab,2022-05-01,1689,79,1610,187,2
Heat Stroke,Amritsar,Punjab,2022-06-01,3418,250,3168,108,2
Heat Stroke,Amritsar,Punjab,2022-07-01,3980,121,3859,183,4
Heat Stroke,Amritsar,Punjab,2022-08-01,3847,0,3847,106,8
Heat Stroke,Amritsar,Punjab,2022-09-01,1472,93,1379,130,6
Heat Stroke,Amritsar,Punjab,2022-10-01,2183,172,2011,77,4
Heat Stroke,Amritsar,Punjab,2022-11-01,3042,191,2851,77,5
Heat Stroke,Amritsar,Punjab,2022-12-01,3906,122,3784,127,4
Heat Stroke,Amritsar,Punjab,2023-01-01,1955,33,1922,128,7
Heat Stroke,Amritsar,Punjab,2023-02-01,2348,151,2197,137,7
Heat Stroke,Amritsar,Punjab,2023-03-01,1113,60,1053,125,7
Heat Stroke,Amritsar,Punjab,2023-04-01,993,46,947,38,1
Heat Stroke,Amritsar,Punjab,2023-05-01,3687,380,3307,65,5
Heat Stroke,Amritsar,Punjab,2023-06-01,4417,99,4318,150,4
Heat Stroke,Amritsar,Punjab,2023-07-01,2501,254,2247,11,8
Heat Stroke,Amritsar,Punjab,2023-08-01,3944,201,3743,121,6
Heat Stroke,Amritsar,Punjab,2023-09-01,3083,0,3083,101,6
Heat Stroke,Amritsar,Punjab,2023-10-01,1732,77,1655,149,3
Heat Stroke,Amritsar,Punjab,2023-11-01,3082,240,2842,127,8
Heat Stroke,Amritsar,Punjab,2023-12-01,4661,183,4478,72,8
Heat Stroke,Amritsar,Punjab,2024-01-01,2549,18,2531,70,1
Heat Stroke,Amritsar,Punjab,2024-02-01,4696,212,4484,80,1
Heat Stroke,Amritsar,Punjab,2024-03-01,78,0,78,136,7
Heat Stroke,Amritsar,Punjab,2024-04-01,3700,238,3462,11,4
Heat Stroke,Amritsar,Punjab,2024-05-01,2714,196,2518,114,8
Heat Stroke,Amritsar,Punjab,2024-06-01,2196,42,2154,61,6
Heat Stroke,Amritsar,Punjab,2024-07-01,2721,80,2641,116,7
Heat Stroke,Amritsar,Punjab,2024-08-01,78,0,78,124,3
Heat Stroke,Amritsar,Punjab,2024-09-01,2303,57,2246,22,6
Heat Stroke,Amritsar,Punjab,2024-10-01,3076,57,3019,95,6
Heat Stroke,Amritsar,Punjab,2024-11-01,4580,72,4508,114,3
Heat Stroke,Amritsar,Punjab,2024-12-01,1902,114,1788,111,8
Heat Stroke,Amritsar,Punjab,2025-01-01,1513,89,1424,100,1
Heat Stroke,Amritsar,Punjab,2025-02-01,1924,58,1866,44,5
Heat Stroke,Amritsar,Punjab,2025-03-01,3825,192,3633,52,1
Heat Stroke,Amritsar,Punjab,2025-04-01,3038,287,2751,36,2
Heat Stroke,Amritsar,Punjab,2025-05-01,1887,40,1847,134,8
Heat Stroke,Amritsar,Punjab,2025-06-01,3286,0,3286,100,2
Heat Stroke,Amritsar,Punjab,2025-07-01,2728,172,2556,104,2
Heat Stroke,Amritsar,Punjab,2025-08-01,3897,182,3715,19,7
Heat Stroke,Amritsar,Punjab,2025-09-01,1656,48,1608,104,2
Heat Stroke,Amritsar,Punjab,2025-10-01,2158,149,2009,138,8
Heat Stroke,Amritsar,Punjab,2025-11-01,2071,154,1917,12,7
Heat Stroke,Amritsar,Punjab,2025-12-01,634,0,634,79,3
Heat Stroke,Amritsar,Chandigarh,2018-01-01,2995,93,2902,26,8
Heat Stroke,Amritsar,Chandigarh,2018-02-01,2948,346,2602,85,1
Heat Stroke,Amritsar,Chandigarh,2018-03-01,2604,174,2430,60,6
Heat Stroke,Amritsar,Chandigarh,2018-04-01,2283,159,2124,126,1
Heat Stroke,Amritsar,Chandigarh,2018-05-01,699,58,641,115,3
Heat Stroke,Amritsar,Chandigarh,2018-06-01,2033,102,1931,172,3
Heat Stroke,Amritsar,Chandigarh,2018-07-01,2138,156,1982,103,9
Heat Stroke,Amritsar,Chandigarh,2018-08-01,1521,107,1414,123,3
Heat Stroke,Amritsar,Chandigarh,2018-09-01,2381,156,2225,78,5
Heat Stroke,Amritsar,Chandigarh,2018-10-01,3139,127,3012,50,4
Heat Stroke,Amritsar,Chandigarh,2018-11-01,4989,274,4715,149,2
Heat Stroke,Amritsar,Chandigarh,2018-12-01,2832,93,2739,170,2
Heat Stroke,Amritsar,Chandigarh,2019-01-01,2943,148,2795,142,6
Heat Stroke,Amritsar,Chandigarh,2019-02-01,2498,40,2458,113,5
Heat Stroke,Amritsar,Chandigarh,2019-03-01,78,0,78,57,7
Heat Stroke,Amritsar,Chandigarh,2019-04-01,2562,107,2455,164,4
Heat Stroke,Amritsar,Chandigarh,2019-05-01,2678,60,2618,136,4
Heat Stroke,Amritsar,Chandigarh,2019-06-01,4989,176,4813,200,7
Heat Stroke,Amritsar,Chandigarh,2019-07-01,2339,105,2234,47,4
Heat Stroke,Amritsar,Chandigarh,2019-08-01,3002,185,2817,150,1
Heat Stroke,Amritsar,Chandigarh,2019-09-01,2551,198,2353,134,7
Heat Stroke,Amritsar,Chandigarh,2019-10-01,1030,37,993,89,3
Heat Stroke,Amritsar,Chandigarh,2019-11-01,4131,367,3764,176,5
Heat Stroke,Amritsar,Chandigarh,2019-12-01,3606,279,3327,127,3
Heat Stroke,Amritsar,Chandigarh,2020-01-01,3659,236,3423,58,2
Heat Stroke,Amritsar,Chandigarh,2020-02-01,1377,75,1302,100,1
Heat Stroke,Amritsar,Chandigarh,2020-03-01,4479,265,4214,58,6
Heat Stroke,Amritsar,Chandigarh,2020-04-01,717,60,657,82,1
Heat Stroke,Amritsar,Chandigarh,2020-05-01,3385,290,3095,142,9
Heat Stroke,Amritsar,Chandigarh,2020-06-01,4989,442,4547,157,8
Heat Stroke,Amritsar,Chandigarh,2020-07-01,1269,65,1204,117,2
Heat Stroke,Amritsar,Chandigarh,2020-08-01,1838,121,1717,68,9
Heat Stroke,Amritsar,Chandigarh,2020-09-01,2731,243,2488,126,10
Heat Stroke,Amritsar,Chandigarh,2020-10-01,1922,61,1861,143,4
Heat Stroke,Amritsar,Chandigarh,2020-11-01,517,21,496,11,6
Heat Stroke,Amritsar,Chandigarh,2020-12-01,2689,135,2554,112,5
Heat Stroke,Amritsar,Chandigarh,2021-01-01,1172,89,1083,97,9
Heat Stroke,Amritsar,Chandigarh,2021-02-01,3233,247,2986,155,1
Heat Stroke,Amritsar,Chandigarh,2021-03-01,1364,59,1305,126,4
Heat Stroke,Amritsar,Chandigarh,2021-04-01,4677,28,4649,131,7
Heat Stroke,Amritsar,Chandigarh,2021-05-01,1547,88,1459,82,7
Heat Stroke,Amritsar,Chandigarh,2021-06-01,2165,50,2115,106,5
Heat Stroke,Amritsar,Chandigarh,2021-07-01,3689,24,3665,154,9
Heat Stroke,Amritsar,Chandigarh,2021-08-01,946,12,934,103,5
Heat Stroke,Amritsar,Chandigarh,2021-09-01,2903,172,2731,115,5
Heat Stroke,Amritsar,Chandigarh,2021-10-01,4351,390,3961,28,7
Heat Stroke,Amritsar,Chandigarh,2021-11-01,441,22,419,103,5
Heat Stroke,Amritsar,Chandigarh,2021-12-01,2845,159,2686,11,5
Heat Stroke,Amritsar,Chandigarh,2022-01-01,2946,248,2698,80,3
Heat Stroke,Amritsar,Chandigarh,2022-02-01,3646,18,3628,109,10
Heat Stroke,Amritsar,Chandigarh,2022-03-01,938,61,877,145,3
Heat Stroke,Amritsar,Chandigarh,2022-04-01,826,41,785,55,7
Heat Stroke,Amritsar,Chandigarh,2022-05-01,3298,219,3079,125,10
Heat Stroke,Amritsar,Chandigarh,2022-06-01,2996,107,2889,181,1
Heat Stroke,Amritsar,Chandigarh,2022-07-01,2933,77,2856,74,7
Heat Stroke,Amritsar,Chandigarh,2022-08-01,3062,165,2897,27,5
Heat Stroke,Amritsar,Chandigarh,2022-09-01,1685,165,1520,121,10
Heat Stroke,Amritsar,Chandigarh,2022-10-01,2909,218,2691,45,2
Heat Stroke,Amritsar,Chandigarh,2022-11-01,2991,105,2886,64,3
Heat Stroke,Amritsar,Chandigarh,2022-12-01,1639,18,1621,153,5
Heat Stroke,Amritsar,Chandigarh,2023-01-01,4989,20,4969,200,3
Heat Stroke,Amritsar,Chandigarh,2023-02-01,3233,285,2948,55,3
Heat Stroke,Amritsar,Chandigarh,2023-03-01,999,22,977,69,10
Heat Stroke,Amritsar,Chandigarh,2023-04-01,3478,141,3337,84,5
Heat Stroke,Amritsar,Chandigarh,2023-05-01,1290,114,1176,78,3
Heat Stroke,Amritsar,Chandigarh,2023-06-01,3653,11,3642,200,4
Heat Stroke,Amritsar,Chandigarh,2023-07-01,4152,388,3764,79,6
Heat Stroke,Amritsar,Chandigarh,2023-08-01,1496,63,1433,86,6
Heat Stroke,Amritsar,Chandigarh,2023-09-01,3890,64,3826,189,3
Heat Stroke,Amritsar,Chandigarh,2023-10-01,3151,135,3016,136,1
Heat Stroke,Amritsar,Chandigarh,2023-11-01,3700,107,3593,156,5
Heat Stroke,Amritsar,Chandigarh,2023-12-01,4989,313,4676,60,5
Heat Stroke,Amritsar,Chandigarh,2024-01-01,2268,70,2198,79,3
Heat Stroke,Amritsar,Chandigarh,2024-02-01,1586,0,1586,53,9
Heat Stroke,Amritsar,Chandigarh,2024-03-01,1404,61,1343,147,6
Heat Stroke,Amritsar,Chandigarh,2024-04-01,1503,15,1488,169,5
Heat Stroke,Amritsar,Chandigarh,2024-05-01,2494,139,2355,76,4
Heat Stroke,Amritsar,Chandigarh,2024-06-01,3055,47,3008,88,10
Heat Stroke,Amritsar,Chandigarh,2024-07-01,2969,106,2863,90,1
Heat Stroke,Amritsar,Chandigarh,2024-08-01,3707,205,3502,27,3
Heat Stroke,Amritsar,Chandigarh,2024-09-01,2615,114,2501,72,4
Heat Stroke,Amritsar,Chandigarh,2024-10-01,4547,260,4287,146,6
Heat Stroke,Amritsar,Chandigarh,2024-11-01,2242,156,2086,62,7
Heat Stroke,Amritsar,Chandigarh,2024-12-01,4989,81,4908,111,1
Heat Stroke,Amritsar,Chandigarh,2025-01-01,3437,165,3272,40,3
Heat Stroke,Amritsar,Chandigarh,2025-02-01,1448,0,1448,99,6
Heat Stroke,Amritsar,Chandigarh,2025-03-01,1161,66,1095,78,3
Heat Stroke,Amritsar,Chandigarh,2025-04-01,3245,134,3111,44,4
Heat Stroke,Amritsar,Chandigarh,2025-05-01,2298,49,2249,146,5
Heat Stroke,Amritsar,Chandigarh,2025-06-01,3555,210,3345,149,2
Heat Stroke,Amritsar,Chandigarh,2025-07-01,3232,272,2960,57,6
Heat Stroke,Amritsar,Chandigarh,2025-08-01,2500,90,2410,95,7
Heat Stroke,Amritsar,Chandigarh,2025-09-01,1461,32,1429,108,5
Heat Stroke,Amritsar,Chandigarh,2025-10-01,565,31,534,14,9
Heat Stroke,Amritsar,Chandigarh,2025-11-01,1998,22,1976,35,7
Heat Stroke,Amritsar,Chandigarh,2025-12-01,3746,115,3631,172,5
Heat Stroke,Amritsar,Himachal Pradesh,2018-01-01,2885,247,2638,52,4
Heat Stroke,Amritsar,Himachal Pradesh,2018-02-01,926,48,878,170,10
Heat Stroke,Amritsar,Himachal Pradesh,2018-03-01,2830,0,2830,38,3
Heat Stroke,Amritsar,Himachal Pradesh,2018-04-01,3114,0,3114,140,4
Heat Stroke,Amritsar,Himachal Pradesh,2018-05-01,1412,77,1335,90,4
Heat Stroke,Amritsar,Himachal Pradesh,2018-06-01,2804,210,2594,98,6
Heat Stroke,Amritsar,Himachal Pradesh,2018-07-01,2675,8,2667,200,10
Heat Stroke,Amritsar,Himachal Pradesh,2018-08-01,1064,67,997,42,6
Heat Stroke,Amritsar,Himachal Pradesh,2018-09-01,3077,273,2804,137,4
Heat Stroke,Amritsar,Himachal Pradesh,2018-10-01,3350,351,2999,134,5
Heat Stroke,Amritsar,Himachal Pradesh,2018-11-01,4050,241,3809,200,1
Heat Stroke,Amritsar,Himachal Pradesh,2018-12-01,4011,259,3752,51,4
Heat Stroke,Amritsar,Himachal Pradesh,2019-01-01,749,0,749,74,10
Heat Stroke,Amritsar,Himachal Pradesh,2019-02-01,1339,148,1191,148,7
Heat Stroke,Amritsar,Himachal Pradesh,2019-03-01,3288,109,3179,96,8
Heat Stroke,Amritsar,Himachal Pradesh,2019-04-01,3287,75,3212,83,8
Heat Stroke,Amritsar,Himachal Pradesh,2019-05-01,3288,140,3148,155,3
Heat Stroke,Amritsar,Himachal Pradesh,2019-06-01,4989,442,4547,93,10
Heat Stroke,Amritsar,Himachal Pradesh,2019-07-01,3363,384,2979,61,1
Heat Stroke,Amritsar,Himachal Pradesh,2019-08-01,4121,221,3900,143,6
Heat Stroke,Amritsar,Himachal Pradesh,2019-09-01,3877,306,3571,125,1
Heat Stroke,Amritsar,Himachal Pradesh,2019-10-01,3471,178,3293,90,1
Heat Stroke,Amritsar,Himachal Pradesh,2019-11-01,2174,43,2131,88,8
Heat Stroke,Amritsar,Himachal Pradesh,2019-12-01,3616,336,3280,60,3
Heat Stroke,Amritsar,Himachal Pradesh,2020-01-01,1561,49,1512,143,8
Heat Stroke,Amritsar,Himachal Pradesh,2020-02-01,2280,216,2064,88,1
Heat Stroke,Amritsar,Himachal Pradesh,2020-03-01,1946,170,1776,67,5
Heat Stroke,Amritsar,Himachal Pradesh,2020-04-01,2707,183,2524,41,1
Heat Stroke,Amritsar,Himachal Pradesh,2020-05-01,4989,442,4547,126,4
Heat Stroke,Amritsar,Himachal Pradesh,2020-06-01,92,10,82,80,9
Heat Stroke,Amritsar,Himachal Pradesh,2020-07-01,3518,158,3360,11,10
Heat Stroke,Amritsar,Himachal Pradesh,2020-08-01,434,11,423,45,6
Heat Stroke,Amritsar,Himachal Pradesh,2020-09-01,1964,0,1964,94,1
Heat Stroke,Amritsar,Himachal Pradesh,2020-10-01,4058,442,3616,96,1
Heat Stroke,Amritsar,Himachal Pradesh,2020-11-01,2684,100,2584,94,5
Heat Stroke,Amritsar,Himachal Pradesh,2020-12-01,1152,95,1057,87,2
Heat Stroke,Amritsar,Himachal Pradesh,2021-01-01,1638,46,1592,31,7
Heat Stroke,Amritsar,Himachal Pradesh,2021-02-01,3509,332,3177,62,10
Heat Stroke,Amritsar,Himachal Pradesh,2021-03-01,1618,48,1570,167,2
Heat Stroke,Amritsar,Himachal Pradesh,2021-04-01,2888,44,2844,159,2
Heat Stroke,Amritsar,Himachal Pradesh,2021-05-01,2659,117,2542,136,1
Heat Stroke,Amritsar,Himachal Pradesh,2021-06-01,1723,59,1664,131,4
Heat Stroke,Amritsar,Himachal Pradesh,2021-07-01,4989,336,4653,152,5
Heat Stroke,Amritsar,Himachal Pradesh,2021-08-01,3448,167,3281,49,5
Heat Stroke,Amritsar,Himachal Pradesh,2021-09-01,78,0,78,108,7
Heat Stroke,Amritsar,Himachal Pradesh,2021-10-01,2848,118,2730,49,6
Heat Stroke,Amritsar,Himachal Pradesh,2021-11-01,1710,52,1658,50,5
Heat Stroke,Amritsar,Himachal Pradesh,2021-12-01,3741,123,3618,125,5
Heat Stroke,Amritsar,Himachal Pradesh,2022-01-01,1534,168,1366,154,5
Heat Stroke,Amritsar,Himachal Pradesh,2022-02-01,2443,138,2305,96,5
Heat Stroke,Amritsar,Himachal Pradesh,2022-03-01,3275,0,3275,190,3
Heat Stroke,Amritsar,Himachal Pradesh,2022-04-01,3759,131,3628,117,1
Heat Stroke,Amritsar,Himachal Pradesh,2022-05-01,987,52,935,67,5
Heat Stroke,Amritsar,Himachal Pradesh,2022-06-01,2149,223,1926,51,3
Heat Stroke,Amritsar,Himachal Pradesh,2022-07-01,1960,156,1804,158,6
Heat Stroke,Amritsar,Himachal Pradesh,2022-08-01,1721,40,1681,113,5
Heat Stroke,Amritsar,Himachal Pradesh,2022-09-01,4966,442,4524,141,5
Heat Stroke,Amritsar,Himachal Pradesh,2022-10-01,3141,154,2987,11,8
Heat Stroke,Amritsar,Himachal Pradesh,2022-11-01,906,78,828,119,1
Heat Stroke,Amritsar,Himachal Pradesh,2022-12-01,3829,63,3766,80,10
Heat Stroke,Amritsar,Himachal Pradesh,2023-01-01,4989,20,4969,35,1
Heat Stroke,Amritsar,Himachal Pradesh,2023-02-01,3982,36,3946,103,9
Heat Stroke,Amritsar,Himachal Pradesh,2023-03-01,559,0,559,162,5
Heat Stroke,Amritsar,Himachal Pradesh,2023-04-01,1948,217,1731,200,3
Heat Stroke,Amritsar,Himachal Pradesh,2023-05-01,4297,241,4056,119,1
Heat Stroke,Amritsar,Himachal Pradesh,2023-06-01,1648,38,1610,70,3
Heat Stroke,Amritsar,Himachal Pradesh,2023-07-01,3193,201,2992,67,4
Heat Stroke,Amritsar,Himachal Pradesh,2023-08-01,3637,202,3435,155,5
Heat Stroke,Amritsar,Himachal Pradesh,2023-09-01,1354,92,1262,55,9
Heat Stroke,Amritsar,Himachal Pradesh,2023-10-01,2518,214,2304,138,5
Heat Stroke,Amritsar,Himachal Pradesh,2023-11-01,78,0,78,121,6
Heat Stroke,Amritsar,Himachal Pradesh,2023-12-01,1223,29,1194,116,6
Heat Stroke,Amritsar,Himachal Pradesh,2024-01-01,2259,167,2092,26,4
Heat Stroke,Amritsar,Himachal Pradesh,2024-02-01,923,67,856,88,4
Heat Stroke,Amritsar,Himachal Pradesh,2024-03-01,4787,253,4534,32,5
Heat Stroke,Amritsar,Himachal Pradesh,2024-04-01,679,77,602,76,7
Heat Stroke,Amritsar,Himachal Pradesh,2024-05-01,2007,74,1933,153,2
Heat Stroke,Amritsar,Himachal Pradesh,2024-06-01,2773,66,2707,169,3
Heat Stroke,Amritsar,Himachal Pradesh,2024-07-01,4531,282,4249,117,6
Heat Stroke,Amritsar,Himachal Pradesh,2024-08-01,671,20,651,77,2
Heat Stroke,Amritsar,Himachal Pradesh,2024-09-01,4158,268,3890,187,5
Heat Stroke,Amritsar,Himachal Pradesh,2024-10-01,2611,67,2544,76,3
Heat Stroke,Amritsar,Himachal Pradesh,2024-11-01,1281,49,1232,48,6
Heat Stroke,Amritsar,Himachal Pradesh,2024-12-01,3217,338,2879,142,9
Heat Stroke,Amritsar,Himachal Pradesh,2025-01-01,2864,109,2755,130,3
Heat Stroke,Amritsar,Himachal Pradesh,2025-02-01,1792,48,1744,79,7
Heat Stroke,Amritsar,Himachal Pradesh,2025-03-01,2691,226,2465,111,5
Heat Stroke,Amritsar,Himachal Pradesh,2025-04-01,2081,40,2041,129,4
Heat Stroke,Amritsar,Himachal Pradesh,2025-05-01,2750,82,2668,117,5
Heat Stroke,Amritsar,Himachal Pradesh,2025-06-01,3486,233,3253,130,9
Heat Stroke,Amritsar,Himachal Pradesh,2025-07-01,4725,365,4360,80,4
Heat Stroke,Amritsar,Himachal Pradesh,2025-08-01,937,80,857,133,9
Heat Stroke,Amritsar,Himachal Pradesh,2025-09-01,4989,141,4848,107,4
Heat Stroke,Amritsar,Himachal Pradesh,2025-10-01,78,0,78,82,1
Heat Stroke,Amritsar,Himachal Pradesh,2025-11-01,2394,87,2307,94,4
Heat Stroke,Amritsar,Himachal Pradesh,2025-12-01,3387,109,3278,101,1
Heat Stroke,Amritsar,Jammu & Kashmir,2018-01-01,2974,253,2721,33,4
Heat Stroke,Amritsar,Jammu & Kashmir,2018-02-01,1762,60,1702,74,4
Heat Stroke,Amritsar,Jammu & Kashmir,2018-03-01,2318,134,2184,110,10
Heat Stroke,Amritsar,Jammu & Kashmir,2018-04-01,1936,105,1831,37,9
Heat Stroke,Amritsar,Jammu & Kashmir,2018-05-01,1807,34,1773,75,5
Heat Stroke,Amritsar,Jammu & Kashmir,2018-06-01,3737,292,3445,200,8
Heat Stroke,Amritsar,Jammu & Kashmir,2018-07-01,3076,204,2872,49,4
Heat Stroke,Amritsar,Jammu & Kashmir,2018-08-01,1668,0,1668,87,1
Heat Stroke,Amritsar,Jammu & Kashmir,2018-09-01,3804,221,3583,64,6
Heat Stroke,Amritsar,Jammu & Kashmir,2018-10-01,3010,82,2928,100,6
Heat Stroke,Amritsar,Jammu & Kashmir,2018-11-01,3688,302,3386,65,2
Heat Stroke,Amritsar,Jammu & Kashmir,2018-12-01,3442,27,3415,94,2
Heat Stroke,Amritsar,Jammu & Kashmir,2019-01-01,1485,58,1427,70,8
Heat Stroke,Amritsar,Jammu & Kashmir,2019-02-01,1846,111,1735,160,1
Heat Stroke,Amritsar,Jammu & Kashmir,2019-03-01,3600,185,3415,110,6
Heat Stroke,Amritsar,Jammu & Kashmir,2019-04-01,3416,246,3170,55,4
Heat Stroke,Amritsar,Jammu & Kashmir,2019-05-01,2569,15,2554,149,6
Heat Stroke,Amritsar,Jammu & Kashmir,2019-06-01,2755,270,2485,57,8
Heat Stroke,Amritsar,Jammu & Kashmir,2019-07-01,4311,281,4030,27,2
Heat Stroke,Amritsar,Jammu & Kashmir,2019-08-01,1804,161,1643,106,2
Heat Stroke,Amritsar,Jammu & Kashmir,2019-09-01,3331,251,3080,200,9
Heat Stroke,Amritsar,Jammu & Kashmir,2019-10-01,2326,115,2211,13,5
Heat Stroke,Amritsar,Jammu & Kashmir,2019-11-01,2305,29,2276,38,6
Heat Stroke,Amritsar,Jammu & Kashmir,2019-12-01,4071,137,3934,145,7
Heat Stroke,Amritsar,Jammu & Kashmir,2020-01-01,3705,356,3349,73,2
Heat Stroke,Amritsar,Jammu & Kashmir,2020-02-01,3689,333,3356,137,7
Heat Stroke,Amritsar,Jammu & Kashmir,2020-03-01,4349,139,4210,64,7
Heat Stroke,Amritsar,Jammu & Kashmir,2020-04-01,2626,0,2626,113,9
Heat Stroke,Amritsar,Jammu & Kashmir,2020-05-01,3512,154,3358,195,9
Heat Stroke,Amritsar,Jammu & Kashmir,2020-06-01,2181,90,2091,45,5
Heat Stroke,Amritsar,Jammu & Kashmir,2020-07-01,3032,129,2903,158,7
Heat Stroke,Amritsar,Jammu & Kashmir,2020-08-01,2423,158,2265,141,5
Heat Stroke,Amritsar,Jammu & Kashmir,2020-09-01,2728,206,2522,30,5
Heat Stroke,Amritsar,Jammu & Kashmir,2020-10-01,3396,267,3129,135,2
Heat Stroke,Amritsar,Jammu & Kashmir,2020-11-01,1500,94,1406,110,4
Heat Stroke,Amritsar,Jammu & Kashmir,2020-12-01,4989,20,4969,111,1
Heat Stroke,Amritsar,Jammu & Kashmir,2021-01-01,1248,50,1198,123,4
Heat Stroke,Amritsar,Jammu & Kashmir,2021-02-01,969,113,856,88,9
Heat Stroke,Amritsar,Jammu & Kashmir,2021-03-01,4151,253,3898,110,7
Heat Stroke,Amritsar,Jammu & Kashmir,2021-04-01,3659,222,3437,119,5
Heat Stroke,Amritsar,Jammu & Kashmir,2021-05-01,3435,207,3228,144,4
Heat Stroke,Amritsar,Jammu & Kashmir,2021-06-01,3440,213,3227,28,3
Heat Stroke,Amritsar,Jammu & Kashmir,2021-07-01,2581,0,2581,172,2
Heat Stroke,Amritsar,Jammu & Kashmir,2021-08-01,1394,60,1334,47,7
Heat Stroke,Amritsar,Jammu & Kashmir,2021-09-01,2699,132,2567,145,1
Heat Stroke,Amritsar,Jammu & Kashmir,2021-10-01,1689,147,1542,110,1
Heat Stroke,Amritsar,Jammu & Kashmir,2021-11-01,3906,200,3706,41,7
Heat Stroke,Amritsar,Jammu & Kashmir,2021-12-01,2400,5,2395,133,5
Heat Stroke,Amritsar,Jammu & Kashmir,2022-01-01,1490,93,1397,58,5
Heat Stroke,Amritsar,Jammu & Kashmir,2022-02-01,2166,57,2109,161,5
Heat Stroke,Amritsar,Jammu & Kashmir,2022-03-01,3151,46,3105,70,10
Heat Stroke,Amritsar,Jammu & Kashmir,2022-04-01,1841,47,1794,30,5
Heat Stroke,Amritsar,Jammu & Kashmir,2022-05-01,1494,98,1396,184,6
Heat Stroke,Amritsar,Jammu & Kashmir,2022-06-01,2924,253,2671,115,10
Heat Stroke,Amritsar,Jammu & Kashmir,2022-07-01,2926,187,2739,150,5
Heat Stroke,Amritsar,Jammu & Kashmir,2022-08-01,1917,131,1786,63,10
Heat Stroke,Amritsar,Jammu & Kashmir,2022-09-01,1966,125,1841,11,1
Heat Stroke,Amritsar,Jammu & Kashmir,2022-10-01,2909,154,2755,192,1
Heat Stroke,Amritsar,Jammu & Kashmir,2022-11-01,655,46,609,106,3
Heat Stroke,Amritsar,Jammu & Kashmir,2022-12-01,709,0,709,131,7
Heat Stroke,Amritsar,Jammu & Kashmir,2023-01-01,1634,87,1547,140,10
Heat Stroke,Amritsar,Jammu & Kashmir,2023-02-01,2311,45,2266,89,3
Heat Stroke,Amritsar,Jammu & Kashmir,2023-03-01,3014,252,2762,118,8
Heat Stroke,Amritsar,Jammu & Kashmir,2023-04-01,4577,209,4368,187,10
Heat Stroke,Amritsar,Jammu & Kashmir,2023-05-01,3748,191,3557,105,9
Heat Stroke,Amritsar,Jammu & Kashmir,2023-06-01,2383,14,2369,154,4
Heat Stroke,Amritsar,Jammu & Kashmir,2023-07-01,2572,204,2368,11,7
Heat Stroke,Amritsar,Jammu & Kashmir,2023-08-01,1253,85,1168,163,6
Heat Stroke,Amritsar,Jammu & Kashmir,2023-09-01,2573,170,2403,29,3
Heat Stroke,Amritsar,Jammu & Kashmir,2023-10-01,2210,58,2152,158,6
Heat Stroke,Amritsar,Jammu & Kashmir,2023-11-01,3030,83,2947,126,3
Heat Stroke,Amritsar,Jammu & Kashmir,2023-12-01,1488,84,1404,101,5
Heat Stroke,Amritsar,Jammu & Kashmir,2024-01-01,3294,98,3196,101,1
Heat Stroke,Amritsar,Jammu & Kashmir,2024-02-01,4654,291,4363,93,1
Heat Stroke,Amritsar,Jammu & Kashmir,2024-03-01,2452,0,2452,64,4
Heat Stroke,Amritsar,Jammu & Kashmir,2024-04-01,3136,112,3024,96,6
Heat Stroke,Amritsar,Jammu & Kashmir,2024-05-01,3523,360,3163,200,2
Heat Stroke,Amritsar,Jammu & Kashmir,2024-06-01,2059,129,1930,173,6
Heat Stroke,Amritsar,Jammu & Kashmir,2024-07-01,2898,159,2739,62,5
Heat Stroke,Amritsar,Jammu & Kashmir,2024-08-01,2614,281,2333,120,7
Heat Stroke,Amritsar,Jammu & Kashmir,2024-09-01,2728,0,2728,111,8
Heat Stroke,Amritsar,Jammu & Kashmir,2024-10-01,1560,41,1519,99,9
Heat Stroke,Amritsar,Jammu & Kashmir,2024-11-01,2630,100,2530,55,7
Heat Stroke,Amritsar,Jammu & Kashmir,2024-12-01,3265,245,3020,129,4
Heat Stroke,Amritsar,Jammu & Kashmir,2025-01-01,4544,343,4201,149,5
Heat Stroke,Amritsar,Jammu & Kashmir,2025-02-01,3884,96,3788,64,10
Heat Stroke,Amritsar,Jammu & Kashmir,2025-03-01,4989,394,4595,200,8
Heat Stroke,Amritsar,Jammu & Kashmir,2025-04-01,1568,60,1508,184,5
Heat Stroke,Amritsar,Jammu & Kashmir,2025-05-01,3768,321,3447,134,4
Heat Stroke,Amritsar,Jammu & Kashmir,2025-06-01,2843,56,2787,43,3
Heat Stroke,Amritsar,Jammu & Kashmir,2025-07-01,4989,231,4758,127,1
Heat Stroke,Amritsar,Jammu & Kashmir,2025-08-01,1513,54,1459,121,10
Heat Stroke,Amritsar,Jammu & Kashmir,2025-09-01,1471,118,1353,132,6
Heat Stroke,Amritsar,Jammu & Kashmir,2025-10-01,1793,62,1731,187,1
Heat Stroke,Amritsar,Jammu & Kashmir,2025-11-01,78,0,78,97,4
Heat Stroke,Amritsar,Jammu & Kashmir,2025-12-01,1892,122,1770,200,9
Heat Stroke,Amritsar,Haryana,2018-01-01,1579,104,1475,127,4
Heat Stroke,Amritsar,Haryana,2018-02-01,2799,212,2587,91,2
Heat Stroke,Amritsar,Haryana,2018-03-01,3056,171,2885,200,6
Heat Stroke,Amritsar,Haryana,2018-04-01,4989,189,4800,148,7
Heat Stroke,Amritsar,Haryana,2018-05-01,3872,154,3718,83,4
Heat Stroke,Amritsar,Haryana,2018-06-01,1823,92,1731,111,3
Heat Stroke,Amritsar,Haryana,2018-07-01,1392,79,1313,139,6
Heat Stroke,Amritsar,Haryana,2018-08-01,3257,149,3108,99,2
Heat Stroke,Amritsar,Haryana,2018-09-01,826,41,785,113,3
Heat Stroke,Amritsar,Haryana,2018-10-01,4989,29,4960,65,4
Heat Stroke,Amritsar,Haryana,2018-11-01,4180,290,3890,20,7
Heat Stroke,Amritsar,Haryana,2018-12-01,1968,108,1860,112,4
Heat Stroke,Amritsar,Haryana,2019-01-01,299,23,276,113,6
Heat Stroke,Amritsar,Haryana,2019-02-01,4414,221,4193,133,8
Heat Stroke,Amritsar,Haryana,2019-03-01,2444,0,2444,77,3
Heat Stroke,Amritsar,Haryana,2019-04-01,4258,168,4090,38,10
Heat Stroke,Amritsar,Haryana,2019-05-01,458,20,438,57,9
Heat Stroke,Amritsar,Haryana,2019-06-01,1793,128,1665,160,6
Heat Stroke,Amritsar,Haryana,2019-07-01,2604,0,2604,72,4
Heat Stroke,Amritsar,Haryana,2019-08-01,2660,136,2524,84,3
Heat Stroke,Amritsar,Haryana,2019-09-01,1994,129,1865,90,10
Heat Stroke,Amritsar,Haryana,2019-10-01,3433,105,3328,75,5
Heat Stroke,Amritsar,Haryana,2019-11-01,1165,60,1105,71,1
Heat Stroke,Amritsar,Haryana,2019-12-01,2406,76,2330,62,1
Heat Stroke,Amritsar,Haryana,2020-01-01,2759,79,2680,178,5
Heat Stroke,Amritsar,Haryana,2020-02-01,3288,125,3163,141,5
Heat Stroke,Amritsar,Haryana,2020-03-01,3552,104,3448,170,2
Heat Stroke,Amritsar,Haryana,2020-04-01,1089,76,1013,180,1
Heat Stroke,Amritsar,Haryana,2020-05-01,539,15,524,11,1
Heat Stroke,Amritsar,Haryana,2020-06-01,4311,102,4209,124,3
Heat Stroke,Amritsar,Haryana,2020-07-01,3043,308,2735,76,4
Heat Stroke,Amritsar,Haryana,2020-08-01,1593,124,1469,163,7
Heat Stroke,Amritsar,Haryana,2020-09-01,4678,0,4678,68,4
Heat Stroke,Amritsar,Haryana,2020-10-01,2753,76,2677,53,8
Heat Stroke,Amritsar,Haryana,2020-11-01,4179,238,3941,33,7
Heat Stroke,Amritsar,Haryana,2020-12-01,2688,159,2529,91,6
Heat Stroke,Amritsar,Haryana,2021-01-01,4989,33,4956,153,8
Heat Stroke,Amritsar,Haryana,2021-02-01,4952,414,4538,119,1
Heat Stroke,Amritsar,Haryana,2021-03-01,2263,167,2096,45,3
Heat Stroke,Amritsar,Haryana,2021-04-01,3901,250,3651,200,10
Heat Stroke,Amritsar,Haryana,2021-05-01,3463,310,3153,139,1
Heat Stroke,Amritsar,Haryana,2021-06-01,4433,280,4153,146,4
Heat Stroke,Amritsar,Haryana,2021-07-01,1303,82,1221,172,6
Heat Stroke,Amritsar,Haryana,2021-08-01,3518,335,3183,23,1
Heat Stroke,Amritsar,Haryana,2021-09-01,4017,329,3688,60,3
Heat Stroke,Amritsar,Haryana,2021-10-01,238,6,232,148,10
Heat Stroke,Amritsar,Haryana,2021-11-01,1010,69,941,65,5
Heat Stroke,Amritsar,Haryana,2021-12-01,78,0,78,92,3
Heat Stroke,Amritsar,Haryana,2022-01-01,2236,144,2092,102,5
Heat Stroke,Amritsar,Haryana,2022-02-01,3560,227,3333,41,3
Heat Stroke,Amritsar,Haryana,2022-03-01,4613,45,4568,88,10
Heat Stroke,Amritsar,Haryana,2022-04-01,2697,125,2572,153,2
Heat Stroke,Amritsar,Haryana,2022-05-01,4782,276,4506,143,3
Heat Stroke,Amritsar,Haryana,2022-06-01,746,27,719,163,1
Heat Stroke,Amritsar,Haryana,2022-07-01,312,18,294,158,4
Heat Stroke,Amritsar,Haryana,2022-08-01,2523,185,2338,127,4
Heat Stroke,Amritsar,Haryana,2022-09-01,3113,153,2960,123,8
Heat Stroke,Amritsar,Haryana,2022-10-01,2554,144,2410,119,2
Heat Stroke,Amritsar,Haryana,2022-11-01,78,0,78,74,6
Heat Stroke,Amritsar,Haryana,2022-12-01,2478,158,2320,54,5
Heat Stroke,Amritsar,Haryana,2023-01-01,847,47,800,71,1
Heat Stroke,Amritsar,Haryana,2023-02-01,3496,77,3419,90,3
Heat Stroke,Amritsar,Haryana,2023-03-01,3089,214,2875,73,3
Heat Stroke,Amritsar,Haryana,2023-04-01,1337,79,1258,127,10
Heat Stroke,Amritsar,Haryana,2023-05-01,1908,166,1742,116,6
Heat Stroke,Amritsar,Haryana,2023-06-01,1176,60,1116,122,5
Heat Stroke,Amritsar,Haryana,2023-07-01,2513,0,2513,124,1
Heat Stroke,Amritsar,Haryana,2023-08-01,3879,2,3877,167,1
Heat Stroke,Amritsar,Haryana,2023-09-01,1275,91,1184,106,7
Heat Stroke,Amritsar,Haryana,2023-10-01,3274,109,3165,158,7
Heat Stroke,Amritsar,Haryana,2023-11-01,1886,118,1768,133,3
Heat Stroke,Amritsar,Haryana,2023-12-01,1534,81,1453,164,5
Heat Stroke,Amritsar,Haryana,2024-01-01,2454,110,2344,188,5
Heat Stroke,Amritsar,Haryana,2024-02-01,1209,57,1152,136,5
Heat Stroke,Amritsar,Haryana,2024-03-01,1855,46,1809,111,4
Heat Stroke,Amritsar,Haryana,2024-04-01,990,49,941,111,7
Heat Stroke,Amritsar,Haryana,2024-05-01,4989,164,4825,82,8
Heat Stroke,Amritsar,Haryana,2024-06-01,2645,103,2542,81,2
Heat Stroke,Amritsar,Haryana,2024-07-01,1659,67,1592,152,1
Heat Stroke,Amritsar,Haryana,2024-08-01,2884,125,2759,57,3
Heat Stroke,Amritsar,Haryana,2024-09-01,2447,188,2259,188,5
Heat Stroke,Amritsar,Haryana,2024-10-01,2301,106,2195,98,6
Heat Stroke,Amritsar,Haryana,2024-11-01,3421,273,3148,200,7
Heat Stroke,Amritsar,Haryana,2024-12-01,3614,342,3272,71,8
Heat Stroke,Amritsar,Haryana,2025-01-01,1886,141,1745,119,6
Heat Stroke,Amritsar,Haryana,2025-02-01,1825,119,1706,88,5
Heat Stroke,Amritsar,Haryana,2025-03-01,2228,132,2096,66,10
Heat Stroke,Amritsar,Haryana,2025-04-01,78,0,78,160,5
Heat Stroke,Amritsar,Haryana,2025-05-01,565,29,536,50,7
Heat Stroke,Amritsar,Haryana,2025-06-01,4431,348,4083,72,6
Heat Stroke,Amritsar,Haryana,2025-07-01,4804,326,4478,136,4
Heat Stroke,Amritsar,Haryana,2025-08-01,2263,89,2174,144,4
Heat Stroke,Amritsar,Haryana,2025-09-01,3371,256,3115,35,9
Heat Stroke,Amritsar,Haryana,2025-10-01,3015,158,2857,136,5
Heat Stroke,Amritsar,Haryana,2025-11-01,4989,234,4755,113,4
Heat Stroke,Amritsar,Haryana,2025-12-01,4099,148,3951,59,3
Heat Stroke,Ludhiana,Punjab,2018-01-01,2426,133,2293,66,6
Heat Stroke,Ludhiana,Punjab,2018-02-01,1316,104,1212,11,3
Heat Stroke,Ludhiana,Punjab,2018-03-01,442,33,409,194,6
Heat Stroke,Ludhiana,Punjab,2018-04-01,2870,173,2697,158,5
Heat Stroke,Ludhiana,Punjab,2018-05-01,1583,106,1477,41,4
Heat Stroke,Ludhiana,Punjab,2018-06-01,689,60,629,147,1
Heat Stroke,Ludhiana,Punjab,2018-07-01,1730,79,1651,77,2
Heat Stroke,Ludhiana,Punjab,2018-08-01,1147,20,1127,153,2
Heat Stroke,Ludhiana,Punjab,2018-09-01,4861,427,4434,81,2
Heat Stroke,Ludhiana,Punjab,2018-10-01,3780,130,3650,88,6
Heat Stroke,Ludhiana,Punjab,2018-11-01,2587,77,2510,92,10
Heat Stroke,Ludhiana,Punjab,2018-12-01,4583,0,4583,73,3
Heat Stroke,Ludhiana,Punjab,2019-01-01,2701,180,2521,177,4
Heat Stroke,Ludhiana,Punjab,2019-02-01,1442,4,1438,152,3
Heat Stroke,Ludhiana,Punjab,2019-03-01,4641,131,4510,112,7
Heat Stroke,Ludhiana,Punjab,2019-04-01,3320,223,3097,158,6
Heat Stroke,Ludhiana,Punjab,2019-05-01,1206,85,1121,23,5
Heat Stroke,Ludhiana,Punjab,2019-06-01,2342,72,2270,44,1
Heat Stroke,Ludhiana,Punjab,2019-07-01,1423,65,1358,130,2
Heat Stroke,Ludhiana,Punjab,2019-08-01,742,18,724,144,5
Heat Stroke,Ludhiana,Punjab,2019-09-01,3840,130,3710,120,5
Heat Stroke,Ludhiana,Punjab,2019-10-01,4989,288,4701,11,5
Heat Stroke,Ludhiana,Punjab,2019-11-01,721,25,696,52,7
Heat Stroke,Ludhiana,Punjab,2019-12-01,3353,144,3209,127,1
Heat Stroke,Ludhiana,Punjab,2020-01-01,1725,12,1713,200,6
Heat Stroke,Ludhiana,Punjab,2020-02-01,1944,161,1783,168,6
Heat Stroke,Ludhiana,Punjab,2020-03-01,1803,117,1686,187,2
Heat Stroke,Ludhiana,Punjab,2020-04-01,1438,105,1333,124,3
Heat Stroke,Ludhiana,Punjab,2020-05-01,2662,233,2429,123,7
Heat Stroke,Ludhiana,Punjab,2020-06-01,1483,38,1445,54,2
Heat Stroke,Ludhiana,Punjab,2020-07-01,2960,117,2843,155,10
Heat Stroke,Ludhiana,Punjab,2020-08-01,2530,0,2530,102,6
Heat Stroke,Ludhiana,Punjab,2020-09-01,2277,322,1955,142,5
Heat Stroke,Ludhiana,Punjab,2020-10-01,1380,63,1317,108,4
Heat Stroke,Ludhiana,Punjab,2020-11-01,1824,146,1678,120,7
Heat Stroke,Ludhiana,Punjab,2020-12-01,3611,50,3561,102,4
Heat Stroke,Ludhiana,Punjab,2021-01-01,3269,258,3011,118,4
Heat Stroke,Ludhiana,Punjab,2021-02-01,1286,133,1153,157,9
Heat Stroke,Ludhiana,Punjab,2021-03-01,2731,131,2600,42,3
Heat Stroke,Ludhiana,Punjab,2021-04-01,3605,74,3531,30,5
Heat Stroke,Ludhiana,Punjab,2021-05-01,358,16,342,128,3
Heat Stroke,Ludhiana,Punjab,2021-06-01,3326,0,3326,180,6
Heat Stroke,Ludhiana,Punjab,2021-07-01,1708,83,1625,192,7
Heat Stroke,Ludhiana,Punjab,2021-08-01,3363,248,3115,44,10
Heat Stroke,Ludhiana,Punjab,2021-09-01,1573,77,1496,86,2
Heat Stroke,Ludhiana,Punjab,2021-10-01,176,7,169,31,1
Heat Stroke,Ludhiana,Punjab,2021-11-01,414,27,387,78,4
Heat Stroke,Ludhiana,Punjab,2021-12-01,2662,180,2482,163,3
Heat Stroke,Ludhiana,Punjab,2022-01-01,2946,5,2941,106,5
Heat Stroke,Ludhiana,Punjab,2022-02-01,1384,72,1312,87,6
Heat Stroke,Ludhiana,Punjab,2022-03-01,3454,417,3037,134,10
Heat Stroke,Ludhiana,Punjab,2022-04-01,368,4,364,66,4
Heat Stroke,Ludhiana,Punjab,2022-05-01,2509,119,2390,187,1
Heat Stroke,Ludhiana,Punjab,2022-06-01,973,103,870,107,4
Heat Stroke,Ludhiana,Punjab,2022-07-01,1723,141,1582,86,6
Heat Stroke,Ludhiana,Punjab,2022-08-01,2661,93,2568,136,2
Heat Stroke,Ludhiana,Punjab,2022-09-01,1443,80,1363,154,5
Heat Stroke,Ludhiana,Punjab,2022-10-01,2082,104,1978,188,5
Heat Stroke,Ludhiana,Punjab,2022-11-01,3947,111,3836,96,6
Heat Stroke,Ludhiana,Punjab,2022-12-01,1824,87,1737,162,7
Heat Stroke,Ludhiana,Punjab,2023-01-01,3718,155,3563,111,5
Heat Stroke,Ludhiana,Punjab,2023-02-01,1082,57,1025,75,6
Heat Stroke,Ludhiana,Punjab,2023-03-01,3308,93,3215,67,1
Heat Stroke,Ludhiana,Punjab,2023-04-01,4531,58,4473,50,2
Heat Stroke,Ludhiana,Punjab,2023-05-01,78,0,78,68,4
Heat Stroke,Ludhiana,Punjab,2023-06-01,1528,152,1376,163,2
Heat Stroke,Ludhiana,Punjab,2023-07-01,3372,176,3196,142,5
Heat Stroke,Ludhiana,Punjab,2023-08-01,2325,93,2232,43,4
Heat Stroke,Ludhiana,Punjab,2023-09-01,3095,222,2873,17,3
Heat Stroke,Ludhiana,Punjab,2023-10-01,1787,81,1706,50,7
Heat Stroke,Ludhiana,Punjab,2023-11-01,2714,283,2431,67,5
Heat Stroke,Ludhiana,Punjab,2023-12-01,2389,119,2270,91,2
Heat Stroke,Ludhiana,Punjab,2024-01-01,4164,293,3871,166,3
Heat Stroke,Ludhiana,Punjab,2024-02-01,2939,82,2857,78,7
Heat Stroke,Ludhiana,Punjab,2024-03-01,3050,197,2853,192,5
Heat Stroke,Ludhiana,Punjab,2024-04-01,2045,118,1927,21,8
Heat Stroke,Ludhiana,Punjab,2024-05-01,1943,94,1849,88,7
Heat Stroke,Ludhiana,Punjab,2024-06-01,2017,71,1946,146,4
Heat Stroke,Ludhiana,Punjab,2024-07-01,3127,98,3029,149,9
Heat Stroke,Ludhiana,Punjab,2024-08-01,2033,118,1915,89,9
Heat Stroke,Ludhiana,Punjab,2024-09-01,2986,204,2782,157,1
Heat Stroke,Ludhiana,Punjab,2024-10-01,4989,231,4758,148,5
Heat Stroke,Ludhiana,Punjab,2024-11-01,3766,220,3546,71,3
Heat Stroke,Ludhiana,Punjab,2024-12-01,2160,105,2055,122,4
Heat Stroke,Ludhiana,Punjab,2025-01-01,4209,222,3987,142,2
Heat Stroke,Ludhiana,Punjab,2025-02-01,2050,90,1960,75,2
Heat Stroke,Ludhiana,Punjab,2025-03-01,78,0,78,193,7
Heat Stroke,Ludhiana,Punjab,2025-04-01,1245,160,1085,64,1
Heat Stroke,Ludhiana,Punjab,2025-05-01,88,5,83,114,5
Heat Stroke,Ludhiana,Punjab,2025-06-01,2126,146,1980,43,1
Heat Stroke,Ludhiana,Punjab,2025-07-01,2622,164,2458,111,9
Heat Stroke,Ludhiana,Punjab,2025-08-01,4846,205,4641,52,5
Heat Stroke,Ludhiana,Punjab,2025-09-01,3036,266,2770,91,7
Heat Stroke,Ludhiana,Punjab,2025-10-01,2303,95,2208,25,5
Heat Stroke,Ludhiana,Punjab,2025-11-01,3710,299,3411,147,4
Heat Stroke,Ludhiana,Punjab,2025-12-01,78,0,78,124,5
Heat Stroke,Ludhiana,Chandigarh,2018-01-01,2913,64,2849,162,9
Heat Stroke,Ludhiana,Chandigarh,2018-02-01,3632,220,3412,88,2
Heat Stroke,Ludhiana,Chandigarh,2018-03-01,614,11,603,164,1
Heat Stroke,Ludhiana,Chandigarh,2018-04-01,4132,271,3861,108,3
Heat Stroke,Ludhiana,Chandigarh,2018-05-01,3052,46,3006,112,1
Heat Stroke,Ludhiana,Chandigarh,2018-06-01,2040,83,1957,200,8
Heat Stroke,Ludhiana,Chandigarh,2018-07-01,3446,28,3418,82,4
Heat Stroke,Ludhiana,Chandigarh,2018-08-01,4989,442,4547,169,7
Heat Stroke,Ludhiana,Chandigarh,2018-09-01,2841,5,2836,131,5
Heat Stroke,Ludhiana,Chandigarh,2018-10-01,2930,147,2783,77,5
Heat Stroke,Ludhiana,Chandigarh,2018-11-01,1981,165,1816,39,5
Heat Stroke,Ludhiana,Chandigarh,2018-12-01,1457,116,1341,54,9
Heat Stroke,Ludhiana,Chandigarh,2019-01-01,3711,277,3434,164,5
Heat Stroke,Ludhiana,Chandigarh,2019-02-01,1449,59,1390,195,8
Heat Stroke,Ludhiana,Chandigarh,2019-03-01,2693,240,2453,111,8
Heat Stroke,Ludhiana,Chandigarh,2019-04-01,1957,150,1807,114,4
Heat Stroke,Ludhiana,Chandigarh,2019-05-01,3240,182,3058,146,5
Heat Stroke,Ludhiana,Chandigarh,2019-06-01,3045,173,2872,110,4
Heat Stroke,Ludhiana,Chandigarh,2019-07-01,3989,164,3825,162,9
Heat Stroke,Ludhiana,Chandigarh,2019-08-01,1913,45,1868,121,2
Heat Stroke,Ludhiana,Chandigarh,2019-09-01,2235,192,2043,113,3
Heat Stroke,Ludhiana,Chandigarh,2019-10-01,1284,113,1171,71,4
Heat Stroke,Ludhiana,Chandigarh,2019-11-01,2001,48,1953,58,1
Heat Stroke,Ludhiana,Chandigarh,2019-12-01,3104,141,2963,11,3
Heat Stroke,Ludhiana,Chandigarh,2020-01-01,3613,165,3448,169,8
Heat Stroke,Ludhiana,Chandigarh,2020-02-01,1360,66,1294,99,7
Heat Stroke,Ludhiana,Chandigarh,2020-03-01,3764,195,3569,86,4
Heat Stroke,Ludhiana,Chandigarh,2020-04-01,4416,342,4074,11,7
Heat Stroke,Ludhiana,Chandigarh,2020-05-01,3152,89,3063,74,10
Heat Stroke,Ludhiana,Chandigarh,2020-06-01,4989,126,4863,67,6
Heat Stroke,Ludhiana,Chandigarh,2020-07-01,1559,134,1425,66,9
Heat Stroke,Ludhiana,Chandigarh,2020-08-01,928,33,895,123,7
Heat Stroke,Ludhiana,Chandigarh,2020-09-01,211,2,209,112,4
Heat Stroke,Ludhiana,Chandigarh,2020-10-01,4604,165,4439,37,5
Heat Stroke,Ludhiana,Chandigarh,2020-11-01,3475,140,3335,40,6
Heat Stroke,Ludhiana,Chandigarh,2020-12-01,2523,240,2283,40,3
Heat Stroke,Ludhiana,Chandigarh,2021-01-01,2973,228,2745,198,1
Heat Stroke,Ludhiana,Chandigarh,2021-02-01,1088,90,998,182,2
Heat Stroke,Ludhiana,Chandigarh,2021-03-01,4989,368,4621,63,1
Heat Stroke,Ludhiana,Chandigarh,2021-04-01,2771,215,2556,11,3
Heat Stroke,Ludhiana,Chandigarh,2021-05-01,2744,82,2662,113,1
Heat Stroke,Ludhiana,Chandigarh,2021-06-01,3571,158,3413,109,7
Heat Stroke,Ludhiana,Chandigarh,2021-07-01,3243,68,3175,122,1
Heat Stroke,Ludhiana,Chandigarh,2021-08-01,2898,127,2771,144,6
Heat Stroke,Ludhiana,Chandigarh,2021-09-01,1537,107,1430,129,7
Heat Stroke,Ludhiana,Chandigarh,2021-10-01,3230,174,3056,49,7
Heat Stroke,Ludhiana,Chandigarh,2021-11-01,4989,440,4549,121,1
Heat Stroke,Ludhiana,Chandigarh,2021-12-01,4402,74,4328,150,8
Heat Stroke,Ludhiana,Chandigarh,2022-01-01,4735,306,4429,69,6
Heat Stroke,Ludhiana,Chandigarh,2022-02-01,1912,26,1886,121,7
Heat Stroke,Ludhiana,Chandigarh,2022-03-01,1270,67,1203,78,10
Heat Stroke,Ludhiana,Chandigarh,2022-04-01,2429,173,2256,200,7
Heat Stroke,Ludhiana,Chandigarh,2022-05-01,2672,117,2555,39,1
Heat Stroke,Ludhiana,Chandigarh,2022-06-01,4065,268,3797,165,7
Heat Stroke,Ludhiana,Chandigarh,2022-07-01,327,7,320,21,1
Heat Stroke,Ludhiana,Chandigarh,2022-08-01,4649,7,4642,198,5
Heat Stroke,Ludhiana,Chandigarh,2022-09-01,2385,158,2227,48,3
Heat Stroke,Ludhiana,Chandigarh,2022-10-01,2025,204,1821,116,5
Heat Stroke,Ludhiana,Chandigarh,2022-11-01,1240,26,1214,23,1
Heat Stroke,Ludhiana,Chandigarh,2022-12-01,377,32,345,37,1
Heat Stroke,Ludhiana,Chandigarh,2023-01-01,3702,190,3512,152,4
Heat Stroke,Ludhiana,Chandigarh,2023-02-01,2696,30,2666,159,4
Heat Stroke,Ludhiana,Chandigarh,2023-03-01,867,14,853,118,4
Heat Stroke,Ludhiana,Chandigarh,2023-04-01,860,43,817,144,9
Heat Stroke,Ludhiana,Chandigarh,2023-05-01,2147,82,2065,159,6
Heat Stroke,Ludhiana,Chandigarh,2023-06-01,4836,57,4779,71,6
Heat Stroke,Ludhiana,Chandigarh,2023-07-01,2249,1,2248,35,4
Heat Stroke,Ludhiana,Chandigarh,2023-08-01,581,14,567,106,1
Heat Stroke,Ludhiana,Chandigarh,2023-09-01,2268,126,2142,77,5
Heat Stroke,Ludhiana,Chandigarh,2023-10-01,2232,111,2121,126,10
Heat Stroke,Ludhiana,Chandigarh,2023-11-01,78,0,78,134,5
Heat Stroke,Ludhiana,Chandigarh,2023-12-01,2525,141,2384,71,8
Heat Stroke,Ludhiana,Chandigarh,2024-01-01,2288,183,2105,142,8
Heat Stroke,Ludhiana,Chandigarh,2024-02-01,3531,217,3314,140,6
Heat Stroke,Ludhiana,Chandigarh,2024-03-01,4989,232,4757,143,5
Heat Stroke,Ludhiana,Chandigarh,2024-04-01,4109,316,3793,85,2
Heat Stroke,Ludhiana,Chandigarh,2024-05-01,2237,49,2188,146,4
Heat Stroke,Ludhiana,Chandigarh,2024-06-01,1113,48,1065,133,4
Heat Stroke,Ludhiana,Chandigarh,2024-07-01,4989,220,4769,139,6
Heat Stroke,Ludhiana,Chandigarh,2024-08-01,2677,37,2640,192,1
Heat Stroke,Ludhiana,Chandigarh,2024-09-01,2616,99,2517,123,3
Heat Stroke,Ludhiana,Chandigarh,2024-10-01,2565,0,2565,75,6
Heat Stroke,Ludhiana,Chandigarh,2024-11-01,2863,302,2561,50,3
Heat Stroke,Ludhiana,Chandigarh,2024-12-01,2404,54,2350,164,2
Heat Stroke,Ludhiana,Chandigarh,2025-01-01,1828,175,1653,124,3
Heat Stroke,Ludhiana,Chandigarh,2025-02-01,1864,95,1769,191,4
Heat Stroke,Ludhiana,Chandigarh,2025-03-01,2553,169,2384,11,1
Heat Stroke,Ludhiana,Chandigarh,2025-04-01,1868,66,1802,153,3
Heat Stroke,Ludhiana,Chandigarh,2025-05-01,1641,92,1549,93,8
Heat Stroke,Ludhiana,Chandigarh,2025-06-01,2740,189,2551,88,6
Heat Stroke,Ludhiana,Chandigarh,2025-07-01,2255,156,2099,67,6
Heat Stroke,Ludhiana,Chandigarh,2025-08-01,4615,335,4280,152,1
Heat Stroke,Ludhiana,Chandigarh,2025-09-01,78,0,78,137,4
Heat Stroke,Ludhiana,Chandigarh,2025-10-01,4062,146,3916,48,4
Heat Stroke,Ludhiana,Chandigarh,2025-11-01,4269,15,4254,115,6
Heat Stroke,Ludhiana,Chandigarh,2025-12-01,78,0,78,142,8
Heat Stroke,Ludhiana,Himachal Pradesh,2018-01-01,2138,174,1964,115,8
Heat Stroke,Ludhiana,Himachal Pradesh,2018-02-01,2099,203,1896,163,3
Heat Stroke,Ludhiana,Himachal Pradesh,2018-03-01,709,41,668,91,3
Heat Stroke,Ludhiana,Himachal Pradesh,2018-04-01,1554,43,1511,11,9
Heat Stroke,Ludhiana,Himachal Pradesh,2018-05-01,1108,0,1108,116,4
Heat Stroke,Ludhiana,Himachal Pradesh,2018-06-01,4948,397,4551,115,2
Heat Stroke,Ludhiana,Himachal Pradesh,2018-07-01,3853,0,3853,122,4
Heat Stroke,Ludhiana,Himachal Pradesh,2018-08-01,4303,172,4131,163,9
Heat Stroke,Ludhiana,Himachal Pradesh,2018-09-01,3566,155,3411,11,2
Heat Stroke,Ludhiana,Himachal Pradesh,2018-10-01,1083,52,1031,94,4
Heat Stroke,Ludhiana,Himachal Pradesh,2018-11-01,1894,96,1798,59,2
Heat Stroke,Ludhiana,Himachal Pradesh,2018-12-01,3254,176,3078,45,8
Heat Stroke,Ludhiana,Himachal Pradesh,2019-01-01,958,0,958,103,6
Heat Stroke,Ludhiana,Himachal Pradesh,2019-02-01,3554,179,3375,142,8
Heat Stroke,Ludhiana,Himachal Pradesh,2019-03-01,2275,0,2275,122,9
Heat Stroke,Ludhiana,Himachal Pradesh,2019-04-01,2095,149,1946,71,1
Heat Stroke,Ludhiana,Himachal Pradesh,2019-05-01,3551,120,3431,99,3
Heat Stroke,Ludhiana,Himachal Pradesh,2019-06-01,3193,0,3193,154,4
Heat Stroke,Ludhiana,Himachal Pradesh,2019-07-01,2113,55,2058,141,5
Heat Stroke,Ludhiana,Himachal Pradesh,2019-08-01,4153,139,4014,78,6
Heat Stroke,Ludhiana,Himachal Pradesh,2019-09-01,1147,97,1050,75,3
Heat Stroke,Ludhiana,Himachal Pradesh,2019-10-01,3424,191,3233,19,3
Heat Stroke,Ludhiana,Himachal Pradesh,2019-11-01,3393,203,3190,84,8
Heat Stroke,Ludhiana,Himachal Pradesh,2019-12-01,2182,184,1998,18,6
Heat Stroke,Ludhiana,Himachal Pradesh,2020-01-01,3035,143,2892,200,6
Heat Stroke,Ludhiana,Himachal Pradesh,2020-02-01,919,66,853,63,1
Heat Stroke,Ludhiana,Himachal Pradesh,2020-03-01,3837,268,3569,163,8
Heat Stroke,Ludhiana,Himachal Pradesh,2020-04-01,2349,29,2320,199,5
Heat Stroke,Ludhiana,Himachal Pradesh,2020-05-01,1896,176,1720,117,4
Heat Stroke,Ludhiana,Himachal Pradesh,2020-06-01,4005,34,3971,101,2
Heat Stroke,Ludhiana,Himachal Pradesh,2020-07-01,1653,126,1527,39,3
Heat Stroke,Ludhiana,Himachal Pradesh,2020-08-01,708,4,704,81,2
Heat Stroke,Ludhiana,Himachal Pradesh,2020-09-01,509,34,475,188,1
Heat Stroke,Ludhiana,Himachal Pradesh,2020-10-01,3410,355,3055,124,2
Heat Stroke,Ludhiana,Himachal Pradesh,2020-11-01,880,38,842,108,1
Heat Stroke,Ludhiana,Himachal Pradesh,2020-12-01,4951,210,4741,173,5
Heat Stroke,Ludhiana,Himachal Pradesh,2021-01-01,78,0,78,142,1
Heat Stroke,Ludhiana,Himachal Pradesh,2021-02-01,4873,197,4676,99,7
Heat Stroke,Ludhiana,Himachal Pradesh,2021-03-01,2880,296,2584,117,1
Heat Stroke,Ludhiana,Himachal Pradesh,2021-04-01,2468,137,2331,67,8
Heat Stroke,Ludhiana,Himachal Pradesh,2021-05-01,1866,76,1790,78,7
Heat Stroke,Ludhiana,Himachal Pradesh,2021-06-01,3133,107,3026,96,2
Heat Stroke,Ludhiana,Himachal Pradesh,2021-07-01,2547,58,2489,135,5
Heat Stroke,Ludhiana,Himachal Pradesh,2021-08-01,4077,129,3948,43,2
Heat Stroke,Ludhiana,Himachal Pradesh,2021-09-01,2751,109,2642,110,7
Heat Stroke,Ludhiana,Himachal Pradesh,2021-10-01,2799,100,2699,86,10
Heat Stroke,Ludhiana,Himachal Pradesh,2021-11-01,2110,65,2045,60,8
Heat Stroke,Ludhiana,Himachal Pradesh,2021-12-01,2521,280,2241,87,3
Heat Stroke,Ludhiana,Himachal Pradesh,2022-01-01,3010,60,2950,11,5
Heat Stroke,Ludhiana,Himachal Pradesh,2022-02-01,303,16,287,68,9
Heat Stroke,Ludhiana,Himachal Pradesh,2022-03-01,789,53,736,50,6
Heat Stroke,Ludhiana,Himachal Pradesh,2022-04-01,3594,245,3349,92,8
Heat Stroke,Ludhiana,Himachal Pradesh,2022-05-01,2827,136,2691,11,7
Heat Stroke,Ludhiana,Himachal Pradesh,2022-06-01,2351,101,2250,116,5
Heat Stroke,Ludhiana,Himachal Pradesh,2022-07-01,2622,165,2457,153,5
Heat Stroke,Ludhiana,Himachal Pradesh,2022-08-01,3064,177,2887,100,1
Heat Stroke,Ludhiana,Himachal Pradesh,2022-09-01,1873,79,1794,132,3
Heat Stroke,Ludhiana,Himachal Pradesh,2022-10-01,1553,7,1546,80,2
Heat Stroke,Ludhiana,Himachal Pradesh,2022-11-01,2860,104,2756,27,4
Heat Stroke,Ludhiana,Himachal Pradesh,2022-12-01,1285,21,1264,106,5
Heat Stroke,Ludhiana,Himachal Pradesh,2023-01-01,3145,96,3049,141,5
Heat Stroke,Ludhiana,Himachal Pradesh,2023-02-01,313,15,298,39,5
Heat Stroke,Ludhiana,Himachal Pradesh,2023-03-01,3978,240,3738,83,7
Heat Stroke,Ludhiana,Himachal Pradesh,2023-04-01,3231,329,2902,94,4
Heat Stroke,Ludhiana,Himachal Pradesh,2023-05-01,2941,101,2840,200,7
Heat Stroke,Ludhiana,Himachal Pradesh,2023-06-01,3916,284,3632,118,8
Heat Stroke,Ludhiana,Himachal Pradesh,2023-07-01,4832,284,4548,11,6
Heat Stroke,Ludhiana,Himachal Pradesh,2023-08-01,3958,347,3611,11,3
Heat Stroke,Ludhiana,Himachal Pradesh,2023-09-01,128,8,120,143,8
Heat Stroke,Ludhiana,Himachal Pradesh,2023-10-01,881,18,863,200,6
Heat Stroke,Ludhiana,Himachal Pradesh,2023-11-01,1759,0,1759,92,7
Heat Stroke,Ludhiana,Himachal Pradesh,2023-12-01,2632,155,2477,89,9
Heat Stroke,Ludhiana,Himachal Pradesh,2024-01-01,3292,114,3178,128,7
Heat Stroke,Ludhiana,Himachal Pradesh,2024-02-01,1624,34,1590,66,9
Heat Stroke,Ludhiana,Himachal Pradesh,2024-03-01,2848,37,2811,11,4
Heat Stroke,Ludhiana,Himachal Pradesh,2024-04-01,1584,86,1498,159,4
Heat Stroke,Ludhiana,Himachal Pradesh,2024-05-01,1777,166,1611,75,8
Heat Stroke,Ludhiana,Himachal Pradesh,2024-06-01,710,27,683,160,2
Heat Stroke,Ludhiana,Himachal Pradesh,2024-07-01,1359,91,1268,67,10
Heat Stroke,Ludhiana,Himachal Pradesh,2024-08-01,784,36,748,112,9
Heat Stroke,Ludhiana,Himachal Pradesh,2024-09-01,1288,16,1272,150,5
Heat Stroke,Ludhiana,Himachal Pradesh,2024-10-01,4011,286,3725,161,8
Heat Stroke,Ludhiana,Himachal Pradesh,2024-11-01,1324,24,1300,118,7
Heat Stroke,Ludhiana,Himachal Pradesh,2024-12-01,4989,252,4737,116,1
Heat Stroke,Ludhiana,Himachal Pradesh,2025-01-01,3259,130,3129,138,2
Heat Stroke,Ludhiana,Himachal Pradesh,2025-02-01,2845,216,2629,130,6
Heat Stroke,Ludhiana,Himachal Pradesh,2025-03-01,1446,27,1419,40,5
Heat Stroke,Ludhiana,Himachal Pradesh,2025-04-01,3537,217,3320,41,9
Heat Stroke,Ludhiana,Himachal Pradesh,2025-05-01,1825,46,1779,11,6
Heat Stroke,Ludhiana,Himachal Pradesh,2025-06-01,2761,97,2664,145,1
Heat Stroke,Ludhiana,Himachal Pradesh,2025-07-01,4989,20,4969,86,3
Heat Stroke,Ludhiana,Himachal Pradesh,2025-08-01,2469,273,2196,148,7
Heat Stroke,Ludhiana,Himachal Pradesh,2025-09-01,4139,273,3866,127,1
Heat Stroke,Ludhiana,Himachal Pradesh,2025-10-01,1654,45,1609,55,1
Heat Stroke,Ludhiana,Himachal Pradesh,2025-11-01,2550,44,2506,100,4
Heat Stroke,Ludhiana,Himachal Pradesh,2025-12-01,4973,177,4796,83,8
Heat Stroke,Ludhiana,Jammu & Kashmir,2018-01-01,1756,124,1632,75,4
Heat Stroke,Ludhiana,Jammu & Kashmir,2018-02-01,4989,20,4969,153,6
Heat Stroke,Ludhiana,Jammu & Kashmir,2018-03-01,3547,162,3385,200,5
Heat Stroke,Ludhiana,Jammu & Kashmir,2018-04-01,1843,187,1656,163,4
Heat Stroke,Ludhiana,Jammu & Kashmir,2018-05-01,3446,58,3388,105,3
Heat Stroke,Ludhiana,Jammu & Kashmir,2018-06-01,3902,204,3698,170,7
Heat Stroke,Ludhiana,Jammu & Kashmir,2018-07-01,3432,391,3041,193,1
Heat Stroke,Ludhiana,Jammu & Kashmir,2018-08-01,491,33,458,35,4
Heat Stroke,Ludhiana,Jammu & Kashmir,2018-09-01,1622,87,1535,169,8
Heat Stroke,Ludhiana,Jammu & Kashmir,2018-10-01,2265,146,2119,145,3
Heat Stroke,Ludhiana,Jammu & Kashmir,2018-11-01,2498,95,2403,167,1
Heat Stroke,Ludhiana,Jammu & Kashmir,2018-12-01,3430,301,3129,148,1
Heat Stroke,Ludhiana,Jammu & Kashmir,2019-01-01,2836,109,2727,95,7
Heat Stroke,Ludhiana,Jammu & Kashmir,2019-02-01,806,0,806,200,7
Heat Stroke,Ludhiana,Jammu & Kashmir,2019-03-01,3107,120,2987,124,4
Heat Stroke,Ludhiana,Jammu & Kashmir,2019-04-01,3417,74,3343,84,1
Heat Stroke,Ludhiana,Jammu & Kashmir,2019-05-01,3348,140,3208,132,4
Heat Stroke,Ludhiana,Jammu & Kashmir,2019-06-01,4047,172,3875,156,8
Heat Stroke,Ludhiana,Jammu & Kashmir,2019-07-01,3716,315,3401,111,1
Heat Stroke,Ludhiana,Jammu & Kashmir,2019-08-01,3213,225,2988,126,8
Heat Stroke,Ludhiana,Jammu & Kashmir,2019-09-01,2503,144,2359,111,1
Heat Stroke,Ludhiana,Jammu & Kashmir,2019-10-01,369,18,351,73,2
Heat Stroke,Ludhiana,Jammu & Kashmir,2019-11-01,3174,61,3113,64,5
Heat Stroke,Ludhiana,Jammu & Kashmir,2019-12-01,2876,0,2876,35,8
Heat Stroke,Ludhiana,Jammu & Kashmir,2020-01-01,2962,158,2804,184,9
Heat Stroke,Ludhiana,Jammu & Kashmir,2020-02-01,885,64,821,95,8
Heat Stroke,Ludhiana,Jammu & Kashmir,2020-03-01,1147,53,1094,11,9
Heat Stroke,Ludhiana,Jammu & Kashmir,2020-04-01,4010,138,3872,126,5
Heat Stroke,Ludhiana,Jammu & Kashmir,2020-05-01,2544,161,2383,125,3
Heat Stroke,Ludhiana,Jammu & Kashmir,2020-06-01,3512,167,3345,11,8
Heat Stroke,Ludhiana,Jammu & Kashmir,2020-07-01,2635,261,2374,64,9
Heat Stroke,Ludhiana,Jammu & Kashmir,2020-08-01,2637,226,2411,62,8
Heat Stroke,Ludhiana,Jammu & Kashmir,2020-09-01,3856,300,3556,68,7
Heat Stroke,Ludhiana,Jammu & Kashmir,2020-10-01,1905,137,1768,168,9
Heat Stroke,Ludhiana,Jammu & Kashmir,2020-11-01,2726,34,2692,99,6
Heat Stroke,Ludhiana,Jammu & Kashmir,2020-12-01,1977,137,1840,84,5
Heat Stroke,Ludhiana,Jammu & Kashmir,2021-01-01,2015,122,1893,163,7
Heat Stroke,Ludhiana,Jammu & Kashmir,2021-02-01,2183,147,2036,131,6
Heat Stroke,Ludhiana,Jammu & Kashmir,2021-03-01,2895,186,2709,18,7
Heat Stroke,Ludhiana,Jammu & Kashmir,2021-04-01,1955,123,1832,75,4
Heat Stroke,Ludhiana,Jammu & Kashmir,2021-05-01,4282,442,3840,123,7
Heat Stroke,Ludhiana,Jammu & Kashmir,2021-06-01,1397,66,1331,59,7
Heat Stroke,Ludhiana,Jammu & Kashmir,2021-07-01,2347,181,2166,200,5
Heat Stroke,Ludhiana,Jammu & Kashmir,2021-08-01,2008,73,1935,112,3
Heat Stroke,Ludhiana,Jammu & Kashmir,2021-09-01,4539,331,4208,68,8
Heat Stroke,Ludhiana,Jammu & Kashmir,2021-10-01,2861,221,2640,49,1
Heat Stroke,Ludhiana,Jammu & Kashmir,2021-11-01,3982,241,3741,153,2
Heat Stroke,Ludhiana,Jammu & Kashmir,2021-12-01,605,59,546,73,5
Heat Stroke,Ludhiana,Jammu & Kashmir,2022-01-01,2956,71,2885,126,1
Heat Stroke,Ludhiana,Jammu & Kashmir,2022-02-01,3791,136,3655,48,9
Heat Stroke,Ludhiana,Jammu & Kashmir,2022-03-01,2708,152,2556,110,5
Heat Stroke,Ludhiana,Jammu & Kashmir,2022-04-01,4027,304,3723,74,9
Heat Stroke,Ludhiana,Jammu & Kashmir,2022-05-01,1903,105,1798,90,10
Heat Stroke,Ludhiana,Jammu & Kashmir,2022-06-01,4488,392,4096,66,4
Heat Stroke,Ludhiana,Jammu & Kashmir,2022-07-01,4989,153,4836,158,9
Heat Stroke,Ludhiana,Jammu & Kashmir,2022-08-01,2111,35,2076,81,2
Heat Stroke,Ludhiana,Jammu & Kashmir,2022-09-01,2000,118,1882,99,6
Heat Stroke,Ludhiana,Jammu & Kashmir,2022-10-01,4547,217,4330,101,3
Heat Stroke,Ludhiana,Jammu & Kashmir,2022-11-01,4716,310,4406,188,7
Heat Stroke,Ludhiana,Jammu & Kashmir,2022-12-01,1896,93,1803,152,7
Heat Stroke,Ludhiana,Jammu & Kashmir,2023-01-01,2034,81,1953,146,4
Heat Stroke,Ludhiana,Jammu & Kashmir,2023-02-01,2219,106,2113,26,6
Heat Stroke,Ludhiana,Jammu & Kashmir,2023-03-01,794,40,754,73,8
Heat Stroke,Ludhiana,Jammu & Kashmir,2023-04-01,1365,56,1309,167,5
Heat Stroke,Ludhiana,Jammu & Kashmir,2023-05-01,1250,55,1195,47,10
Heat Stroke,Ludhiana,Jammu & Kashmir,2023-06-01,1567,60,1507,110,4
Heat Stroke,Ludhiana,Jammu & Kashmir,2023-07-01,2551,191,2360,52,10
Heat Stroke,Ludhiana,Jammu & Kashmir,2023-08-01,2912,162,2750,57,8
Heat Stroke,Ludhiana,Jammu & Kashmir,2023-09-01,4677,442,4235,192,1
Heat Stroke,Ludhiana,Jammu & Kashmir,2023-10-01,1258,68,1190,143,9
Heat Stroke,Ludhiana,Jammu & Kashmir,2023-11-01,3918,133,3785,156,8
Heat Stroke,Ludhiana,Jammu & Kashmir,2023-12-01,2310,295,2015,146,5
Heat Stroke,Ludhiana,Jammu & Kashmir,2024-01-01,2531,157,2374,99,6
Heat Stroke,Ludhiana,Jammu & Kashmir,2024-02-01,3503,276,3227,71,6
Heat Stroke,Ludhiana,Jammu & Kashmir,2024-03-01,1091,73,1018,86,9
Heat Stroke,Ludhiana,Jammu & Kashmir,2024-04-01,3110,212,2898,96,4
Heat Stroke,Ludhiana,Jammu & Kashmir,2024-05-01,2821,185,2636,197,9
Heat Stroke,Ludhiana,Jammu & Kashmir,2024-06-01,3258,58,3200,38,2
Heat Stroke,Ludhiana,Jammu & Kashmir,2024-07-01,2985,181,2804,78,1
Heat Stroke,Ludhiana,Jammu & Kashmir,2024-08-01,4989,57,4932,60,7
Heat Stroke,Ludhiana,Jammu & Kashmir,2024-09-01,1742,78,1664,160,8
Heat Stroke,Ludhiana,Jammu & Kashmir,2024-10-01,1885,54,1831,200,4
Heat Stroke,Ludhiana,Jammu & Kashmir,2024-11-01,1761,106,1655,122,1
Heat Stroke,Ludhiana,Jammu & Kashmir,2024-12-01,1852,110,1742,126,1
Heat Stroke,Ludhiana,Jammu & Kashmir,2025-01-01,1742,111,1631,111,6
Heat Stroke,Ludhiana,Jammu & Kashmir,2025-02-01,4192,244,3948,128,5
Heat Stroke,Ludhiana,Jammu & Kashmir,2025-03-01,4503,145,4358,146,9
Heat Stroke,Ludhiana,Jammu & Kashmir,2025-04-01,1832,77,1755,128,5
Heat Stroke,Ludhiana,Jammu & Kashmir,2025-05-01,1481,113,1368,132,3
Heat Stroke,Ludhiana,Jammu & Kashmir,2025-06-01,3230,262,2968,146,6
Heat Stroke,Ludhiana,Jammu & Kashmir,2025-07-01,1857,31,1826,16,8
Heat Stroke,Ludhiana,Jammu & Kashmir,2025-08-01,3446,19,3427,106,9
Heat Stroke,Ludhiana,Jammu & Kashmir,2025-09-01,2870,82,2788,122,4
Heat Stroke,Ludhiana,Jammu & Kashmir,2025-10-01,564,45,519,127,5
Heat Stroke,Ludhiana,Jammu & Kashmir,2025-11-01,4673,399,4274,98,7
Heat Stroke,Ludhiana,Jammu & Kashmir,2025-12-01,4989,115,4874,114,3
Heat Stroke,Ludhiana,Haryana,2018-01-01,1775,104,1671,70,7
Heat Stroke,Ludhiana,Haryana,2018-02-01,2077,214,1863,16,4
Heat Stroke,Ludhiana,Haryana,2018-03-01,2981,185,2796,156,5
Heat Stroke,Ludhiana,Haryana,2018-04-01,3046,278,2768,48,5
Heat Stroke,Ludhiana,Haryana,2018-05-01,3481,275,3206,98,5
Heat Stroke,Ludhiana,Haryana,2018-06-01,4989,117,4872,68,10
Heat Stroke,Ludhiana,Haryana,2018-07-01,2360,105,2255,187,3
Heat Stroke,Ludhiana,Haryana,2018-08-01,1526,77,1449,102,4
Heat Stroke,Ludhiana,Haryana,2018-09-01,747,39,708,90,9
Heat Stroke,Ludhiana,Haryana,2018-10-01,1617,124,1493,144,6
Heat Stroke,Ludhiana,Haryana,2018-11-01,2553,158,2395,200,7
Heat Stroke,Ludhiana,Haryana,2018-12-01,4989,20,4969,127,2
Heat Stroke,Ludhiana,Haryana,2019-01-01,1903,22,1881,87,6
Heat Stroke,Ludhiana,Haryana,2019-02-01,2898,0,2898,142,7
Heat Stroke,Ludhiana,Haryana,2019-03-01,2575,142,2433,26,3
Heat Stroke,Ludhiana,Haryana,2019-04-01,4192,239,3953,109,7
Heat Stroke,Ludhiana,Haryana,2019-05-01,4989,290,4699,200,4
Heat Stroke,Ludhiana,Haryana,2019-06-01,1885,41,1844,114,3
Heat Stroke,Ludhiana,Haryana,2019-07-01,1941,135,1806,112,8
Heat Stroke,Ludhiana,Haryana,2019-08-01,3998,283,3715,107,8
Heat Stroke,Ludhiana,Haryana,2019-09-01,3512,47,3465,86,5
Heat Stroke,Ludhiana,Haryana,2019-10-01,4989,36,4953,122,6
Heat Stroke,Ludhiana,Haryana,2019-11-01,3381,169,3212,146,9
Heat Stroke,Ludhiana,Haryana,2019-12-01,2115,216,1899,89,4
Heat Stroke,Ludhiana,Haryana,2020-01-01,3390,337,3053,11,6
Heat Stroke,Ludhiana,Haryana,2020-02-01,4085,271,3814,130,4
Heat Stroke,Ludhiana,Haryana,2020-03-01,3698,106,3592,200,2
Heat Stroke,Ludhiana,Haryana,2020-04-01,3278,248,3030,87,4
Heat Stroke,Ludhiana,Haryana,2020-05-01,4028,148,3880,31,2
Heat Stroke,Ludhiana,Haryana,2020-06-01,4166,115,4051,141,6
Heat Stroke,Ludhiana,Haryana,2020-07-01,4452,0,4452,195,3
Heat Stroke,Ludhiana,Haryana,2020-08-01,3468,183,3285,133,1
Heat Stroke,Ludhiana,Haryana,2020-09-01,2373,75,2298,194,7
Heat Stroke,Ludhiana,Haryana,2020-10-01,2794,147,2647,147,7
Heat Stroke,Ludhiana,Haryana,2020-11-01,4216,0,4216,142,4
Heat Stroke,Ludhiana,Haryana,2020-12-01,1501,82,1419,80,7
Heat Stroke,Ludhiana,Haryana,2021-01-01,3092,0,3092,121,2
Heat Stroke,Ludhiana,Haryana,2021-02-01,2070,169,1901,105,4
Heat Stroke,Ludhiana,Haryana,2021-03-01,2636,172,2464,103,6
Heat Stroke,Ludhiana,Haryana,2021-04-01,4312,180,4132,93,8
Heat Stroke,Ludhiana,Haryana,2021-05-01,2854,189,2665,118,4
Heat Stroke,Ludhiana,Haryana,2021-06-01,2660,57,2603,40,3
Heat Stroke,Ludhiana,Haryana,2021-07-01,773,40,733,148,8
Heat Stroke,Ludhiana,Haryana,2021-08-01,3599,263,3336,61,7
Heat Stroke,Ludhiana,Haryana,2021-09-01,3463,0,3463,93,5
Heat Stroke,Ludhiana,Haryana,2021-10-01,4989,184,4805,123,8
Heat Stroke,Ludhiana,Haryana,2021-11-01,2185,107,2078,59,10
Heat Stroke,Ludhiana,Haryana,2021-12-01,2891,128,2763,11,6
Heat Stroke,Ludhiana,Haryana,2022-01-01,2932,271,2661,87,3
Heat Stroke,Ludhiana,Haryana,2022-02-01,4714,81,4633,33,6
Heat Stroke,Ludhiana,Haryana,2022-03-01,2470,79,2391,142,2
Heat Stroke,Ludhiana,Haryana,2022-04-01,2972,0,2972,47,8
Heat Stroke,Ludhiana,Haryana,2022-05-01,3413,320,3093,182,3
Heat Stroke,Ludhiana,Haryana,2022-06-01,2848,122,2726,106,4
Heat Stroke,Ludhiana,Haryana,2022-07-01,1999,74,1925,109,2
Heat Stroke,Ludhiana,Haryana,2022-08-01,2858,138,2720,11,5
Heat Stroke,Ludhiana,Haryana,2022-09-01,4038,276,3762,114,5
Heat Stroke,Ludhiana,Haryana,2022-10-01,1220,73,1147,102,7
Heat Stroke,Ludhiana,Haryana,2022-11-01,2776,352,2424,40,5
Heat Stroke,Ludhiana,Haryana,2022-12-01,1658,104,1554,111,5
Heat Stroke,Ludhiana,Haryana,2023-01-01,4201,153,4048,86,3
Heat Stroke,Ludhiana,Haryana,2023-02-01,554,18,536,95,4
Heat Stroke,Ludhiana,Haryana,2023-03-01,1848,71,1777,108,1
Heat Stroke,Ludhiana,Haryana,2023-04-01,3103,19,3084,82,9
Heat Stroke,Ludhiana,Haryana,2023-05-01,4698,240,4458,119,5
Heat Stroke,Ludhiana,Haryana,2023-06-01,2509,182,2327,102,10
Heat Stroke,Ludhiana,Haryana,2023-07-01,1853,59,1794,130,4
Heat Stroke,Ludhiana,Haryana,2023-08-01,4989,132,4857,79,1
Heat Stroke,Ludhiana,Haryana,2023-09-01,655,61,594,52,4
Heat Stroke,Ludhiana,Haryana,2023-10-01,78,0,78,70,5
Heat Stroke,Ludhiana,Haryana,2023-11-01,3188,0,3188,180,5
Heat Stroke,Ludhiana,Haryana,2023-12-01,1924,31,1893,155,7
Heat Stroke,Ludhiana,Haryana,2024-01-01,1227,6,1221,168,5
Heat Stroke,Ludhiana,Haryana,2024-02-01,3548,217,3331,172,4
Heat Stroke,Ludhiana,Haryana,2024-03-01,2924,115,2809,82,2
Heat Stroke,Ludhiana,Haryana,2024-04-01,1841,80,1761,121,4
Heat Stroke,Ludhiana,Haryana,2024-05-01,880,73,807,110,7
Heat Stroke,Ludhiana,Haryana,2024-06-01,3768,112,3656,140,7
Heat Stroke,Ludhiana,Haryana,2024-07-01,3470,252,3218,91,3
Heat Stroke,Ludhiana,Haryana,2024-08-01,2464,231,2233,111,8
Heat Stroke,Ludhiana,Haryana,2024-09-01,4989,183,4806,110,6
Heat Stroke,Ludhiana,Haryana,2024-10-01,1162,83,1079,133,2
Heat Stroke,Ludhiana,Haryana,2024-11-01,551,23,528,140,6
Heat Stroke,Ludhiana,Haryana,2024-12-01,1669,128,1541,111,6
Heat Stroke,Ludhiana,Haryana,2025-01-01,2536,10,2526,113,2
Heat Stroke,Ludhiana,Haryana,2025-02-01,2924,6,2918,118,1
Heat Stroke,Ludhiana,Haryana,2025-03-01,2274,87,2187,190,6
Heat Stroke,Ludhiana,Haryana,2025-04-01,3070,74,2996,18,4
Heat Stroke,Ludhiana,Haryana,2025-05-01,918,32,886,57,9
Heat Stroke,Ludhiana,Haryana,2025-06-01,4534,198,4336,141,10
Heat Stroke,Ludhiana,Haryana,2025-07-01,2487,176,2311,120,6
Heat Stroke,Ludhiana,Haryana,2025-08-01,4096,156,3940,120,8
Heat Stroke,Ludhiana,Haryana,2025-09-01,3057,79,2978,140,2
Heat Stroke,Ludhiana,Haryana,2025-10-01,3210,127,3083,117,1
Heat Stroke,Ludhiana,Haryana,2025-11-01,3362,93,3269,78,4
Heat Stroke,Ludhiana,Haryana,2025-12-01,3198,73,3125,138,1
Heat Stroke,Chandigarh,Punjab,2018-01-01,3460,10,3450,107,6
Heat Stroke,Chandigarh,Punjab,2018-02-01,4380,228,4152,83,3
Heat Stroke,Chandigarh,Punjab,2018-03-01,2861,95,2766,141,5
Heat Stroke,Chandigarh,Punjab,2018-04-01,3549,277,3272,139,4
Heat Stroke,Chandigarh,Punjab,2018-05-01,2477,19,2458,117,7
Heat Stroke,Chandigarh,Punjab,2018-06-01,4529,155,4374,194,6
Heat Stroke,Chandigarh,Punjab,2018-07-01,1690,173,1517,174,4
Heat Stroke,Chandigarh,Punjab,2018-08-01,4989,113,4876,157,1
Heat Stroke,Chandigarh,Punjab,2018-09-01,2544,109,2435,200,5
Heat Stroke,Chandigarh,Punjab,2018-10-01,678,9,669,99,1
Heat Stroke,Chandigarh,Punjab,2018-11-01,2769,29,2740,83,8
Heat Stroke,Chandigarh,Punjab,2018-12-01,1684,160,1524,150,6
Heat Stroke,Chandigarh,Punjab,2019-01-01,3725,205,3520,93,7
Heat Stroke,Chandigarh,Punjab,2019-02-01,1722,92,1630,107,2
Heat Stroke,Chandigarh,Punjab,2019-03-01,1999,1,1998,56,6
Heat Stroke,Chandigarh,Punjab,2019-04-01,78,0,78,137,3
Heat Stroke,Chandigarh,Punjab,2019-05-01,1991,166,1825,31,5
Heat Stroke,Chandigarh,Punjab,2019-06-01,78,0,78,101,2
Heat Stroke,Chandigarh,Punjab,2019-07-01,473,32,441,105,5
Heat Stroke,Chandigarh,Punjab,2019-08-01,3618,62,3556,84,1
Heat Stroke,Chandigarh,Punjab,2019-09-01,3652,216,3436,17,4
Heat Stroke,Chandigarh,Punjab,2019-10-01,3168,220,2948,16,1
Heat Stroke,Chandigarh,Punjab,2019-11-01,1300,0,1300,68,10
Heat Stroke,Chandigarh,Punjab,2019-12-01,2533,44,2489,134,5
Heat Stroke,Chandigarh,Punjab,2020-01-01,2593,196,2397,121,5
Heat Stroke,Chandigarh,Punjab,2020-02-01,1043,78,965,105,7
Heat Stroke,Chandigarh,Punjab,2020-03-01,4614,23,4591,61,1
Heat Stroke,Chandigarh,Punjab,2020-04-01,3774,276,3498,124,3
Heat Stroke,Chandigarh,Punjab,2020-05-01,2301,121,2180,15,6
Heat Stroke,Chandigarh,Punjab,2020-06-01,2633,191,2442,11,5
Heat Stroke,Chandigarh,Punjab,2020-07-01,2877,90,2787,94,3
Heat Stroke,Chandigarh,Punjab,2020-08-01,78,0,78,78,7
Heat Stroke,Chandigarh,Punjab,2020-09-01,2266,169,2097,158,6
Heat Stroke,Chandigarh,Punjab,2020-10-01,1683,67,1616,114,6
Heat Stroke,Chandigarh,Punjab,2020-11-01,1254,63,1191,190,6
Heat Stroke,Chandigarh,Punjab,2020-12-01,2220,69,2151,78,3
Heat Stroke,Chandigarh,Punjab,2021-01-01,4989,442,4547,131,5
Heat Stroke,Chandigarh,Punjab,2021-02-01,3457,160,3297,93,1
Heat Stroke,Chandigarh,Punjab,2021-03-01,1831,42,1789,177,3
Heat Stroke,Chandigarh,Punjab,2021-04-01,3366,98,3268,96,4
Heat Stroke,Chandigarh,Punjab,2021-05-01,4475,240,4235,150,7
Heat Stroke,Chandigarh,Punjab,2021-06-01,3838,276,3562,51,6
Heat Stroke,Chandigarh,Punjab,2021-07-01,2677,29,2648,85,3
Heat Stroke,Chandigarh,Punjab,2021-08-01,1730,179,1551,102,3
Heat Stroke,Chandigarh,Punjab,2021-09-01,3534,208,3326,171,9
Heat Stroke,Chandigarh,Punjab,2021-10-01,3125,198,2927,11,4
Heat Stroke,Chandigarh,Punjab,2021-11-01,3798,179,3619,89,5
Heat Stroke,Chandigarh,Punjab,2021-12-01,3449,174,3275,88,7
Heat Stroke,Chandigarh,Punjab,2022-01-01,4005,183,3822,11,5
Heat Stroke,Chandigarh,Punjab,2022-02-01,1879,149,1730,83,4
Heat Stroke,Chandigarh,Punjab,2022-03-01,4365,217,4148,28,4
Heat Stroke,Chandigarh,Punjab,2022-04-01,2862,207,2655,11,3
Heat Stroke,Chandigarh,Punjab,2022-05-01,4989,186,4803,93,5
Heat Stroke,Chandigarh,Punjab,2022-06-01,1673,93,1580,91,1
Heat Stroke,Chandigarh,Punjab,2022-07-01,4926,131,4795,94,4
Heat Stroke,Chandigarh,Punjab,2022-08-01,2863,244,2619,119,6
Heat Stroke,Chandigarh,Punjab,2022-09-01,1724,44,1680,61,6
Heat Stroke,Chandigarh,Punjab,2022-10-01,1948,79,1869,197,9
Heat Stroke,Chandigarh,Punjab,2022-11-01,2168,88,2080,105,7
Heat Stroke,Chandigarh,Punjab,2022-12-01,3166,125,3041,172,6
Heat Stroke,Chandigarh,Punjab,2023-01-01,3299,234,3065,21,5
Heat Stroke,Chandigarh,Punjab,2023-02-01,1828,74,1754,64,3
Heat Stroke,Chandigarh,Punjab,2023-03-01,2565,232,2333,141,6
Heat Stroke,Chandigarh,Punjab,2023-04-01,4989,130,4859,95,6
Heat Stroke,Chandigarh,Punjab,2023-05-01,4915,270,4645,52,4
Heat Stroke,Chandigarh,Punjab,2023-06-01,3183,87,3096,13,2
Heat Stroke,Chandigarh,Punjab,2023-07-01,2648,165,2483,144,5
Heat Stroke,Chandigarh,Punjab,2023-08-01,2758,136,2622,139,8
Heat Stroke,Chandigarh,Punjab,2023-09-01,3420,155,3265,119,5
Heat Stroke,Chandigarh,Punjab,2023-10-01,1225,103,1122,81,5
Heat Stroke,Chandigarh,Punjab,2023-11-01,2252,69,2183,50,6
Heat Stroke,Chandigarh,Punjab,2023-12-01,359,24,335,104,6
Heat Stroke,Chandigarh,Punjab,2024-01-01,3133,86,3047,39,6
Heat Stroke,Chandigarh,Punjab,2024-02-01,3466,184,3282,68,5
Heat Stroke,Chandigarh,Punjab,2024-03-01,1949,29,1920,170,3
Heat Stroke,Chandigarh,Punjab,2024-04-01,4709,144,4565,12,8
Heat Stroke,Chandigarh,Punjab,2024-05-01,953,45,908,141,4
Heat Stroke,Chandigarh,Punjab,2024-06-01,633,65,568,182,9
Heat Stroke,Chandigarh,Punjab,2024-07-01,2899,153,2746,148,5
Heat Stroke,Chandigarh,Punjab,2024-08-01,4002,393,3609,126,5
Heat Stroke,Chandigarh,Punjab,2024-09-01,4856,274,4582,83,7
Heat Stroke,Chandigarh,Punjab,2024-10-01,1982,76,1906,73,3
Heat Stroke,Chandigarh,Punjab,2024-11-01,4044,383,3661,11,6
Heat Stroke,Chandigarh,Punjab,2024-12-01,2546,159,2387,108,5
Heat Stroke,Chandigarh,Punjab,2025-01-01,2366,74,2292,86,6
Heat Stroke,Chandigarh,Punjab,2025-02-01,3783,241,3542,71,3
Heat Stroke,Chandigarh,Punjab,2025-03-01,3473,144,3329,105,3
Heat Stroke,Chandigarh,Punjab,2025-04-01,483,0,483,109,1
Heat Stroke,Chandigarh,Punjab,2025-05-01,4578,353,4225,74,3
Heat Stroke,Chandigarh,Punjab,2025-06-01,4449,364,4085,188,3
Heat Stroke,Chandigarh,Punjab,2025-07-01,1758,182,1576,143,3
Heat Stroke,Chandigarh,Punjab,2025-08-01,3128,195,2933,152,4
Heat Stroke,Chandigarh,Punjab,2025-09-01,3260,139,3121,101,5
Heat Stroke,Chandigarh,Punjab,2025-10-01,2947,219,2728,132,6
Heat Stroke,Chandigarh,Punjab,2025-11-01,1859,139,1720,61,6
Heat Stroke,Chandigarh,Punjab,2025-12-01,1696,165,1531,140,7
Heat Stroke,Chandigarh,Chandigarh,2018-01-01,2563,125,2438,96,7
Heat Stroke,Chandigarh,Chandigarh,2018-02-01,4171,188,3983,54,6
Heat Stroke,Chandigarh,Chandigarh,2018-03-01,3327,97,3230,105,5
Heat Stroke,Chandigarh,Chandigarh,2018-04-01,2100,137,1963,91,8
Heat Stroke,Chandigarh,Chandigarh,2018-05-01,3633,18,3615,200,7
Heat Stroke,Chandigarh,Chandigarh,2018-06-01,78,0,78,128,1
Heat Stroke,Chandigarh,Chandigarh,2018-07-01,4138,277,3861,187,4
Heat Stroke,Chandigarh,Chandigarh,2018-08-01,264,17,247,164,1
Heat Stroke,Chandigarh,Chandigarh,2018-09-01,2111,114,1997,108,1
Heat Stroke,Chandigarh,Chandigarh,2018-10-01,1095,103,992,84,3
Heat Stroke,Chandigarh,Chandigarh,2018-11-01,861,64,797,18,4
Heat Stroke,Chandigarh,Chandigarh,2018-12-01,4155,134,4021,62,4
Heat Stroke,Chandigarh,Chandigarh,2019-01-01,1970,64,1906,140,1
Heat Stroke,Chandigarh,Chandigarh,2019-02-01,3062,74,2988,91,7
Heat Stroke,Chandigarh,Chandigarh,2019-03-01,2534,167,2367,125,3
Heat Stroke,Chandigarh,Chandigarh,2019-04-01,3237,67,3170,11,6
Heat Stroke,Chandigarh,Chandigarh,2019-05-01,2700,220,2480,129,3
Heat Stroke,Chandigarh,Chandigarh,2019-06-01,876,77,799,162,3
Heat Stroke,Chandigarh,Chandigarh,2019-07-01,3934,96,3838,16,6
Heat Stroke,Chandigarh,Chandigarh,2019-08-01,1935,86,1849,125,4
Heat Stroke,Chandigarh,Chandigarh,2019-09-01,509,25,484,175,5
Heat Stroke,Chandigarh,Chandigarh,2019-10-01,2023,153,1870,192,6
Heat Stroke,Chandigarh,Chandigarh,2019-11-01,4611,442,4169,81,1
Heat Stroke,Chandigarh,Chandigarh,2019-12-01,3738,3,3735,146,6
Heat Stroke,Chandigarh,Chandigarh,2020-01-01,2130,86,2044,179,2
Heat Stroke,Chandigarh,Chandigarh,2020-02-01,2129,90,2039,127,2
Heat Stroke,Chandigarh,Chandigarh,2020-03-01,2166,20,2146,172,3
Heat Stroke,Chandigarh,Chandigarh,2020-04-01,4989,179,4810,104,7
Heat Stroke,Chandigarh,Chandigarh,2020-05-01,3110,194,2916,126,1
Heat Stroke,Chandigarh,Chandigarh,2020-06-01,3174,133,3041,75,7
Heat Stroke,Chandigarh,Chandigarh,2020-07-01,3980,20,3960,98,6
Heat Stroke,Chandigarh,Chandigarh,2020-08-01,2918,390,2528,128,5
Heat Stroke,Chandigarh,Chandigarh,2020-09-01,2250,130,2120,71,6
Heat Stroke,Chandigarh,Chandigarh,2020-10-01,2334,124,2210,95,4
Heat Stroke,Chandigarh,Chandigarh,2020-11-01,2501,45,2456,145,7
Heat Stroke,Chandigarh,Chandigarh,2020-12-01,2547,146,2401,200,4
Heat Stroke,Chandigarh,Chandigarh,2021-01-01,3574,161,3413,11,1
Heat Stroke,Chandigarh,Chandigarh,2021-02-01,2667,0,2667,200,5
Heat Stroke,Chandigarh,Chandigarh,2021-03-01,3580,67,3513,93,7
Heat Stroke,Chandigarh,Chandigarh,2021-04-01,2489,182,2307,155,6
Heat Stroke,Chandigarh,Chandigarh,2021-05-01,2703,288,2415,165,10
Heat Stroke,Chandigarh,Chandigarh,2021-06-01,78,0,78,186,4
Heat Stroke,Chandigarh,Chandigarh,2021-07-01,3827,314,3513,69,4
Heat Stroke,Chandigarh,Chandigarh,2021-08-01,3062,139,2923,95,4
Heat Stroke,Chandigarh,Chandigarh,2021-09-01,3936,187,3749,103,3
Heat Stroke,Chandigarh,Chandigarh,2021-10-01,78,0,78,88,3
Heat Stroke,Chandigarh,Chandigarh,2021-11-01,4989,442,4547,173,2
Heat Stroke,Chandigarh,Chandigarh,2021-12-01,2410,211,2199,102,1
Heat Stroke,Chandigarh,Chandigarh,2022-01-01,4084,77,4007,24,3
Heat Stroke,Chandigarh,Chandigarh,2022-02-01,1202,57,1145,74,5
Heat Stroke,Chandigarh,Chandigarh,2022-03-01,3419,198,3221,26,7
Heat Stroke,Chandigarh,Chandigarh,2022-04-01,1184,50,1134,95,3
Heat Stroke,Chandigarh,Chandigarh,2022-05-01,1761,108,1653,140,3
Heat Stroke,Chandigarh,Chandigarh,2022-06-01,4989,368,4621,73,8
Heat Stroke,Chandigarh,Chandigarh,2022-07-01,2342,185,2157,86,1
Heat Stroke,Chandigarh,Chandigarh,2022-08-01,2889,286,2603,92,4
Heat Stroke,Chandigarh,Chandigarh,2022-09-01,3765,152,3613,113,8
Heat Stroke,Chandigarh,Chandigarh,2022-10-01,3262,33,3229,133,3
Heat Stroke,Chandigarh,Chandigarh,2022-11-01,2799,169,2630,147,1
Heat Stroke,Chandigarh,Chandigarh,2022-12-01,3087,323,2764,200,10
Heat Stroke,Chandigarh,Chandigarh,2023-01-01,4989,180,4809,113,7
Heat Stroke,Chandigarh,Chandigarh,2023-02-01,2520,176,2344,144,7
Heat Stroke,Chandigarh,Chandigarh,2023-03-01,2867,201,2666,25,5
Heat Stroke,Chandigarh,Chandigarh,2023-04-01,4007,222,3785,87,7
Heat Stroke,Chandigarh,Chandigarh,2023-05-01,4080,205,3875,92,1
Heat Stroke,Chandigarh,Chandigarh,2023-06-01,4190,97,4093,54,4
Heat Stroke,Chandigarh,Chandigarh,2023-07-01,3454,0,3454,79,8
Heat Stroke,Chandigarh,Chandigarh,2023-08-01,1064,18,1046,101,1
Heat Stroke,Chandigarh,Chandigarh,2023-09-01,4789,185,4604,80,4
Heat Stroke,Chandigarh,Chandigarh,2023-10-01,1060,86,974,200,6
Heat Stroke,Chandigarh,Chandigarh,2023-11-01,3003,141,2862,132,3
Heat Stroke,Chandigarh,Chandigarh,2023-12-01,1586,55,1531,200,5
Heat Stroke,Chandigarh,Chandigarh,2024-01-01,2511,60,2451,182,6
Heat Stroke,Chandigarh,Chandigarh,2024-02-01,3038,210,2828,74,6
Heat Stroke,Chandigarh,Chandigarh,2024-03-01,3029,271,2758,108,4
Heat Stroke,Chandigarh,Chandigarh,2024-04-01,3163,256,2907,84,2
Heat Stroke,Chandigarh,Chandigarh,2024-05-01,4762,322,4440,98,6
Heat Stroke,Chandigarh,Chandigarh,2024-06-01,3206,22,3184,56,6
Heat Stroke,Chandigarh,Chandigarh,2024-07-01,2270,90,2180,84,6
Heat Stroke,Chandigarh,Chandigarh,2024-08-01,3891,415,3476,125,5
Heat Stroke,Chandigarh,Chandigarh,2024-09-01,4193,346,3847,123,6
Heat Stroke,Chandigarh,Chandigarh,2024-10-01,951,5,946,119,7
Heat Stroke,Chandigarh,Chandigarh,2024-11-01,3399,164,3235,103,6
Heat Stroke,Chandigarh,Chandigarh,2024-12-01,3538,214,3324,150,5
Heat Stroke,Chandigarh,Chandigarh,2025-01-01,2198,61,2137,93,3
Heat Stroke,Chandigarh,Chandigarh,2025-02-01,4443,0,4443,177,9
Heat Stroke,Chandigarh,Chandigarh,2025-03-01,2396,126,2270,12,2
Heat Stroke,Chandigarh,Chandigarh,2025-04-01,2766,75,2691,140,4
Heat Stroke,Chandigarh,Chandigarh,2025-05-01,2365,64,2301,131,3
Heat Stroke,Chandigarh,Chandigarh,2025-06-01,2618,104,2514,72,1
Heat Stroke,Chandigarh,Chandigarh,2025-07-01,1127,52,1075,88,6
Heat Stroke,Chandigarh,Chandigarh,2025-08-01,666,33,633,130,4
Heat Stroke,Chandigarh,Chandigarh,2025-09-01,4736,115,4621,153,5
Heat Stroke,Chandigarh,Chandigarh,2025-10-01,1461,63,1398,17,4
Heat Stroke,Chandigarh,Chandigarh,2025-11-01,1267,0,1267,138,7
Heat Stroke,Chandigarh,Chandigarh,2025-12-01,78,0,78,83,7
Heat Stroke,Chandigarh,Himachal Pradesh,2018-01-01,1740,0,1740,164,2
Heat Stroke,Chandigarh,Himachal Pradesh,2018-02-01,822,34,788,13,10
Heat Stroke,Chandigarh,Himachal Pradesh,2018-03-01,4800,368,4432,200,4
Heat Stroke,Chandigarh,Himachal Pradesh,2018-04-01,3952,76,3876,61,7
Heat Stroke,Chandigarh,Himachal Pradesh,2018-05-01,1674,118,1556,179,5
Heat Stroke,Chandigarh,Himachal Pradesh,2018-06-01,4989,417,4572,103,5
Heat Stroke,Chandigarh,Himachal Pradesh,2018-07-01,3914,0,3914,65,6
Heat Stroke,Chandigarh,Himachal Pradesh,2018-08-01,2162,98,2064,120,9
Heat Stroke,Chandigarh,Himachal Pradesh,2018-09-01,78,0,78,159,7
Heat Stroke,Chandigarh,Himachal Pradesh,2018-10-01,4989,232,4757,27,4
Heat Stroke,Chandigarh,Himachal Pradesh,2018-11-01,733,36,697,142,5
Heat Stroke,Chandigarh,Himachal Pradesh,2018-12-01,390,0,390,106,3
Heat Stroke,Chandigarh,Himachal Pradesh,2019-01-01,3969,421,3548,136,7
Heat Stroke,Chandigarh,Himachal Pradesh,2019-02-01,4989,291,4698,107,7
Heat Stroke,Chandigarh,Himachal Pradesh,2019-03-01,4454,112,4342,77,4
Heat Stroke,Chandigarh,Himachal Pradesh,2019-04-01,3354,310,3044,50,9
Heat Stroke,Chandigarh,Himachal Pradesh,2019-05-01,3395,0,3395,140,8
Heat Stroke,Chandigarh,Himachal Pradesh,2019-06-01,3742,53,3689,140,10
Heat Stroke,Chandigarh,Himachal Pradesh,2019-07-01,3616,0,3616,140,3
Heat Stroke,Chandigarh,Himachal Pradesh,2019-08-01,2975,304,2671,128,5
Heat Stroke,Chandigarh,Himachal Pradesh,2019-09-01,2737,163,2574,154,4
Heat Stroke,Chandigarh,Himachal Pradesh,2019-10-01,2513,174,2339,178,10
Heat Stroke,Chandigarh,Himachal Pradesh,2019-11-01,1586,93,1493,11,5
Heat Stroke,Chandigarh,Himachal Pradesh,2019-12-01,2221,148,2073,11,8
Heat Stroke,Chandigarh,Himachal Pradesh,2020-01-01,326,17,309,194,8
Heat Stroke,Chandigarh,Himachal Pradesh,2020-02-01,2465,142,2323,38,5
Heat Stroke,Chandigarh,Himachal Pradesh,2020-03-01,1271,67,1204,51,5
Heat Stroke,Chandigarh,Himachal Pradesh,2020-04-01,1117,36,1081,92,6
Heat Stroke,Chandigarh,Himachal Pradesh,2020-05-01,2839,138,2701,22,8
Heat Stroke,Chandigarh,Himachal Pradesh,2020-06-01,4465,259,4206,87,4
Heat Stroke,Chandigarh,Himachal Pradesh,2020-07-01,3829,204,3625,58,3
Heat Stroke,Chandigarh,Himachal Pradesh,2020-08-01,491,3,488,94,8
Heat Stroke,Chandigarh,Himachal Pradesh,2020-09-01,1270,13,1257,120,1
Heat Stroke,Chandigarh,Himachal Pradesh,2020-10-01,3859,314,3545,89,6
Heat Stroke,Chandigarh,Himachal Pradesh,2020-11-01,1279,52,1227,86,8
Heat Stroke,Chandigarh,Himachal Pradesh,2020-12-01,2296,154,2142,119,6
Heat Stroke,Chandigarh,Himachal Pradesh,2021-01-01,3335,60,3275,159,3
Heat Stroke,Chandigarh,Himachal Pradesh,2021-02-01,1298,9,1289,188,2
Heat Stroke,Chandigarh,Himachal Pradesh,2021-03-01,2739,69,2670,95,8
Heat Stroke,Chandigarh,Himachal Pradesh,2021-04-01,808,35,773,199,4
Heat Stroke,Chandigarh,Himachal Pradesh,2021-05-01,1791,55,1736,151,2
Heat Stroke,Chandigarh,Himachal Pradesh,2021-06-01,3026,265,2761,43,8
Heat Stroke,Chandigarh,Himachal Pradesh,2021-07-01,460,25,435,42,7
Heat Stroke,Chandigarh,Himachal Pradesh,2021-08-01,3188,331,2857,77,2
Heat Stroke,Chandigarh,Himachal Pradesh,2021-09-01,2571,158,2413,180,10
Heat Stroke,Chandigarh,Himachal Pradesh,2021-10-01,3339,0,3339,81,3
Heat Stroke,Chandigarh,Himachal Pradesh,2021-11-01,2898,234,2664,11,7
Heat Stroke,Chandigarh,Himachal Pradesh,2021-12-01,4427,27,4400,95,10
Heat Stroke,Chandigarh,Himachal Pradesh,2022-01-01,2765,156,2609,11,7
Heat Stroke,Chandigarh,Himachal Pradesh,2022-02-01,2021,55,1966,52,6
Heat Stroke,Chandigarh,Himachal Pradesh,2022-03-01,2761,310,2451,76,1
Heat Stroke,Chandigarh,Himachal Pradesh,2022-04-01,3326,305,3021,114,10
Heat Stroke,Chandigarh,Himachal Pradesh,2022-05-01,2663,75,2588,158,7
Heat Stroke,Chandigarh,Himachal Pradesh,2022-06-01,2652,122,2530,142,1
Heat Stroke,Chandigarh,Himachal Pradesh,2022-07-01,1656,94,1562,46,9
Heat Stroke,Chandigarh,Himachal Pradesh,2022-08-01,1708,128,1580,87,5
Heat Stroke,Chandigarh,Himachal Pradesh,2022-09-01,716,36,680,110,4
Heat Stroke,Chandigarh,Himachal Pradesh,2022-10-01,4944,100,4844,93,3
Heat Stroke,Chandigarh,Himachal Pradesh,2022-11-01,929,27,902,92,5
Heat Stroke,Chandigarh,Himachal Pradesh,2022-12-01,1668,83,1585,18,7
Heat Stroke,Chandigarh,Himachal Pradesh,2023-01-01,1634,140,1494,47,3
Heat Stroke,Chandigarh,Himachal Pradesh,2023-02-01,3798,237,3561,86,5
Heat Stroke,Chandigarh,Himachal Pradesh,2023-03-01,2202,60,2142,11,10
Heat Stroke,Chandigarh,Himachal Pradesh,2023-04-01,4271,294,3977,139,6
Heat Stroke,Chandigarh,Himachal Pradesh,2023-05-01,1694,65,1629,36,8
Heat Stroke,Chandigarh,Himachal Pradesh,2023-06-01,2972,225,2747,141,2
Heat Stroke,Chandigarh,Himachal Pradesh,2023-07-01,1477,182,1295,137,1
Heat Stroke,Chandigarh,Himachal Pradesh,2023-08-01,4989,197,4792,79,9
Heat Stroke,Chandigarh,Himachal Pradesh,2023-09-01,1004,73,931,157,8
Heat Stroke,Chandigarh,Himachal Pradesh,2023-10-01,3013,85,2928,144,10
Heat Stroke,Chandigarh,Himachal Pradesh,2023-11-01,3448,161,3287,90,5
Heat Stroke,Chandigarh,Himachal Pradesh,2023-12-01,3153,160,2993,85,8
Heat Stroke,Chandigarh,Himachal Pradesh,2024-01-01,2349,104,2245,162,1
Heat Stroke,Chandigarh,Himachal Pradesh,2024-02-01,2423,295,2128,118,6
Heat Stroke,Chandigarh,Himachal Pradesh,2024-03-01,2656,109,2547,159,8
Heat Stroke,Chandigarh,Himachal Pradesh,2024-04-01,2400,161,2239,11,3
Heat Stroke,Chandigarh,Himachal Pradesh,2024-05-01,3890,0,3890,111,8
Heat Stroke,Chandigarh,Himachal Pradesh,2024-06-01,4989,312,4677,26,4
Heat Stroke,Chandigarh,Himachal Pradesh,2024-07-01,1850,154,1696,105,5
Heat Stroke,Chandigarh,Himachal Pradesh,2024-08-01,760,26,734,143,4
Heat Stroke,Chandigarh,Himachal Pradesh,2024-09-01,2479,0,2479,195,9
Heat Stroke,Chandigarh,Himachal Pradesh,2024-10-01,4989,244,4745,58,4
Heat Stroke,Chandigarh,Himachal Pradesh,2024-11-01,1519,76,1443,79,3
Heat Stroke,Chandigarh,Himachal Pradesh,2024-12-01,4796,341,4455,101,2
Heat Stroke,Chandigarh,Himachal Pradesh,2025-01-01,4848,442,4406,57,4
Heat Stroke,Chandigarh,Himachal Pradesh,2025-02-01,1855,72,1783,156,5
Heat Stroke,Chandigarh,Himachal Pradesh,2025-03-01,3361,84,3277,103,7
Heat Stroke,Chandigarh,Himachal Pradesh,2025-04-01,4782,77,4705,112,3
Heat Stroke,Chandigarh,Himachal Pradesh,2025-05-01,2089,116,1973,138,6
Heat Stroke,Chandigarh,Himachal Pradesh,2025-06-01,2324,148,2176,103,7
Heat Stroke,Chandigarh,Himachal Pradesh,2025-07-01,1817,62,1755,65,2
Heat Stroke,Chandigarh,Himachal Pradesh,2025-08-01,1236,89,1147,103,5
Heat Stroke,Chandigarh,Himachal Pradesh,2025-09-01,1726,109,1617,63,5
Heat Stroke,Chandigarh,Himachal Pradesh,2025-10-01,955,49,906,112,5
Heat Stroke,Chandigarh,Himachal Pradesh,2025-11-01,2643,62,2581,157,3
Heat Stroke,Chandigarh,Himachal Pradesh,2025-12-01,1564,56,1508,46,4
Heat Stroke,Chandigarh,Jammu & Kashmir,2018-01-01,2911,0,2911,28,5
Heat Stroke,Chandigarh,Jammu & Kashmir,2018-02-01,510,29,481,109,10
Heat Stroke,Chandigarh,Jammu & Kashmir,2018-03-01,3041,154,2887,67,5
Heat Stroke,Chandigarh,Jammu & Kashmir,2018-04-01,3716,206,3510,108,9
Heat Stroke,Chandigarh,Jammu & Kashmir,2018-05-01,78,0,78,123,9
Heat Stroke,Chandigarh,Jammu & Kashmir,2018-06-01,3099,189,2910,11,1
Heat Stroke,Chandigarh,Jammu & Kashmir,2018-07-01,4244,198,4046,141,4
Heat Stroke,Chandigarh,Jammu & Kashmir,2018-08-01,975,50,925,47,9
Heat Stroke,Chandigarh,Jammu & Kashmir,2018-09-01,4841,44,4797,105,5
Heat Stroke,Chandigarh,Jammu & Kashmir,2018-10-01,3160,104,3056,73,4
Heat Stroke,Chandigarh,Jammu & Kashmir,2018-11-01,1652,85,1567,78,7
Heat Stroke,Chandigarh,Jammu & Kashmir,2018-12-01,2523,72,2451,193,8
Heat Stroke,Chandigarh,Jammu & Kashmir,2019-01-01,3346,251,3095,122,5
Heat Stroke,Chandigarh,Jammu & Kashmir,2019-02-01,2699,83,2616,152,4
Heat Stroke,Chandigarh,Jammu & Kashmir,2019-03-01,3320,187,3133,114,1
Heat Stroke,Chandigarh,Jammu & Kashmir,2019-04-01,1362,72,1290,138,5
Heat Stroke,Chandigarh,Jammu & Kashmir,2019-05-01,2825,202,2623,127,4
Heat Stroke,Chandigarh,Jammu & Kashmir,2019-06-01,701,53,648,119,2
Heat Stroke,Chandigarh,Jammu & Kashmir,2019-07-01,2448,172,2276,163,4
Heat Stroke,Chandigarh,Jammu & Kashmir,2019-08-01,1385,0,1385,114,4
Heat Stroke,Chandigarh,Jammu & Kashmir,2019-09-01,1611,136,1475,200,5
Heat Stroke,Chandigarh,Jammu & Kashmir,2019-10-01,4256,402,3854,155,4
Heat Stroke,Chandigarh,Jammu & Kashmir,2019-11-01,4061,146,3915,48,6
Heat Stroke,Chandigarh,Jammu & Kashmir,2019-12-01,3415,194,3221,97,5
Heat Stroke,Chandigarh,Jammu & Kashmir,2020-01-01,1132,27,1105,126,9
Heat Stroke,Chandigarh,Jammu & Kashmir,2020-02-01,2173,0,2173,108,3
Heat Stroke,Chandigarh,Jammu & Kashmir,2020-03-01,4225,120,4105,141,10
Heat Stroke,Chandigarh,Jammu & Kashmir,2020-04-01,2788,95,2693,147,8
Heat Stroke,Chandigarh,Jammu & Kashmir,2020-05-01,4989,198,4791,37,9
Heat Stroke,Chandigarh,Jammu & Kashmir,2020-06-01,3125,69,3056,171,6
Heat Stroke,Chandigarh,Jammu & Kashmir,2020-07-01,2855,82,2773,81,4
Heat Stroke,Chandigarh,Jammu & Kashmir,2020-08-01,2183,108,2075,76,3
Heat Stroke,Chandigarh,Jammu & Kashmir,2020-09-01,2777,76,2701,76,10
Heat Stroke,Chandigarh,Jammu & Kashmir,2020-10-01,2393,157,2236,147,8
Heat Stroke,Chandigarh,Jammu & Kashmir,2020-11-01,3547,247,3300,93,2
Heat Stroke,Chandigarh,Jammu & Kashmir,2020-12-01,3881,442,3439,72,8
Heat Stroke,Chandigarh,Jammu & Kashmir,2021-01-01,1543,127,1416,85,2
Heat Stroke,Chandigarh,Jammu & Kashmir,2021-02-01,812,46,766,15,6
Heat Stroke,Chandigarh,Jammu & Kashmir,2021-03-01,134,4,130,63,7
Heat Stroke,Chandigarh,Jammu & Kashmir,2021-04-01,3279,192,3087,43,9
Heat Stroke,Chandigarh,Jammu & Kashmir,2021-05-01,1117,66,1051,92,6
Heat Stroke,Chandigarh,Jammu & Kashmir,2021-06-01,78,0,78,140,4
Heat Stroke,Chandigarh,Jammu & Kashmir,2021-07-01,3119,227,2892,134,5
Heat Stroke,Chandigarh,Jammu & Kashmir,2021-08-01,4989,46,4943,170,8
Heat Stroke,Chandigarh,Jammu & Kashmir,2021-09-01,2589,111,2478,159,7
Heat Stroke,Chandigarh,Jammu & Kashmir,2021-10-01,3722,246,3476,79,5
Heat Stroke,Chandigarh,Jammu & Kashmir,2021-11-01,2707,112,2595,107,1
Heat Stroke,Chandigarh,Jammu & Kashmir,2021-12-01,2465,108,2357,105,1
Heat Stroke,Chandigarh,Jammu & Kashmir,2022-01-01,3830,176,3654,11,5
Heat Stroke,Chandigarh,Jammu & Kashmir,2022-02-01,2208,56,2152,44,1
Heat Stroke,Chandigarh,Jammu & Kashmir,2022-03-01,2956,249,2707,98,3
Heat Stroke,Chandigarh,Jammu & Kashmir,2022-04-01,3029,61,2968,97,4
Heat Stroke,Chandigarh,Jammu & Kashmir,2022-05-01,1701,100,1601,132,10
Heat Stroke,Chandigarh,Jammu & Kashmir,2022-06-01,3928,243,3685,130,5
Heat Stroke,Chandigarh,Jammu & Kashmir,2022-07-01,2363,53,2310,16,7
Heat Stroke,Chandigarh,Jammu & Kashmir,2022-08-01,1584,82,1502,133,6
Heat Stroke,Chandigarh,Jammu & Kashmir,2022-09-01,3317,78,3239,115,1
Heat Stroke,Chandigarh,Jammu & Kashmir,2022-10-01,1392,126,1266,138,4
Heat Stroke,Chandigarh,Jammu & Kashmir,2022-11-01,2635,44,2591,161,1
Heat Stroke,Chandigarh,Jammu & Kashmir,2022-12-01,2585,80,2505,99,10
Heat Stroke,Chandigarh,Jammu & Kashmir,2023-01-01,4054,58,3996,170,1
Heat Stroke,Chandigarh,Jammu & Kashmir,2023-02-01,3234,34,3200,61,4
Heat Stroke,Chandigarh,Jammu & Kashmir,2023-03-01,2564,247,2317,58,4
Heat Stroke,Chandigarh,Jammu & Kashmir,2023-04-01,3694,243,3451,128,2
Heat Stroke,Chandigarh,Jammu & Kashmir,2023-05-01,4462,241,4221,87,5
Heat Stroke,Chandigarh,Jammu & Kashmir,2023-06-01,3346,103,3243,120,5
Heat Stroke,Chandigarh,Jammu & Kashmir,2023-07-01,2611,199,2412,200,5
Heat Stroke,Chandigarh,Jammu & Kashmir,2023-08-01,838,21,817,126,6
Heat Stroke,Chandigarh,Jammu & Kashmir,2023-09-01,1169,85,1084,117,6
Heat Stroke,Chandigarh,Jammu & Kashmir,2023-10-01,2188,53,2135,62,6
Heat Stroke,Chandigarh,Jammu & Kashmir,2023-11-01,1780,55,1725,20,8
Heat Stroke,Chandigarh,Jammu & Kashmir,2023-12-01,2347,169,2178,103,1
Heat Stroke,Chandigarh,Jammu & Kashmir,2024-01-01,2673,201,2472,161,7
Heat Stroke,Chandigarh,Jammu & Kashmir,2024-02-01,3308,223,3085,90,2
Heat Stroke,Chandigarh,Jammu & Kashmir,2024-03-01,2503,48,2455,127,3
Heat Stroke,Chandigarh,Jammu & Kashmir,2024-04-01,3250,120,3130,179,5
Heat Stroke,Chandigarh,Jammu & Kashmir,2024-05-01,2684,146,2538,178,6
Heat Stroke,Chandigarh,Jammu & Kashmir,2024-06-01,78,0,78,128,6
Heat Stroke,Chandigarh,Jammu & Kashmir,2024-07-01,1337,120,1217,115,2
Heat Stroke,Chandigarh,Jammu & Kashmir,2024-08-01,2404,0,2404,29,10
Heat Stroke,Chandigarh,Jammu & Kashmir,2024-09-01,975,26,949,74,4
Heat Stroke,Chandigarh,Jammu & Kashmir,2024-10-01,3402,119,3283,92,3
Heat Stroke,Chandigarh,Jammu & Kashmir,2024-11-01,4651,0,4651,63,1
Heat Stroke,Chandigarh,Jammu & Kashmir,2024-12-01,4232,39,4193,119,1
Heat Stroke,Chandigarh,Jammu & Kashmir,2025-01-01,2311,157,2154,200,1
Heat Stroke,Chandigarh,Jammu & Kashmir,2025-02-01,4597,234,4363,184,6
Heat Stroke,Chandigarh,Jammu & Kashmir,2025-03-01,2797,268,2529,119,7
Heat Stroke,Chandigarh,Jammu & Kashmir,2025-04-01,2145,203,1942,146,2
Heat Stroke,Chandigarh,Jammu & Kashmir,2025-05-01,1775,111,1664,69,2
Heat Stroke,Chandigarh,Jammu & Kashmir,2025-06-01,2192,129,2063,181,4
Heat Stroke,Chandigarh,Jammu & Kashmir,2025-07-01,2077,107,1970,27,5
Heat Stroke,Chandigarh,Jammu & Kashmir,2025-08-01,2826,0,2826,153,6
Heat Stroke,Chandigarh,Jammu & Kashmir,2025-09-01,2813,26,2787,131,2
Heat Stroke,Chandigarh,Jammu & Kashmir,2025-10-01,2601,137,2464,68,4
Heat Stroke,Chandigarh,Jammu & Kashmir,2025-11-01,3184,216,2968,96,9
Heat Stroke,Chandigarh,Jammu & Kashmir,2025-12-01,4195,245,3950,48,1
Heat Stroke,Chandigarh,Haryana,2018-01-01,3871,93,3778,51,5
Heat Stroke,Chandigarh,Haryana,2018-02-01,605,46,559,25,6
Heat Stroke,Chandigarh,Haryana,2018-03-01,78,0,78,145,2
Heat Stroke,Chandigarh,Haryana,2018-04-01,3851,297,3554,168,7
Heat Stroke,Chandigarh,Haryana,2018-05-01,764,60,704,11,1
Heat Stroke,Chandigarh,Haryana,2018-06-01,2296,77,2219,200,7
Heat Stroke,Chandigarh,Haryana,2018-07-01,1028,83,945,106,5
Heat Stroke,Chandigarh,Haryana,2018-08-01,180,9,171,121,1
Heat Stroke,Chandigarh,Haryana,2018-09-01,3324,215,3109,31,7
Heat Stroke,Chandigarh,Haryana,2018-10-01,3616,219,3397,174,2
Heat Stroke,Chandigarh,Haryana,2018-11-01,1824,84,1740,116,4
Heat Stroke,Chandigarh,Haryana,2018-12-01,78,0,78,164,7
Heat Stroke,Chandigarh,Haryana,2019-01-01,1865,88,1777,168,2
Heat Stroke,Chandigarh,Haryana,2019-02-01,3123,246,2877,174,3
Heat Stroke,Chandigarh,Haryana,2019-03-01,613,22,591,73,8
Heat Stroke,Chandigarh,Haryana,2019-04-01,2843,216,2627,96,1
Heat Stroke,Chandigarh,Haryana,2019-05-01,2577,184,2393,75,9
Heat Stroke,Chandigarh,Haryana,2019-06-01,3375,139,3236,152,1
Heat Stroke,Chandigarh,Haryana,2019-07-01,2758,249,2509,123,3
Heat Stroke,Chandigarh,Haryana,2019-08-01,1292,51,1241,161,6
Heat Stroke,Chandigarh,Haryana,2019-09-01,4203,395,3808,163,7
Heat Stroke,Chandigarh,Haryana,2019-10-01,2385,149,2236,18,6
Heat Stroke,Chandigarh,Haryana,2019-11-01,2561,127,2434,175,5
Heat Stroke,Chandigarh,Haryana,2019-12-01,1345,32,1313,155,4
Heat Stroke,Chandigarh,Haryana,2020-01-01,2003,95,1908,87,9
Heat Stroke,Chandigarh,Haryana,2020-02-01,1410,62,1348,124,7
Heat Stroke,Chandigarh,Haryana,2020-03-01,2365,31,2334,100,8
Heat Stroke,Chandigarh,Haryana,2020-04-01,4894,214,4680,138,4
Heat Stroke,Chandigarh,Haryana,2020-05-01,757,20,737,87,1
Heat Stroke,Chandigarh,Haryana,2020-06-01,433,29,404,131,8
Heat Stroke,Chandigarh,Haryana,2020-07-01,4571,402,4169,110,6
Heat Stroke,Chandigarh,Haryana,2020-08-01,2317,33,2284,84,5
Heat Stroke,Chandigarh,Haryana,2020-09-01,1700,169,1531,116,3
Heat Stroke,Chandigarh,Haryana,2020-10-01,3992,184,3808,200,4
Heat Stroke,Chandigarh,Haryana,2020-11-01,1785,38,1747,71,3
Heat Stroke,Chandigarh,Haryana,2020-12-01,4989,359,4630,93,5
Heat Stroke,Chandigarh,Haryana,2021-01-01,3507,130,3377,72,2
Heat Stroke,Chandigarh,Haryana,2021-02-01,1943,92,1851,78,7
Heat Stroke,Chandigarh,Haryana,2021-03-01,4989,191,4798,148,10
Heat Stroke,Chandigarh,Haryana,2021-04-01,1785,46,1739,143,3
Heat Stroke,Chandigarh,Haryana,2021-05-01,3593,255,3338,106,1
Heat Stroke,Chandigarh,Haryana,2021-06-01,2999,125,2874,158,5
Heat Stroke,Chandigarh,Haryana,2021-07-01,4344,35,4309,147,6
Heat Stroke,Chandigarh,Haryana,2021-08-01,4692,310,4382,98,6
Heat Stroke,Chandigarh,Haryana,2021-09-01,2640,39,2601,28,9
Heat Stroke,Chandigarh,Haryana,2021-10-01,1587,26,1561,148,7
Heat Stroke,Chandigarh,Haryana,2021-11-01,3214,272,2942,115,1
Heat Stroke,Chandigarh,Haryana,2021-12-01,1688,25,1663,107,1
Heat Stroke,Chandigarh,Haryana,2022-01-01,4989,20,4969,82,6
Heat Stroke,Chandigarh,Haryana,2022-02-01,2781,189,2592,144,4
Heat Stroke,Chandigarh,Haryana,2022-03-01,2107,86,2021,124,9
Heat Stroke,Chandigarh,Haryana,2022-04-01,2845,124,2721,94,2
Heat Stroke,Chandigarh,Haryana,2022-05-01,790,32,758,44,8
Heat Stroke,Chandigarh,Haryana,2022-06-01,1294,73,1221,161,3
Heat Stroke,Chandigarh,Haryana,2022-07-01,4208,118,4090,137,6
Heat Stroke,Chandigarh,Haryana,2022-08-01,1716,159,1557,119,2
Heat Stroke,Chandigarh,Haryana,2022-09-01,1193,8,1185,11,6
Heat Stroke,Chandigarh,Haryana,2022-10-01,3317,209,3108,104,8
Heat Stroke,Chandigarh,Haryana,2022-11-01,4188,287,3901,94,6
Heat Stroke,Chandigarh,Haryana,2022-12-01,3562,99,3463,75,10
Heat Stroke,Chandigarh,Haryana,2023-01-01,3934,79,3855,145,3
Heat Stroke,Chandigarh,Haryana,2023-02-01,1582,126,1456,143,5
Heat Stroke,Chandigarh,Haryana,2023-03-01,690,14,676,128,7
Heat Stroke,Chandigarh,Haryana,2023-04-01,4611,149,4462,159,2
Heat Stroke,Chandigarh,Haryana,2023-05-01,2165,164,2001,54,5
Heat Stroke,Chandigarh,Haryana,2023-06-01,2261,115,2146,83,7
Heat Stroke,Chandigarh,Haryana,2023-07-01,4379,0,4379,110,8
Heat Stroke,Chandigarh,Haryana,2023-08-01,3344,337,3007,75,8
Heat Stroke,Chandigarh,Haryana,2023-09-01,3209,111,3098,143,2
Heat Stroke,Chandigarh,Haryana,2023-10-01,4989,191,4798,80,6
Heat Stroke,Chandigarh,Haryana,2023-11-01,1734,99,1635,172,1
Heat Stroke,Chandigarh,Haryana,2023-12-01,3842,262,3580,59,3
Heat Stroke,Chandigarh,Haryana,2024-01-01,2674,286,2388,200,4
Heat Stroke,Chandigarh,Haryana,2024-02-01,2958,5,2953,200,8
Heat Stroke,Chandigarh,Haryana,2024-03-01,4648,344,4304,101,6
Heat Stroke,Chandigarh,Haryana,2024-04-01,3279,235,3044,165,5
Heat Stroke,Chandigarh,Haryana,2024-05-01,3320,152,3168,86,6
Heat Stroke,Chandigarh,Haryana,2024-06-01,4036,294,3742,158,6
Heat Stroke,Chandigarh,Haryana,2024-07-01,2108,162,1946,97,6
Heat Stroke,Chandigarh,Haryana,2024-08-01,1472,14,1458,41,3
Heat Stroke,Chandigarh,Haryana,2024-09-01,1196,120,1076,11,2
Heat Stroke,Chandigarh,Haryana,2024-10-01,78,0,78,93,4
Heat Stroke,Chandigarh,Haryana,2024-11-01,4989,84,4905,120,3
Heat Stroke,Chandigarh,Haryana,2024-12-01,1117,47,1070,174,7
Heat Stroke,Chandigarh,Haryana,2025-01-01,2301,244,2057,108,9
Heat Stroke,Chandigarh,Haryana,2025-02-01,2226,91,2135,157,6
Heat Stroke,Chandigarh,Haryana,2025-03-01,3010,147,2863,83,1
Heat Stroke,Chandigarh,Haryana,2025-04-01,3692,338,3354,89,3
Heat Stroke,Chandigarh,Haryana,2025-05-01,3752,155,3597,160,5
Heat Stroke,Chandigarh,Haryana,2025-06-01,1815,28,1787,11,1
Heat Stroke,Chandigarh,Haryana,2025-07-01,2373,90,2283,107,5
Heat Stroke,Chandigarh,Haryana,2025-08-01,2976,267,2709,86,6
Heat Stroke,Chandigarh,Haryana,2025-09-01,2264,118,2146,176,9
Heat Stroke,Chandigarh,Haryana,2025-10-01,4754,442,4312,79,10
Heat Stroke,Chandigarh,Haryana,2025-11-01,3256,232,3024,133,1
Heat Stroke,Chandigarh,Haryana,2025-12-01,3583,112,3471,153,4
Heat Stroke,Shimla,Punjab,2018-01-01,3487,179,3308,30,5
Heat Stroke,Shimla,Punjab,2018-02-01,4172,105,4067,99,3
Heat Stroke,Shimla,Punjab,2018-03-01,2840,86,2754,84,5
Heat Stroke,Shimla,Punjab,2018-04-01,858,154,704,154,5
Heat Stroke,Shimla,Punjab,2018-05-01,3134,249,2885,141,7
Heat Stroke,Shimla,Punjab,2018-06-01,1724,129,1595,94,9
Heat Stroke,Shimla,Punjab,2018-07-01,1888,60,1828,53,5
Heat Stroke,Shimla,Punjab,2018-08-01,3384,324,3060,159,3
Heat Stroke,Shimla,Punjab,2018-09-01,4259,349,3910,103,2
Heat Stroke,Shimla,Punjab,2018-10-01,2626,275,2351,24,10
Heat Stroke,Shimla,Punjab,2018-11-01,3012,311,2701,28,7
Heat Stroke,Shimla,Punjab,2018-12-01,4881,34,4847,129,6
Heat Stroke,Shimla,Punjab,2019-01-01,2920,51,2869,41,4
Heat Stroke,Shimla,Punjab,2019-02-01,4989,104,4885,200,10
Heat Stroke,Shimla,Punjab,2019-03-01,3356,75,3281,58,4
Heat Stroke,Shimla,Punjab,2019-04-01,235,13,222,106,1
Heat Stroke,Shimla,Punjab,2019-05-01,3608,121,3487,114,6
Heat Stroke,Shimla,Punjab,2019-06-01,3109,343,2766,69,1
Heat Stroke,Shimla,Punjab,2019-07-01,4328,442,3886,11,6
Heat Stroke,Shimla,Punjab,2019-08-01,3500,174,3326,116,9
Heat Stroke,Shimla,Punjab,2019-09-01,2412,258,2154,68,1
Heat Stroke,Shimla,Punjab,2019-10-01,955,89,866,112,2
Heat Stroke,Shimla,Punjab,2019-11-01,2317,85,2232,100,7
Heat Stroke,Shimla,Punjab,2019-12-01,1456,0,1456,120,3
Heat Stroke,Shimla,Punjab,2020-01-01,1819,79,1740,186,6
Heat Stroke,Shimla,Punjab,2020-02-01,3387,106,3281,78,6
Heat Stroke,Shimla,Punjab,2020-03-01,4838,271,4567,82,7
Heat Stroke,Shimla,Punjab,2020-04-01,3127,164,2963,21,3
Heat Stroke,Shimla,Punjab,2020-05-01,993,51,942,96,1
Heat Stroke,Shimla,Punjab,2020-06-01,3194,208,2986,127,6
Heat Stroke,Shimla,Punjab,2020-07-01,4203,62,4141,82,1
Heat Stroke,Shimla,Punjab,2020-08-01,1779,110,1669,127,8
Heat Stroke,Shimla,Punjab,2020-09-01,2418,90,2328,97,5
Heat Stroke,Shimla,Punjab,2020-10-01,2617,146,2471,40,4
Heat Stroke,Shimla,Punjab,2020-11-01,1544,120,1424,122,7
Heat Stroke,Shimla,Punjab,2020-12-01,3467,50,3417,96,1
Heat Stroke,Shimla,Punjab,2021-01-01,2435,101,2334,112,4
Heat Stroke,Shimla,Punjab,2021-02-01,3160,147,3013,77,6
Heat Stroke,Shimla,Punjab,2021-03-01,1407,49,1358,73,6
Heat Stroke,Shimla,Punjab,2021-04-01,2011,153,1858,114,3
Heat Stroke,Shimla,Punjab,2021-05-01,3566,103,3463,94,3
Heat Stroke,Shimla,Punjab,2021-06-01,2097,71,2026,194,9
Heat Stroke,Shimla,Punjab,2021-07-01,4914,144,4770,147,7
Heat Stroke,Shimla,Punjab,2021-08-01,2061,168,1893,134,3
Heat Stroke,Shimla,Punjab,2021-09-01,2899,103,2796,97,9
Heat Stroke,Shimla,Punjab,2021-10-01,3848,244,3604,11,7
Heat Stroke,Shimla,Punjab,2021-11-01,695,74,621,65,6
Heat Stroke,Shimla,Punjab,2021-12-01,235,11,224,73,6
Heat Stroke,Shimla,Punjab,2022-01-01,551,45,506,92,1
Heat Stroke,Shimla,Punjab,2022-02-01,4291,423,3868,105,9
Heat Stroke,Shimla,Punjab,2022-03-01,1857,148,1709,140,8
Heat Stroke,Shimla,Punjab,2022-04-01,4989,247,4742,120,6
Heat Stroke,Shimla,Punjab,2022-05-01,1840,126,1714,165,6
Heat Stroke,Shimla,Punjab,2022-06-01,2845,35,2810,90,5
Heat Stroke,Shimla,Punjab,2022-07-01,4666,127,4539,119,3
Heat Stroke,Shimla,Punjab,2022-08-01,4989,162,4827,124,6
Heat Stroke,Shimla,Punjab,2022-09-01,4989,442,4547,119,3
Heat Stroke,Shimla,Punjab,2022-10-01,4218,111,4107,172,5
Heat Stroke,Shimla,Punjab,2022-11-01,3971,103,3868,147,5
Heat Stroke,Shimla,Punjab,2022-12-01,3392,66,3326,39,6
Heat Stroke,Shimla,Punjab,2023-01-01,3642,241,3401,100,8
Heat Stroke,Shimla,Punjab,2023-02-01,1858,100,1758,105,6
Heat Stroke,Shimla,Punjab,2023-03-01,1500,122,1378,200,7
Heat Stroke,Shimla,Punjab,2023-04-01,2593,180,2413,89,1
Heat Stroke,Shimla,Punjab,2023-05-01,2369,23,2346,56,6
Heat Stroke,Shimla,Punjab,2023-06-01,1989,52,1937,129,5
Heat Stroke,Shimla,Punjab,2023-07-01,3532,317,3215,132,6
Heat Stroke,Shimla,Punjab,2023-08-01,3879,171,3708,102,3
Heat Stroke,Shimla,Punjab,2023-09-01,2716,229,2487,95,8
Heat Stroke,Shimla,Punjab,2023-10-01,4580,209,4371,155,6
Heat Stroke,Shimla,Punjab,2023-11-01,1066,23,1043,63,3
Heat Stroke,Shimla,Punjab,2023-12-01,2338,96,2242,89,3
Heat Stroke,Shimla,Punjab,2024-01-01,1636,35,1601,80,7
Heat Stroke,Shimla,Punjab,2024-02-01,93,3,90,162,5
Heat Stroke,Shimla,Punjab,2024-03-01,2486,139,2347,121,5
Heat Stroke,Shimla,Punjab,2024-04-01,2434,158,2276,52,4
Heat Stroke,Shimla,Punjab,2024-05-01,4628,17,4611,57,8
Heat Stroke,Shimla,Punjab,2024-06-01,3444,170,3274,200,6
Heat Stroke,Shimla,Punjab,2024-07-01,1223,40,1183,161,1
Heat Stroke,Shimla,Punjab,2024-08-01,4989,155,4834,149,2
Heat Stroke,Shimla,Punjab,2024-09-01,4235,228,4007,107,5
Heat Stroke,Shimla,Punjab,2024-10-01,3378,115,3263,183,3
Heat Stroke,Shimla,Punjab,2024-11-01,2294,207,2087,50,1
Heat Stroke,Shimla,Punjab,2024-12-01,1310,110,1200,145,3
Heat Stroke,Shimla,Punjab,2025-01-01,2098,177,1921,84,4
Heat Stroke,Shimla,Punjab,2025-02-01,4058,144,3914,94,4
Heat Stroke,Shimla,Punjab,2025-03-01,4989,110,4879,143,7
Heat Stroke,Shimla,Punjab,2025-04-01,4668,244,4424,99,1
Heat Stroke,Shimla,Punjab,2025-05-01,1942,88,1854,84,3
Heat Stroke,Shimla,Punjab,2025-06-01,1095,35,1060,81,7
Heat Stroke,Shimla,Punjab,2025-07-01,2786,44,2742,11,3
Heat Stroke,Shimla,Punjab,2025-08-01,225,10,215,145,1
Heat Stroke,Shimla,Punjab,2025-09-01,3031,116,2915,55,3
Heat Stroke,Shimla,Punjab,2025-10-01,2399,168,2231,200,6
Heat Stroke,Shimla,Punjab,2025-11-01,1972,136,1836,92,4
Heat Stroke,Shimla,Punjab,2025-12-01,458,37,421,173,3
Heat Stroke,Shimla,Chandigarh,2018-01-01,3286,44,3242,14,6
Heat Stroke,Shimla,Chandigarh,2018-02-01,1883,116,1767,143,6
Heat Stroke,Shimla,Chandigarh,2018-03-01,1028,29,999,157,1
Heat Stroke,Shimla,Chandigarh,2018-04-01,78,0,78,173,5
Heat Stroke,Shimla,Chandigarh,2018-05-01,2560,96,2464,28,1
Heat Stroke,Shimla,Chandigarh,2018-06-01,4975,403,4572,70,8
Heat Stroke,Shimla,Chandigarh,2018-07-01,4826,189,4637,136,8
Heat Stroke,Shimla,Chandigarh,2018-08-01,1984,189,1795,114,4
Heat Stroke,Shimla,Chandigarh,2018-09-01,1790,118,1672,121,8
Heat Stroke,Shimla,Chandigarh,2018-10-01,3226,124,3102,88,3
Heat Stroke,Shimla,Chandigarh,2018-11-01,1258,105,1153,185,4
Heat Stroke,Shimla,Chandigarh,2018-12-01,3002,189,2813,200,3
Heat Stroke,Shimla,Chandigarh,2019-01-01,3625,83,3542,112,5
Heat Stroke,Shimla,Chandigarh,2019-02-01,4243,441,3802,129,5
Heat Stroke,Shimla,Chandigarh,2019-03-01,2463,141,2322,109,5
Heat Stroke,Shimla,Chandigarh,2019-04-01,2324,117,2207,172,5
Heat Stroke,Shimla,Chandigarh,2019-05-01,1420,35,1385,148,5
Heat Stroke,Shimla,Chandigarh,2019-06-01,1488,125,1363,52,8
Heat Stroke,Shimla,Chandigarh,2019-07-01,2294,149,2145,75,1
Heat Stroke,Shimla,Chandigarh,2019-08-01,3090,211,2879,55,10
Heat Stroke,Shimla,Chandigarh,2019-09-01,3823,134,3689,200,4
Heat Stroke,Shimla,Chandigarh,2019-10-01,1520,113,1407,139,5
Heat Stroke,Shimla,Chandigarh,2019-11-01,4600,352,4248,76,9
Heat Stroke,Shimla,Chandigarh,2019-12-01,2234,68,2166,72,7
Heat Stroke,Shimla,Chandigarh,2020-01-01,2569,22,2547,147,6
Heat Stroke,Shimla,Chandigarh,2020-02-01,1595,106,1489,152,8
Heat Stroke,Shimla,Chandigarh,2020-03-01,78,0,78,147,4
Heat Stroke,Shimla,Chandigarh,2020-04-01,3783,206,3577,85,7
Heat Stroke,Shimla,Chandigarh,2020-05-01,3586,132,3454,122,1
Heat Stroke,Shimla,Chandigarh,2020-06-01,2220,189,2031,112,6
Heat Stroke,Shimla,Chandigarh,2020-07-01,2687,103,2584,59,6
Heat Stroke,Shimla,Chandigarh,2020-08-01,3290,270,3020,59,8
Heat Stroke,Shimla,Chandigarh,2020-09-01,501,17,484,127,7
Heat Stroke,Shimla,Chandigarh,2020-10-01,1888,149,1739,116,5
Heat Stroke,Shimla,Chandigarh,2020-11-01,3663,403,3260,134,4
Heat Stroke,Shimla,Chandigarh,2020-12-01,915,17,898,147,4
Heat Stroke,Shimla,Chandigarh,2021-01-01,2991,175,2816,183,4
Heat Stroke,Shimla,Chandigarh,2021-02-01,778,101,677,67,1
Heat Stroke,Shimla,Chandigarh,2021-03-01,3223,167,3056,138,10
Heat Stroke,Shimla,Chandigarh,2021-04-01,2550,132,2418,144,8
Heat Stroke,Shimla,Chandigarh,2021-05-01,431,31,400,90,6
Heat Stroke,Shimla,Chandigarh,2021-06-01,4160,213,3947,112,7
Heat Stroke,Shimla,Chandigarh,2021-07-01,1612,0,1612,92,7
Heat Stroke,Shimla,Chandigarh,2021-08-01,1510,125,1385,200,2
Heat Stroke,Shimla,Chandigarh,2021-09-01,2866,0,2866,112,7
Heat Stroke,Shimla,Chandigarh,2021-10-01,4138,156,3982,129,9
Heat Stroke,Shimla,Chandigarh,2021-11-01,1235,105,1130,93,3
Heat Stroke,Shimla,Chandigarh,2021-12-01,2680,106,2574,82,1
Heat Stroke,Shimla,Chandigarh,2022-01-01,3173,94,3079,40,1
Heat Stroke,Shimla,Chandigarh,2022-02-01,3527,266,3261,162,5
Heat Stroke,Shimla,Chandigarh,2022-03-01,2834,71,2763,145,1
Heat Stroke,Shimla,Chandigarh,2022-04-01,2105,30,2075,91,4
Heat Stroke,Shimla,Chandigarh,2022-05-01,1487,86,1401,60,3
Heat Stroke,Shimla,Chandigarh,2022-06-01,2713,121,2592,115,5
Heat Stroke,Shimla,Chandigarh,2022-07-01,1159,16,1143,81,3
Heat Stroke,Shimla,Chandigarh,2022-08-01,78,0,78,95,5
Heat Stroke,Shimla,Chandigarh,2022-09-01,3183,202,2981,42,7
Heat Stroke,Shimla,Chandigarh,2022-10-01,3810,150,3660,117,2
Heat Stroke,Shimla,Chandigarh,2022-11-01,78,0,78,118,6
Heat Stroke,Shimla,Chandigarh,2022-12-01,1243,79,1164,162,2
Heat Stroke,Shimla,Chandigarh,2023-01-01,3428,290,3138,99,5
Heat Stroke,Shimla,Chandigarh,2023-02-01,4989,208,4781,89,5
Heat Stroke,Shimla,Chandigarh,2023-03-01,2625,181,2444,27,6
Heat Stroke,Shimla,Chandigarh,2023-04-01,1621,107,1514,162,5
Heat Stroke,Shimla,Chandigarh,2023-05-01,2352,177,2175,152,8
Heat Stroke,Shimla,Chandigarh,2023-06-01,4442,227,4215,108,5
Heat Stroke,Shimla,Chandigarh,2023-07-01,1731,40,1691,38,3
Heat Stroke,Shimla,Chandigarh,2023-08-01,1525,55,1470,44,8
Heat Stroke,Shimla,Chandigarh,2023-09-01,1950,117,1833,78,6
Heat Stroke,Shimla,Chandigarh,2023-10-01,1319,135,1184,155,7
Heat Stroke,Shimla,Chandigarh,2023-11-01,2762,99,2663,121,4
Heat Stroke,Shimla,Chandigarh,2023-12-01,4777,351,4426,30,1
Heat Stroke,Shimla,Chandigarh,2024-01-01,3031,122,2909,127,10
Heat Stroke,Shimla,Chandigarh,2024-02-01,2259,120,2139,63,3
Heat Stroke,Shimla,Chandigarh,2024-03-01,2206,207,1999,80,1
Heat Stroke,Shimla,Chandigarh,2024-04-01,500,36,464,156,7
Heat Stroke,Shimla,Chandigarh,2024-05-01,3782,52,3730,145,2
Heat Stroke,Shimla,Chandigarh,2024-06-01,2493,83,2410,162,4
Heat Stroke,Shimla,Chandigarh,2024-07-01,2355,204,2151,105,5
Heat Stroke,Shimla,Chandigarh,2024-08-01,4989,270,4719,151,4
Heat Stroke,Shimla,Chandigarh,2024-09-01,2998,49,2949,76,4
Heat Stroke,Shimla,Chandigarh,2024-10-01,1589,41,1548,93,9
Heat Stroke,Shimla,Chandigarh,2024-11-01,2025,142,1883,90,4
Heat Stroke,Shimla,Chandigarh,2024-12-01,4138,326,3812,107,2
Heat Stroke,Shimla,Chandigarh,2025-01-01,2749,139,2610,41,8
Heat Stroke,Shimla,Chandigarh,2025-02-01,668,81,587,95,3
Heat Stroke,Shimla,Chandigarh,2025-03-01,3831,283,3548,180,5
Heat Stroke,Shimla,Chandigarh,2025-04-01,1701,73,1628,51,2
Heat Stroke,Shimla,Chandigarh,2025-05-01,4989,131,4858,38,5
Heat Stroke,Shimla,Chandigarh,2025-06-01,4046,87,3959,43,5
Heat Stroke,Shimla,Chandigarh,2025-07-01,1997,119,1878,200,5
Heat Stroke,Shimla,Chandigarh,2025-08-01,4316,154,4162,130,5
Heat Stroke,Shimla,Chandigarh,2025-09-01,2688,265,2423,92,7
Heat Stroke,Shimla,Chandigarh,2025-10-01,3741,346,3395,110,7
Heat Stroke,Shimla,Chandigarh,2025-11-01,3248,222,3026,118,2
Heat Stroke,Shimla,Chandigarh,2025-12-01,1462,23,1439,74,3
Heat Stroke,Shimla,Himachal Pradesh,2018-01-01,1734,52,1682,80,8
Heat Stroke,Shimla,Himachal Pradesh,2018-02-01,3979,344,3635,98,3
Heat Stroke,Shimla,Himachal Pradesh,2018-03-01,2148,72,2076,69,6
Heat Stroke,Shimla,Himachal Pradesh,2018-04-01,2056,170,1886,86,7
Heat Stroke,Shimla,Himachal Pradesh,2018-05-01,1316,84,1232,124,1
Heat Stroke,Shimla,Himachal Pradesh,2018-06-01,3166,163,3003,55,4
Heat Stroke,Shimla,Himachal Pradesh,2018-07-01,4989,147,4842,200,7
Heat Stroke,Shimla,Himachal Pradesh,2018-08-01,1165,55,1110,145,4
Heat Stroke,Shimla,Himachal Pradesh,2018-09-01,2630,146,2484,42,4
Heat Stroke,Shimla,Himachal Pradesh,2018-10-01,4492,359,4133,11,7
Heat Stroke,Shimla,Himachal Pradesh,2018-11-01,2491,60,2431,71,8
Heat Stroke,Shimla,Himachal Pradesh,2018-12-01,3204,135,3069,141,3
Heat Stroke,Shimla,Himachal Pradesh,2019-01-01,1172,60,1112,131,10
Heat Stroke,Shimla,Himachal Pradesh,2019-02-01,3172,220,2952,101,1
Heat Stroke,Shimla,Himachal Pradesh,2019-03-01,2346,55,2291,76,1
Heat Stroke,Shimla,Himachal Pradesh,2019-04-01,3920,46,3874,60,3
Heat Stroke,Shimla,Himachal Pradesh,2019-05-01,4190,291,3899,86,4
Heat Stroke,Shimla,Himachal Pradesh,2019-06-01,4989,29,4960,55,4
Heat Stroke,Shimla,Himachal Pradesh,2019-07-01,3375,295,3080,86,3
Heat Stroke,Shimla,Himachal Pradesh,2019-08-01,3034,138,2896,174,3
Heat Stroke,Shimla,Himachal Pradesh,2019-09-01,2858,14,2844,67,4
Heat Stroke,Shimla,Himachal Pradesh,2019-10-01,2124,76,2048,137,3
Heat Stroke,Shimla,Himachal Pradesh,2019-11-01,3051,186,2865,145,7
Heat Stroke,Shimla,Himachal Pradesh,2019-12-01,2201,76,2125,51,5
Heat Stroke,Shimla,Himachal Pradesh,2020-01-01,2823,142,2681,63,4
Heat Stroke,Shimla,Himachal Pradesh,2020-02-01,4365,312,4053,161,5
Heat Stroke,Shimla,Himachal Pradesh,2020-03-01,1247,55,1192,59,8
Heat Stroke,Shimla,Himachal Pradesh,2020-04-01,4127,94,4033,103,3
Heat Stroke,Shimla,Himachal Pradesh,2020-05-01,4364,180,4184,200,1
Heat Stroke,Shimla,Himachal Pradesh,2020-06-01,2439,222,2217,156,2
Heat Stroke,Shimla,Himachal Pradesh,2020-07-01,78,0,78,111,4
Heat Stroke,Shimla,Himachal Pradesh,2020-08-01,1782,0,1782,149,6
Heat Stroke,Shimla,Himachal Pradesh,2020-09-01,4337,354,3983,103,7
Heat Stroke,Shimla,Himachal Pradesh,2020-10-01,2567,147,2420,158,10
Heat Stroke,Shimla,Himachal Pradesh,2020-11-01,1257,96,1161,11,7
Heat Stroke,Shimla,Himachal Pradesh,2020-12-01,1920,65,1855,99,2
Heat Stroke,Shimla,Himachal Pradesh,2021-01-01,3725,0,3725,11,4
Heat Stroke,Shimla,Himachal Pradesh,2021-02-01,3331,223,3108,114,1
Heat Stroke,Shimla,Himachal Pradesh,2021-03-01,2277,51,2226,94,4
Heat Stroke,Shimla,Himachal Pradesh,2021-04-01,2105,20,2085,176,3
Heat Stroke,Shimla,Himachal Pradesh,2021-05-01,2072,24,2048,142,1
Heat Stroke,Shimla,Himachal Pradesh,2021-06-01,1360,91,1269,79,10
Heat Stroke,Shimla,Himachal Pradesh,2021-07-01,4764,257,4507,86,4
Heat Stroke,Shimla,Himachal Pradesh,2021-08-01,2165,157,2008,126,1
Heat Stroke,Shimla,Himachal Pradesh,2021-09-01,4230,294,3936,77,4
Heat Stroke,Shimla,Himachal Pradesh,2021-10-01,4638,175,4463,105,10
Heat Stroke,Shimla,Himachal Pradesh,2021-11-01,3937,189,3748,173,10
Heat Stroke,Shimla,Himachal Pradesh,2021-12-01,2018,71,1947,64,5
Heat Stroke,Shimla,Himachal Pradesh,2022-01-01,3139,137,3002,83,5
Heat Stroke,Shimla,Himachal Pradesh,2022-02-01,2565,56,2509,91,8
Heat Stroke,Shimla,Himachal Pradesh,2022-03-01,1385,85,1300,200,4
Heat Stroke,Shimla,Himachal Pradesh,2022-04-01,3033,246,2787,137,6
Heat Stroke,Shimla,Himachal Pradesh,2022-05-01,1016,26,990,164,7
Heat Stroke,Shimla,Himachal Pradesh,2022-06-01,4191,366,3825,145,2
Heat Stroke,Shimla,Himachal Pradesh,2022-07-01,1974,105,1869,149,9
Heat Stroke,Shimla,Himachal Pradesh,2022-08-01,2867,163,2704,130,2
Heat Stroke,Shimla,Himachal Pradesh,2022-09-01,2977,1,2976,125,3
Heat Stroke,Shimla,Himachal Pradesh,2022-10-01,2250,0,2250,32,5
Heat Stroke,Shimla,Himachal Pradesh,2022-11-01,3384,183,3201,124,8
Heat Stroke,Shimla,Himachal Pradesh,2022-12-01,1960,143,1817,101,7
Heat Stroke,Shimla,Himachal Pradesh,2023-01-01,3766,114,3652,134,5
Heat Stroke,Shimla,Himachal Pradesh,2023-02-01,792,78,714,103,6
Heat Stroke,Shimla,Himachal Pradesh,2023-03-01,2767,197,2570,145,8
Heat Stroke,Shimla,Himachal Pradesh,2023-04-01,4989,117,4872,154,5
Heat Stroke,Shimla,Himachal Pradesh,2023-05-01,1255,63,1192,11,2
Heat Stroke,Shimla,Himachal Pradesh,2023-06-01,1688,206,1482,84,3
Heat Stroke,Shimla,Himachal Pradesh,2023-07-01,3287,45,3242,12,7
Heat Stroke,Shimla,Himachal Pradesh,2023-08-01,2838,185,2653,118,2
Heat Stroke,Shimla,Himachal Pradesh,2023-09-01,3068,124,2944,91,1
Heat Stroke,Shimla,Himachal Pradesh,2023-10-01,3254,229,3025,175,4
Heat Stroke,Shimla,Himachal Pradesh,2023-11-01,3449,299,3150,117,5
Heat Stroke,Shimla,Himachal Pradesh,2023-12-01,4086,158,3928,81,7
Heat Stroke,Shimla,Himachal Pradesh,2024-01-01,3147,260,2887,154,1
Heat Stroke,Shimla,Himachal Pradesh,2024-02-01,2274,260,2014,90,6
Heat Stroke,Shimla,Himachal Pradesh,2024-03-01,3500,182,3318,81,8
Heat Stroke,Shimla,Himachal Pradesh,2024-04-01,4989,363,4626,126,2
Heat Stroke,Shimla,Himachal Pradesh,2024-05-01,2419,79,2340,188,5
Heat Stroke,Shimla,Himachal Pradesh,2024-06-01,1290,65,1225,150,1
Heat Stroke,Shimla,Himachal Pradesh,2024-07-01,4083,183,3900,135,7
Heat Stroke,Shimla,Himachal Pradesh,2024-08-01,2436,178,2258,200,7
Heat Stroke,Shimla,Himachal Pradesh,2024-09-01,78,0,78,69,5
Heat Stroke,Shimla,Himachal Pradesh,2024-10-01,3734,175,3559,68,1
Heat Stroke,Shimla,Himachal Pradesh,2024-11-01,1879,177,1702,114,7
Heat Stroke,Shimla,Himachal Pradesh,2024-12-01,2476,234,2242,183,4
Heat Stroke,Shimla,Himachal Pradesh,2025-01-01,3043,227,2816,58,1
Heat Stroke,Shimla,Himachal Pradesh,2025-02-01,2853,100,2753,196,7
Heat Stroke,Shimla,Himachal Pradesh,2025-03-01,3549,114,3435,33,8
Heat Stroke,Shimla,Himachal Pradesh,2025-04-01,2013,53,1960,100,9
Heat Stroke,Shimla,Himachal Pradesh,2025-05-01,3286,255,3031,115,1
Heat Stroke,Shimla,Himachal Pradesh,2025-06-01,2249,33,2216,61,1
Heat Stroke,Shimla,Himachal Pradesh,2025-07-01,3589,250,3339,75,4
Heat Stroke,Shimla,Himachal Pradesh,2025-08-01,3423,63,3360,147,6
Heat Stroke,Shimla,Himachal Pradesh,2025-09-01,1343,99,1244,180,2
Heat Stroke,Shimla,Himachal Pradesh,2025-10-01,4054,205,3849,11,1
Heat Stroke,Shimla,Himachal Pradesh,2025-11-01,1878,166,1712,115,7
Heat Stroke,Shimla,Himachal Pradesh,2025-12-01,3681,306,3375,100,4
Heat Stroke,Shimla,Jammu & Kashmir,2018-01-01,3090,283,2807,112,7
Heat Stroke,Shimla,Jammu & Kashmir,2018-02-01,4989,442,4547,90,5
Heat Stroke,Shimla,Jammu & Kashmir,2018-03-01,2298,124,2174,40,4
Heat Stroke,Shimla,Jammu & Kashmir,2018-04-01,2129,34,2095,185,5
Heat Stroke,Shimla,Jammu & Kashmir,2018-05-01,2571,49,2522,165,4
Heat Stroke,Shimla,Jammu & Kashmir,2018-06-01,2191,0,2191,101,3
Heat Stroke,Shimla,Jammu & Kashmir,2018-07-01,3671,68,3603,81,2
Heat Stroke,Shimla,Jammu & Kashmir,2018-08-01,429,22,407,75,6
Heat Stroke,Shimla,Jammu & Kashmir,2018-09-01,1184,39,1145,11,8
Heat Stroke,Shimla,Jammu & Kashmir,2018-10-01,1165,52,1113,124,3
Heat Stroke,Shimla,Jammu & Kashmir,2018-11-01,3872,249,3623,146,10
Heat Stroke,Shimla,Jammu & Kashmir,2018-12-01,4892,201,4691,113,6
Heat Stroke,Shimla,Jammu & Kashmir,2019-01-01,2457,42,2415,102,6
Heat Stroke,Shimla,Jammu & Kashmir,2019-02-01,2371,115,2256,113,7
Heat Stroke,Shimla,Jammu & Kashmir,2019-03-01,2691,64,2627,63,8
Heat Stroke,Shimla,Jammu & Kashmir,2019-04-01,4156,175,3981,81,3
Heat Stroke,Shimla,Jammu & Kashmir,2019-05-01,1353,120,1233,98,6
Heat Stroke,Shimla,Jammu & Kashmir,2019-06-01,2917,123,2794,142,8
Heat Stroke,Shimla,Jammu & Kashmir,2019-07-01,3906,396,3510,176,4
Heat Stroke,Shimla,Jammu & Kashmir,2019-08-01,3270,299,2971,95,5
Heat Stroke,Shimla,Jammu & Kashmir,2019-09-01,2852,94,2758,53,3
Heat Stroke,Shimla,Jammu & Kashmir,2019-10-01,3940,69,3871,108,3
Heat Stroke,Shimla,Jammu & Kashmir,2019-11-01,78,0,78,200,4
Heat Stroke,Shimla,Jammu & Kashmir,2019-12-01,3507,293,3214,57,2
Heat Stroke,Shimla,Jammu & Kashmir,2020-01-01,1720,61,1659,151,5
Heat Stroke,Shimla,Jammu & Kashmir,2020-02-01,142,10,132,174,6
Heat Stroke,Shimla,Jammu & Kashmir,2020-03-01,3283,279,3004,88,6
Heat Stroke,Shimla,Jammu & Kashmir,2020-04-01,4440,122,4318,71,2
Heat Stroke,Shimla,Jammu & Kashmir,2020-05-01,2413,73,2340,136,3
Heat Stroke,Shimla,Jammu & Kashmir,2020-06-01,3876,274,3602,124,7
Heat Stroke,Shimla,Jammu & Kashmir,2020-07-01,4760,259,4501,142,3
Heat Stroke,Shimla,Jammu & Kashmir,2020-08-01,4361,131,4230,200,7
Heat Stroke,Shimla,Jammu & Kashmir,2020-09-01,4797,191,4606,115,3
Heat Stroke,Shimla,Jammu & Kashmir,2020-10-01,3593,172,3421,45,6
Heat Stroke,Shimla,Jammu & Kashmir,2020-11-01,2699,12,2687,110,7
Heat Stroke,Shimla,Jammu & Kashmir,2020-12-01,448,32,416,119,1
Heat Stroke,Shimla,Jammu & Kashmir,2021-01-01,2267,81,2186,171,7
Heat Stroke,Shimla,Jammu & Kashmir,2021-02-01,1466,0,1466,96,9
Heat Stroke,Shimla,Jammu & Kashmir,2021-03-01,4989,246,4743,85,4
Heat Stroke,Shimla,Jammu & Kashmir,2021-04-01,2361,67,2294,36,6
Heat Stroke,Shimla,Jammu & Kashmir,2021-05-01,2763,274,2489,134,2
Heat Stroke,Shimla,Jammu & Kashmir,2021-06-01,3337,110,3227,200,6
Heat Stroke,Shimla,Jammu & Kashmir,2021-07-01,2656,48,2608,95,10
Heat Stroke,Shimla,Jammu & Kashmir,2021-08-01,4871,315,4556,129,1
Heat Stroke,Shimla,Jammu & Kashmir,2021-09-01,1762,54,1708,78,3
Heat Stroke,Shimla,Jammu & Kashmir,2021-10-01,2858,78,2780,41,7
Heat Stroke,Shimla,Jammu & Kashmir,2021-11-01,1601,103,1498,128,8
Heat Stroke,Shimla,Jammu & Kashmir,2021-12-01,827,16,811,108,1
Heat Stroke,Shimla,Jammu & Kashmir,2022-01-01,1777,13,1764,11,3
Heat Stroke,Shimla,Jammu & Kashmir,2022-02-01,2548,255,2293,188,3
Heat Stroke,Shimla,Jammu & Kashmir,2022-03-01,2021,135,1886,127,3
Heat Stroke,Shimla,Jammu & Kashmir,2022-04-01,1669,70,1599,110,4
Heat Stroke,Shimla,Jammu & Kashmir,2022-05-01,711,35,676,85,1
Heat Stroke,Shimla,Jammu & Kashmir,2022-06-01,2486,161,2325,127,4
Heat Stroke,Shimla,Jammu & Kashmir,2022-07-01,579,45,534,129,2
Heat Stroke,Shimla,Jammu & Kashmir,2022-08-01,3617,101,3516,127,5
Heat Stroke,Shimla,Jammu & Kashmir,2022-09-01,2708,164,2544,161,3
Heat Stroke,Shimla,Jammu & Kashmir,2022-10-01,642,22,620,172,4
Heat Stroke,Shimla,Jammu & Kashmir,2022-11-01,2183,97,2086,200,2
Heat Stroke,Shimla,Jammu & Kashmir,2022-12-01,1588,86,1502,64,8
Heat Stroke,Shimla,Jammu & Kashmir,2023-01-01,3026,150,2876,77,4
Heat Stroke,Shimla,Jammu & Kashmir,2023-02-01,4396,314,4082,125,5
Heat Stroke,Shimla,Jammu & Kashmir,2023-03-01,82,4,78,67,4
Heat Stroke,Shimla,Jammu & Kashmir,2023-04-01,2752,16,2736,75,5
Heat Stroke,Shimla,Jammu & Kashmir,2023-05-01,2383,25,2358,130,5
Heat Stroke,Shimla,Jammu & Kashmir,2023-06-01,3498,137,3361,152,7
Heat Stroke,Shimla,Jammu & Kashmir,2023-07-01,2883,297,2586,171,4
Heat Stroke,Shimla,Jammu & Kashmir,2023-08-01,1589,40,1549,96,3
Heat Stroke,Shimla,Jammu & Kashmir,2023-09-01,2169,95,2074,130,5
Heat Stroke,Shimla,Jammu & Kashmir,2023-10-01,1530,52,1478,119,3
Heat Stroke,Shimla,Jammu & Kashmir,2023-11-01,4041,137,3904,107,5
Heat Stroke,Shimla,Jammu & Kashmir,2023-12-01,2626,145,2481,65,2
Heat Stroke,Shimla,Jammu & Kashmir,2024-01-01,4989,442,4547,58,8
Heat Stroke,Shimla,Jammu & Kashmir,2024-02-01,2516,159,2357,140,3
Heat Stroke,Shimla,Jammu & Kashmir,2024-03-01,1647,43,1604,64,8
Heat Stroke,Shimla,Jammu & Kashmir,2024-04-01,567,73,494,16,5
Heat Stroke,Shimla,Jammu & Kashmir,2024-05-01,178,9,169,105,7
Heat Stroke,Shimla,Jammu & Kashmir,2024-06-01,472,15,457,180,3
Heat Stroke,Shimla,Jammu & Kashmir,2024-07-01,2956,269,2687,11,1
Heat Stroke,Shimla,Jammu & Kashmir,2024-08-01,3280,119,3161,92,1
Heat Stroke,Shimla,Jammu & Kashmir,2024-09-01,476,46,430,141,10
Heat Stroke,Shimla,Jammu & Kashmir,2024-10-01,3798,93,3705,13,3
Heat Stroke,Shimla,Jammu & Kashmir,2024-11-01,1949,178,1771,95,8
Heat Stroke,Shimla,Jammu & Kashmir,2024-12-01,2794,156,2638,48,1
Heat Stroke,Shimla,Jammu & Kashmir,2025-01-01,4760,417,4343,55,5
Heat Stroke,Shimla,Jammu & Kashmir,2025-02-01,3801,400,3401,86,6
Heat Stroke,Shimla,Jammu & Kashmir,2025-03-01,2237,38,2199,49,10
Heat Stroke,Shimla,Jammu & Kashmir,2025-04-01,1402,122,1280,45,4
Heat Stroke,Shimla,Jammu & Kashmir,2025-05-01,78,0,78,103,3
Heat Stroke,Shimla,Jammu & Kashmir,2025-06-01,1633,31,1602,200,6
Heat Stroke,Shimla,Jammu & Kashmir,2025-07-01,2314,61,2253,145,2
Heat Stroke,Shimla,Jammu & Kashmir,2025-08-01,1273,82,1191,158,6
Heat Stroke,Shimla,Jammu & Kashmir,2025-09-01,2421,123,2298,147,5
Heat Stroke,Shimla,Jammu & Kashmir,2025-10-01,2701,122,2579,71,3
Heat Stroke,Shimla,Jammu & Kashmir,2025-11-01,2296,124,2172,122,6
Heat Stroke,Shimla,Jammu & Kashmir,2025-12-01,1725,116,1609,162,5
Heat Stroke,Shimla,Haryana,2018-01-01,2824,196,2628,148,7
Heat Stroke,Shimla,Haryana,2018-02-01,3190,261,2929,116,10
Heat Stroke,Shimla,Haryana,2018-03-01,1135,116,1019,133,3
Heat Stroke,Shimla,Haryana,2018-04-01,4490,222,4268,200,4
Heat Stroke,Shimla,Haryana,2018-05-01,2465,86,2379,149,1
Heat Stroke,Shimla,Haryana,2018-06-01,2623,178,2445,90,6
Heat Stroke,Shimla,Haryana,2018-07-01,3547,59,3488,102,3
Heat Stroke,Shimla,Haryana,2018-08-01,2910,88,2822,53,6
Heat Stroke,Shimla,Haryana,2018-09-01,3876,306,3570,200,8
Heat Stroke,Shimla,Haryana,2018-10-01,2983,138,2845,188,3
Heat Stroke,Shimla,Haryana,2018-11-01,1776,26,1750,110,3
Heat Stroke,Shimla,Haryana,2018-12-01,3082,20,3062,200,8
Heat Stroke,Shimla,Haryana,2019-01-01,1063,54,1009,138,7
Heat Stroke,Shimla,Haryana,2019-02-01,2743,228,2515,84,7
Heat Stroke,Shimla,Haryana,2019-03-01,2553,211,2342,152,4
Heat Stroke,Shimla,Haryana,2019-04-01,2318,123,2195,127,1
Heat Stroke,Shimla,Haryana,2019-05-01,2425,263,2162,149,3
Heat Stroke,Shimla,Haryana,2019-06-01,78,0,78,36,2
Heat Stroke,Shimla,Haryana,2019-07-01,1861,85,1776,65,7
Heat Stroke,Shimla,Haryana,2019-08-01,2722,0,2722,182,6
Heat Stroke,Shimla,Haryana,2019-09-01,2812,104,2708,192,3
Heat Stroke,Shimla,Haryana,2019-10-01,1219,91,1128,178,4
Heat Stroke,Shimla,Haryana,2019-11-01,4295,410,3885,200,6
Heat Stroke,Shimla,Haryana,2019-12-01,1435,37,1398,136,4
Heat Stroke,Shimla,Haryana,2020-01-01,3898,247,3651,132,3
Heat Stroke,Shimla,Haryana,2020-02-01,3170,255,2915,60,10
Heat Stroke,Shimla,Haryana,2020-03-01,1730,87,1643,77,3
Heat Stroke,Shimla,Haryana,2020-04-01,4979,10,4969,11,7
Heat Stroke,Shimla,Haryana,2020-05-01,996,57,939,90,6
Heat Stroke,Shimla,Haryana,2020-06-01,3830,276,3554,11,1
Heat Stroke,Shimla,Haryana,2020-07-01,3940,88,3852,161,3
Heat Stroke,Shimla,Haryana,2020-08-01,1698,72,1626,126,7
Heat Stroke,Shimla,Haryana,2020-09-01,4465,73,4392,11,4
Heat Stroke,Shimla,Haryana,2020-10-01,2262,0,2262,97,1
Heat Stroke,Shimla,Haryana,2020-11-01,2985,238,2747,200,6
Heat Stroke,Shimla,Haryana,2020-12-01,2947,147,2800,100,3
Heat Stroke,Shimla,Haryana,2021-01-01,2417,233,2184,55,6
Heat Stroke,Shimla,Haryana,2021-02-01,3685,276,3409,15,10
Heat Stroke,Shimla,Haryana,2021-03-01,3662,145,3517,17,6
Heat Stroke,Shimla,Haryana,2021-04-01,252,12,240,133,7
Heat Stroke,Shimla,Haryana,2021-05-01,4347,289,4058,84,4
Heat Stroke,Shimla,Haryana,2021-06-01,367,28,339,88,2
Heat Stroke,Shimla,Haryana,2021-07-01,3983,236,3747,84,8
Heat Stroke,Shimla,Haryana,2021-08-01,4109,337,3772,99,3
Heat Stroke,Shimla,Haryana,2021-09-01,1134,46,1088,44,4
Heat Stroke,Shimla,Haryana,2021-10-01,2046,43,2003,122,10
Heat Stroke,Shimla,Haryana,2021-11-01,1114,53,1061,34,4
Heat Stroke,Shimla,Haryana,2021-12-01,2309,129,2180,68,8
Heat Stroke,Shimla,Haryana,2022-01-01,2184,32,2152,158,6
Heat Stroke,Shimla,Haryana,2022-02-01,3643,40,3603,125,3
Heat Stroke,Shimla,Haryana,2022-03-01,4355,274,4081,141,6
Heat Stroke,Shimla,Haryana,2022-04-01,4470,170,4300,200,3
Heat Stroke,Shimla,Haryana,2022-05-01,1843,83,1760,103,7
Heat Stroke,Shimla,Haryana,2022-06-01,2317,91,2226,107,8
Heat Stroke,Shimla,Haryana,2022-07-01,339,31,308,93,5
Heat Stroke,Shimla,Haryana,2022-08-01,1516,131,1385,84,9
Heat Stroke,Shimla,Haryana,2022-09-01,3892,54,3838,55,5
Heat Stroke,Shimla,Haryana,2022-10-01,4765,164,4601,110,7
Heat Stroke,Shimla,Haryana,2022-11-01,942,70,872,124,10
Heat Stroke,Shimla,Haryana,2022-12-01,1803,121,1682,127,10
Heat Stroke,Shimla,Haryana,2023-01-01,2562,125,2437,109,4
Heat Stroke,Shimla,Haryana,2023-02-01,2973,50,2923,153,6
Heat Stroke,Shimla,Haryana,2023-03-01,1511,45,1466,108,2
Heat Stroke,Shimla,Haryana,2023-04-01,3166,110,3056,85,7
Heat Stroke,Shimla,Haryana,2023-05-01,1962,114,1848,59,6
Heat Stroke,Shimla,Haryana,2023-06-01,2578,256,2322,27,3
Heat Stroke,Shimla,Haryana,2023-07-01,3330,100,3230,181,8
Heat Stroke,Shimla,Haryana,2023-08-01,2606,52,2554,71,4
Heat Stroke,Shimla,Haryana,2023-09-01,2012,94,1918,59,3
Heat Stroke,Shimla,Haryana,2023-10-01,2450,196,2254,85,6
Heat Stroke,Shimla,Haryana,2023-11-01,2479,19,2460,92,3
Heat Stroke,Shimla,Haryana,2023-12-01,2101,194,1907,190,5
Heat Stroke,Shimla,Haryana,2024-01-01,2250,101,2149,89,10
Heat Stroke,Shimla,Haryana,2024-02-01,4742,136,4606,200,3
Heat Stroke,Shimla,Haryana,2024-03-01,3350,11,3339,109,7
Heat Stroke,Shimla,Haryana,2024-04-01,2201,155,2046,200,3
Heat Stroke,Shimla,Haryana,2024-05-01,3532,159,3373,152,2
Heat Stroke,Shimla,Haryana,2024-06-01,2150,118,2032,125,5
Heat Stroke,Shimla,Haryana,2024-07-01,4171,99,4072,187,10
Heat Stroke,Shimla,Haryana,2024-08-01,3093,126,2967,163,7
Heat Stroke,Shimla,Haryana,2024-09-01,2453,88,2365,139,6
Heat Stroke,Shimla,Haryana,2024-10-01,3198,150,3048,200,3
Heat Stroke,Shimla,Haryana,2024-11-01,490,14,476,81,4
Heat Stroke,Shimla,Haryana,2024-12-01,1086,5,1081,56,1
Heat Stroke,Shimla,Haryana,2025-01-01,996,128,868,72,10
Heat Stroke,Shimla,Haryana,2025-02-01,2789,28,2761,195,6
Heat Stroke,Shimla,Haryana,2025-03-01,4922,272,4650,180,5
Heat Stroke,Shimla,Haryana,2025-04-01,4989,20,4969,79,5
Heat Stroke,Shimla,Haryana,2025-05-01,3453,0,3453,11,10
Heat Stroke,Shimla,Haryana,2025-06-01,3269,172,3097,96,6
Heat Stroke,Shimla,Haryana,2025-07-01,181,9,172,55,4
Heat Stroke,Shimla,Haryana,2025-08-01,1869,162,1707,81,10
Heat Stroke,Shimla,Haryana,2025-09-01,1541,95,1446,52,4
Heat Stroke,Shimla,Haryana,2025-10-01,1765,80,1685,24,1
Heat Stroke,Shimla,Haryana,2025-11-01,2372,53,2319,200,1
Heat Stroke,Shimla,Haryana,2025-12-01,1964,184,1780,71,4
Heat Stroke,Manali,Punjab,2018-01-01,78,0,78,178,6
Heat Stroke,Manali,Punjab,2018-02-01,3601,49,3552,95,7
Heat Stroke,Manali,Punjab,2018-03-01,1158,59,1099,49,2
Heat Stroke,Manali,Punjab,2018-04-01,2918,158,2760,132,4
Heat Stroke,Manali,Punjab,2018-05-01,4989,199,4790,86,2
Heat Stroke,Manali,Punjab,2018-06-01,1364,98,1266,96,8
Heat Stroke,Manali,Punjab,2018-07-01,78,0,78,114,9
Heat Stroke,Manali,Punjab,2018-08-01,2214,98,2116,65,10
Heat Stroke,Manali,Punjab,2018-09-01,4074,170,3904,24,6
Heat Stroke,Manali,Punjab,2018-10-01,4989,442,4547,104,10
Heat Stroke,Manali,Punjab,2018-11-01,948,73,875,155,3
Heat Stroke,Manali,Punjab,2018-12-01,3264,170,3094,60,5
Heat Stroke,Manali,Punjab,2019-01-01,1973,5,1968,114,2
Heat Stroke,Manali,Punjab,2019-02-01,2455,147,2308,183,6
Heat Stroke,Manali,Punjab,2019-03-01,4989,351,4638,102,6
Heat Stroke,Manali,Punjab,2019-04-01,581,0,581,111,1
Heat Stroke,Manali,Punjab,2019-05-01,2938,168,2770,109,8
Heat Stroke,Manali,Punjab,2019-06-01,3225,122,3103,71,7
Heat Stroke,Manali,Punjab,2019-07-01,4054,176,3878,56,3
Heat Stroke,Manali,Punjab,2019-08-01,2729,64,2665,56,6
Heat Stroke,Manali,Punjab,2019-09-01,3011,137,2874,125,1
Heat Stroke,Manali,Punjab,2019-10-01,2072,187,1885,145,3
Heat Stroke,Manali,Punjab,2019-11-01,2958,109,2849,147,10
Heat Stroke,Manali,Punjab,2019-12-01,2137,167,1970,87,1
Heat Stroke,Manali,Punjab,2020-01-01,3431,91,3340,162,5
Heat Stroke,Manali,Punjab,2020-02-01,2102,151,1951,122,1
Heat Stroke,Manali,Punjab,2020-03-01,3103,155,2948,110,6
Heat Stroke,Manali,Punjab,2020-04-01,2558,154,2404,11,6
Heat Stroke,Manali,Punjab,2020-05-01,4108,206,3902,65,7
Heat Stroke,Manali,Punjab,2020-06-01,2528,173,2355,29,6
Heat Stroke,Manali,Punjab,2020-07-01,219,0,219,138,9
Heat Stroke,Manali,Punjab,2020-08-01,4290,37,4253,111,3
Heat Stroke,Manali,Punjab,2020-09-01,1382,85,1297,52,2
Heat Stroke,Manali,Punjab,2020-10-01,1720,0,1720,122,3
Heat Stroke,Manali,Punjab,2020-11-01,1798,62,1736,34,1
Heat Stroke,Manali,Punjab,2020-12-01,4441,215,4226,53,5
Heat Stroke,Manali,Punjab,2021-01-01,78,0,78,70,4
Heat Stroke,Manali,Punjab,2021-02-01,4989,149,4840,134,6
Heat Stroke,Manali,Punjab,2021-03-01,4014,232,3782,178,1
Heat Stroke,Manali,Punjab,2021-04-01,2897,230,2667,76,5
Heat Stroke,Manali,Punjab,2021-05-01,2524,55,2469,174,8
Heat Stroke,Manali,Punjab,2021-06-01,2980,99,2881,109,6
Heat Stroke,Manali,Punjab,2021-07-01,3296,94,3202,118,1
Heat Stroke,Manali,Punjab,2021-08-01,3463,0,3463,103,5
Heat Stroke,Manali,Punjab,2021-09-01,3343,181,3162,96,3
Heat Stroke,Manali,Punjab,2021-10-01,2718,210,2508,129,5
Heat Stroke,Manali,Punjab,2021-11-01,2333,185,2148,144,4
Heat Stroke,Manali,Punjab,2021-12-01,2394,59,2335,61,10
Heat Stroke,Manali,Punjab,2022-01-01,2336,31,2305,97,5
Heat Stroke,Manali,Punjab,2022-02-01,4118,208,3910,191,6
Heat Stroke,Manali,Punjab,2022-03-01,3394,251,3143,115,5
Heat Stroke,Manali,Punjab,2022-04-01,78,0,78,121,6
Heat Stroke,Manali,Punjab,2022-05-01,3477,203,3274,166,4
Heat Stroke,Manali,Punjab,2022-06-01,2859,238,2621,81,7
Heat Stroke,Manali,Punjab,2022-07-01,2572,73,2499,104,4
Heat Stroke,Manali,Punjab,2022-08-01,2076,90,1986,148,9
Heat Stroke,Manali,Punjab,2022-09-01,4105,400,3705,169,6
Heat Stroke,Manali,Punjab,2022-10-01,3869,171,3698,11,4
Heat Stroke,Manali,Punjab,2022-11-01,1561,20,1541,69,7
Heat Stroke,Manali,Punjab,2022-12-01,3143,96,3047,55,6
Heat Stroke,Manali,Punjab,2023-01-01,1294,29,1265,100,7
Heat Stroke,Manali,Punjab,2023-02-01,747,45,702,59,5
Heat Stroke,Manali,Punjab,2023-03-01,1757,42,1715,140,4
Heat Stroke,Manali,Punjab,2023-04-01,3754,217,3537,115,5
Heat Stroke,Manali,Punjab,2023-05-01,3876,111,3765,152,3
Heat Stroke,Manali,Punjab,2023-06-01,3286,0,3286,155,8
Heat Stroke,Manali,Punjab,2023-07-01,3570,210,3360,141,9
Heat Stroke,Manali,Punjab,2023-08-01,3290,178,3112,89,7
Heat Stroke,Manali,Punjab,2023-09-01,1737,113,1624,112,9
Heat Stroke,Manali,Punjab,2023-10-01,3177,96,3081,83,8
Heat Stroke,Manali,Punjab,2023-11-01,3671,100,3571,37,4
Heat Stroke,Manali,Punjab,2023-12-01,3609,222,3387,155,7
Heat Stroke,Manali,Punjab,2024-01-01,4192,395,3797,102,1
Heat Stroke,Manali,Punjab,2024-02-01,3548,178,3370,30,5
Heat Stroke,Manali,Punjab,2024-03-01,3069,191,2878,134,1
Heat Stroke,Manali,Punjab,2024-04-01,4033,164,3869,95,5
Heat Stroke,Manali,Punjab,2024-05-01,2562,13,2549,11,1
Heat Stroke,Manali,Punjab,2024-06-01,1414,110,1304,36,8
Heat Stroke,Manali,Punjab,2024-07-01,2379,182,2197,71,4
Heat Stroke,Manali,Punjab,2024-08-01,1598,113,1485,117,7
Heat Stroke,Manali,Punjab,2024-09-01,1692,75,1617,146,5
Heat Stroke,Manali,Punjab,2024-10-01,2404,162,2242,145,1
Heat Stroke,Manali,Punjab,2024-11-01,1534,116,1418,137,3
Heat Stroke,Manali,Punjab,2024-12-01,2184,212,1972,104,3
Heat Stroke,Manali,Punjab,2025-01-01,78,0,78,194,5
Heat Stroke,Manali,Punjab,2025-02-01,2884,149,2735,142,9
Heat Stroke,Manali,Punjab,2025-03-01,2599,31,2568,118,10
Heat Stroke,Manali,Punjab,2025-04-01,1501,81,1420,135,4
Heat Stroke,Manali,Punjab,2025-05-01,3482,200,3282,86,1
Heat Stroke,Manali,Punjab,2025-06-01,3855,272,3583,103,3
Heat Stroke,Manali,Punjab,2025-07-01,441,39,402,11,6
Heat Stroke,Manali,Punjab,2025-08-01,1574,74,1500,87,5
Heat Stroke,Manali,Punjab,2025-09-01,1566,174,1392,196,1
Heat Stroke,Manali,Punjab,2025-10-01,1337,0,1337,114,3
Heat Stroke,Manali,Punjab,2025-11-01,3710,231,3479,112,9
Heat Stroke,Manali,Punjab,2025-12-01,2337,62,2275,157,6
Heat Stroke,Manali,Chandigarh,2018-01-01,2243,0,2243,124,5
Heat Stroke,Manali,Chandigarh,2018-02-01,78,0,78,66,4
Heat Stroke,Manali,Chandigarh,2018-03-01,3450,26,3424,107,3
Heat Stroke,Manali,Chandigarh,2018-04-01,935,42,893,48,6
Heat Stroke,Manali,Chandigarh,2018-05-01,2678,136,2542,116,5
Heat Stroke,Manali,Chandigarh,2018-06-01,2970,245,2725,64,7
Heat Stroke,Manali,Chandigarh,2018-07-01,4423,27,4396,154,6
Heat Stroke,Manali,Chandigarh,2018-08-01,842,64,778,80,5
Heat Stroke,Manali,Chandigarh,2018-09-01,78,0,78,64,6
Heat Stroke,Manali,Chandigarh,2018-10-01,2844,227,2617,100,3
Heat Stroke,Manali,Chandigarh,2018-11-01,4989,187,4802,125,5
Heat Stroke,Manali,Chandigarh,2018-12-01,4259,48,4211,45,9
Heat Stroke,Manali,Chandigarh,2019-01-01,2879,42,2837,80,5
Heat Stroke,Manali,Chandigarh,2019-02-01,1938,24,1914,112,4
Heat Stroke,Manali,Chandigarh,2019-03-01,3680,235,3445,174,5
Heat Stroke,Manali,Chandigarh,2019-04-01,1291,120,1171,11,1
Heat Stroke,Manali,Chandigarh,2019-05-01,3236,108,3128,138,5
Heat Stroke,Manali,Chandigarh,2019-06-01,3275,223,3052,87,10
Heat Stroke,Manali,Chandigarh,2019-07-01,4020,23,3997,81,2
Heat Stroke,Manali,Chandigarh,2019-08-01,4989,275,4714,72,6
Heat Stroke,Manali,Chandigarh,2019-09-01,3124,217,2907,88,5
Heat Stroke,Manali,Chandigarh,2019-10-01,1915,15,1900,138,5
Heat Stroke,Manali,Chandigarh,2019-11-01,2563,113,2450,79,5
Heat Stroke,Manali,Chandigarh,2019-12-01,224,15,209,191,7
Heat Stroke,Manali,Chandigarh,2020-01-01,1665,0,1665,138,2
Heat Stroke,Manali,Chandigarh,2020-02-01,2048,182,1866,116,7
Heat Stroke,Manali,Chandigarh,2020-03-01,1894,114,1780,98,5
Heat Stroke,Manali,Chandigarh,2020-04-01,2802,198,2604,167,1
Heat Stroke,Manali,Chandigarh,2020-05-01,1494,56,1438,174,6
Heat Stroke,Manali,Chandigarh,2020-06-01,4101,0,4101,47,5
Heat Stroke,Manali,Chandigarh,2020-07-01,2598,170,2428,70,2
Heat Stroke,Manali,Chandigarh,2020-08-01,2585,123,2462,139,5
Heat Stroke,Manali,Chandigarh,2020-09-01,2158,110,2048,154,1
Heat Stroke,Manali,Chandigarh,2020-10-01,2806,229,2577,91,3
Heat Stroke,Manali,Chandigarh,2020-11-01,3704,267,3437,68,5
Heat Stroke,Manali,Chandigarh,2020-12-01,1434,151,1283,110,1
Heat Stroke,Manali,Chandigarh,2021-01-01,1715,93,1622,181,1
Heat Stroke,Manali,Chandigarh,2021-02-01,2190,65,2125,108,2
Heat Stroke,Manali,Chandigarh,2021-03-01,792,35,757,42,5
Heat Stroke,Manali,Chandigarh,2021-04-01,1498,93,1405,112,6
Heat Stroke,Manali,Chandigarh,2021-05-01,1959,156,1803,146,2
Heat Stroke,Manali,Chandigarh,2021-06-01,3770,27,3743,101,2
Heat Stroke,Manali,Chandigarh,2021-07-01,2950,148,2802,170,5
Heat Stroke,Manali,Chandigarh,2021-08-01,2857,276,2581,150,5
Heat Stroke,Manali,Chandigarh,2021-09-01,3739,161,3578,103,3
Heat Stroke,Manali,Chandigarh,2021-10-01,2413,186,2227,108,10
Heat Stroke,Manali,Chandigarh,2021-11-01,3121,201,2920,12,5
Heat Stroke,Manali,Chandigarh,2021-12-01,2459,191,2268,168,4
Heat Stroke,Manali,Chandigarh,2022-01-01,2953,78,2875,89,4
Heat Stroke,Manali,Chandigarh,2022-02-01,1816,48,1768,86,8
Heat Stroke,Manali,Chandigarh,2022-03-01,78,0,78,78,6
Heat Stroke,Manali,Chandigarh,2022-04-01,2417,13,2404,129,1
Heat Stroke,Manali,Chandigarh,2022-05-01,4506,190,4316,49,3
Heat Stroke,Manali,Chandigarh,2022-06-01,3840,220,3620,56,4
Heat Stroke,Manali,Chandigarh,2022-07-01,3892,397,3495,104,5
Heat Stroke,Manali,Chandigarh,2022-08-01,4256,262,3994,74,7
Heat Stroke,Manali,Chandigarh,2022-09-01,2716,185,2531,123,2
Heat Stroke,Manali,Chandigarh,2022-10-01,2862,240,2622,76,5
Heat Stroke,Manali,Chandigarh,2022-11-01,1769,38,1731,187,10
Heat Stroke,Manali,Chandigarh,2022-12-01,2173,98,2075,142,5
Heat Stroke,Manali,Chandigarh,2023-01-01,3423,413,3010,141,3
Heat Stroke,Manali,Chandigarh,2023-02-01,4212,201,4011,75,1
Heat Stroke,Manali,Chandigarh,2023-03-01,2410,198,2212,200,3
Heat Stroke,Manali,Chandigarh,2023-04-01,1993,155,1838,84,2
Heat Stroke,Manali,Chandigarh,2023-05-01,2598,18,2580,70,4
Heat Stroke,Manali,Chandigarh,2023-06-01,3404,201,3203,142,6
Heat Stroke,Manali,Chandigarh,2023-07-01,660,35,625,116,5
Heat Stroke,Manali,Chandigarh,2023-08-01,78,0,78,65,3
Heat Stroke,Manali,Chandigarh,2023-09-01,1859,52,1807,200,1
Heat Stroke,Manali,Chandigarh,2023-10-01,960,16,944,156,7
Heat Stroke,Manali,Chandigarh,2023-11-01,1916,69,1847,106,4
Heat Stroke,Manali,Chandigarh,2023-12-01,2399,113,2286,200,5
Heat Stroke,Manali,Chandigarh,2024-01-01,1989,168,1821,148,2
Heat Stroke,Manali,Chandigarh,2024-02-01,4546,442,4104,106,4
Heat Stroke,Manali,Chandigarh,2024-03-01,3036,275,2761,200,3
Heat Stroke,Manali,Chandigarh,2024-04-01,3000,225,2775,140,1
Heat Stroke,Manali,Chandigarh,2024-05-01,3432,71,3361,138,2
Heat Stroke,Manali,Chandigarh,2024-06-01,1070,40,1030,87,5
Heat Stroke,Manali,Chandigarh,2024-07-01,3991,224,3767,109,6
Heat Stroke,Manali,Chandigarh,2024-08-01,2496,79,2417,85,3
Heat Stroke,Manali,Chandigarh,2024-09-01,3497,233,3264,180,1
Heat Stroke,Manali,Chandigarh,2024-10-01,1160,82,1078,24,4
Heat Stroke,Manali,Chandigarh,2024-11-01,513,33,480,176,7
Heat Stroke,Manali,Chandigarh,2024-12-01,3695,295,3400,62,2
Heat Stroke,Manali,Chandigarh,2025-01-01,3102,73,3029,103,5
Heat Stroke,Manali,Chandigarh,2025-02-01,1387,107,1280,91,3
Heat Stroke,Manali,Chandigarh,2025-03-01,1431,42,1389,80,8
Heat Stroke,Manali,Chandigarh,2025-04-01,4107,93,4014,141,3
Heat Stroke,Manali,Chandigarh,2025-05-01,1002,65,937,106,7
Heat Stroke,Manali,Chandigarh,2025-06-01,4801,410,4391,72,8
Heat Stroke,Manali,Chandigarh,2025-07-01,1389,89,1300,114,9
Heat Stroke,Manali,Chandigarh,2025-08-01,3454,175,3279,71,1
Heat Stroke,Manali,Chandigarh,2025-09-01,2157,127,2030,79,1
Heat Stroke,Manali,Chandigarh,2025-10-01,3407,184,3223,30,8
Heat Stroke,Manali,Chandigarh,2025-11-01,1867,32,1835,83,8
Heat Stroke,Manali,Chandigarh,2025-12-01,2379,33,2346,131,3
Heat Stroke,Manali,Himachal Pradesh,2018-01-01,2652,126,2526,108,1
Heat Stroke,Manali,Himachal Pradesh,2018-02-01,1253,65,1188,199,5
Heat Stroke,Manali,Himachal Pradesh,2018-03-01,3591,180,3411,200,1
Heat Stroke,Manali,Himachal Pradesh,2018-04-01,1909,133,1776,83,2
Heat Stroke,Manali,Himachal Pradesh,2018-05-01,2291,100,2191,64,5
Heat Stroke,Manali,Himachal Pradesh,2018-06-01,1263,83,1180,164,6
Heat Stroke,Manali,Himachal Pradesh,2018-07-01,78,0,78,123,9
Heat Stroke,Manali,Himachal Pradesh,2018-08-01,2341,241,2100,164,4
Heat Stroke,Manali,Himachal Pradesh,2018-09-01,4989,261,4728,127,2
Heat Stroke,Manali,Himachal Pradesh,2018-10-01,3650,431,3219,96,7
Heat Stroke,Manali,Himachal Pradesh,2018-11-01,2572,155,2417,97,6
Heat Stroke,Manali,Himachal Pradesh,2018-12-01,2245,98,2147,128,4
Heat Stroke,Manali,Himachal Pradesh,2019-01-01,2628,62,2566,95,5
Heat Stroke,Manali,Himachal Pradesh,2019-02-01,3331,26,3305,168,4
Heat Stroke,Manali,Himachal Pradesh,2019-03-01,1013,21,992,40,7
Heat Stroke,Manali,Himachal Pradesh,2019-04-01,4092,100,3992,168,10
Heat Stroke,Manali,Himachal Pradesh,2019-05-01,3557,218,3339,11,3
Heat Stroke,Manali,Himachal Pradesh,2019-06-01,3561,123,3438,114,6
Heat Stroke,Manali,Himachal Pradesh,2019-07-01,3186,176,3010,89,1
Heat Stroke,Manali,Himachal Pradesh,2019-08-01,2624,229,2395,29,2
Heat Stroke,Manali,Himachal Pradesh,2019-09-01,3500,166,3334,11,6
Heat Stroke,Manali,Himachal Pradesh,2019-10-01,3391,374,3017,50,5
Heat Stroke,Manali,Himachal Pradesh,2019-11-01,2122,33,2089,109,2
Heat Stroke,Manali,Himachal Pradesh,2019-12-01,1828,83,1745,76,5
Heat Stroke,Manali,Himachal Pradesh,2020-01-01,2734,93,2641,53,7
Heat Stroke,Manali,Himachal Pradesh,2020-02-01,4675,361,4314,175,1
Heat Stroke,Manali,Himachal Pradesh,2020-03-01,935,0,935,43,10
Heat Stroke,Manali,Himachal Pradesh,2020-04-01,629,5,624,141,6
Heat Stroke,Manali,Himachal Pradesh,2020-05-01,2818,132,2686,61,7
Heat Stroke,Manali,Himachal Pradesh,2020-06-01,2666,253,2413,49,5
Heat Stroke,Manali,Himachal Pradesh,2020-07-01,2830,160,2670,75,10
Heat Stroke,Manali,Himachal Pradesh,2020-08-01,2925,31,2894,138,8
Heat Stroke,Manali,Himachal Pradesh,2020-09-01,2298,34,2264,36,4
Heat Stroke,Manali,Himachal Pradesh,2020-10-01,4596,442,4154,121,7
Heat Stroke,Manali,Himachal Pradesh,2020-11-01,450,14,436,57,3
Heat Stroke,Manali,Himachal Pradesh,2020-12-01,1486,33,1453,66,4
Heat Stroke,Manali,Himachal Pradesh,2021-01-01,2459,228,2231,127,9
Heat Stroke,Manali,Himachal Pradesh,2021-02-01,393,31,362,200,6
Heat Stroke,Manali,Himachal Pradesh,2021-03-01,2361,205,2156,60,7
Heat Stroke,Manali,Himachal Pradesh,2021-04-01,4826,108,4718,143,8
Heat Stroke,Manali,Himachal Pradesh,2021-05-01,2625,14,2611,90,6
Heat Stroke,Manali,Himachal Pradesh,2021-06-01,2907,156,2751,82,2
Heat Stroke,Manali,Himachal Pradesh,2021-07-01,907,54,853,161,10
Heat Stroke,Manali,Himachal Pradesh,2021-08-01,1771,107,1664,63,6
Heat Stroke,Manali,Himachal Pradesh,2021-09-01,2094,194,1900,47,7
Heat Stroke,Manali,Himachal Pradesh,2021-10-01,2171,0,2171,130,5
Heat Stroke,Manali,Himachal Pradesh,2021-11-01,4317,324,3993,187,8
Heat Stroke,Manali,Himachal Pradesh,2021-12-01,3346,60,3286,144,10
Heat Stroke,Manali,Himachal Pradesh,2022-01-01,1106,82,1024,35,4
Heat Stroke,Manali,Himachal Pradesh,2022-02-01,2928,106,2822,75,8
Heat Stroke,Manali,Himachal Pradesh,2022-03-01,3266,86,3180,156,5
Heat Stroke,Manali,Himachal Pradesh,2022-04-01,4127,133,3994,187,1
Heat Stroke,Manali,Himachal Pradesh,2022-05-01,4718,37,4681,118,1
Heat Stroke,Manali,Himachal Pradesh,2022-06-01,1236,63,1173,77,6
Heat Stroke,Manali,Himachal Pradesh,2022-07-01,1510,41,1469,190,8
Heat Stroke,Manali,Himachal Pradesh,2022-08-01,910,66,844,102,7
Heat Stroke,Manali,Himachal Pradesh,2022-09-01,2283,156,2127,75,7
Heat Stroke,Manali,Himachal Pradesh,2022-10-01,3223,319,2904,67,10
Heat Stroke,Manali,Himachal Pradesh,2022-11-01,3922,238,3684,45,6
Heat Stroke,Manali,Himachal Pradesh,2022-12-01,2496,162,2334,200,4
Heat Stroke,Manali,Himachal Pradesh,2023-01-01,2168,196,1972,179,4
Heat Stroke,Manali,Himachal Pradesh,2023-02-01,2801,89,2712,73,10
Heat Stroke,Manali,Himachal Pradesh,2023-03-01,1477,9,1468,194,1
Heat Stroke,Manali,Himachal Pradesh,2023-04-01,4989,278,4711,133,8
Heat Stroke,Manali,Himachal Pradesh,2023-05-01,441,3,438,130,5
Heat Stroke,Manali,Himachal Pradesh,2023-06-01,2845,345,2500,70,2
Heat Stroke,Manali,Himachal Pradesh,2023-07-01,4989,442,4547,80,1
Heat Stroke,Manali,Himachal Pradesh,2023-08-01,2607,294,2313,104,9
Heat Stroke,Manali,Himachal Pradesh,2023-09-01,2342,121,2221,11,2
Heat Stroke,Manali,Himachal Pradesh,2023-10-01,2118,139,1979,81,5
Heat Stroke,Manali,Himachal Pradesh,2023-11-01,2355,86,2269,106,2
Heat Stroke,Manali,Himachal Pradesh,2023-12-01,4439,336,4103,173,10
Heat Stroke,Manali,Himachal Pradesh,2024-01-01,78,0,78,75,5
Heat Stroke,Manali,Himachal Pradesh,2024-02-01,4655,0,4655,148,1
Heat Stroke,Manali,Himachal Pradesh,2024-03-01,687,18,669,11,4
Heat Stroke,Manali,Himachal Pradesh,2024-04-01,2240,17,2223,166,9
Heat Stroke,Manali,Himachal Pradesh,2024-05-01,2022,188,1834,60,2
Heat Stroke,Manali,Himachal Pradesh,2024-06-01,3387,348,3039,113,4
Heat Stroke,Manali,Himachal Pradesh,2024-07-01,454,4,450,127,8
Heat Stroke,Manali,Himachal Pradesh,2024-08-01,3217,282,2935,117,6
Heat Stroke,Manali,Himachal Pradesh,2024-09-01,4989,387,4602,101,1
Heat Stroke,Manali,Himachal Pradesh,2024-10-01,769,3,766,43,5
Heat Stroke,Manali,Himachal Pradesh,2024-11-01,2852,110,2742,61,4
Heat Stroke,Manali,Himachal Pradesh,2024-12-01,1709,56,1653,157,5
Heat Stroke,Manali,Himachal Pradesh,2025-01-01,3169,227,2942,76,8
Heat Stroke,Manali,Himachal Pradesh,2025-02-01,2623,37,2586,101,6
Heat Stroke,Manali,Himachal Pradesh,2025-03-01,1737,81,1656,30,5
Heat Stroke,Manali,Himachal Pradesh,2025-04-01,3252,97,3155,150,4
Heat Stroke,Manali,Himachal Pradesh,2025-05-01,4989,318,4671,39,8
Heat Stroke,Manali,Himachal Pradesh,2025-06-01,2341,102,2239,153,3
Heat Stroke,Manali,Himachal Pradesh,2025-07-01,3563,122,3441,52,1
Heat Stroke,Manali,Himachal Pradesh,2025-08-01,862,37,825,158,4
Heat Stroke,Manali,Himachal Pradesh,2025-09-01,1314,143,1171,107,6
Heat Stroke,Manali,Himachal Pradesh,2025-10-01,3231,122,3109,78,4
Heat Stroke,Manali,Himachal Pradesh,2025-11-01,4588,90,4498,188,3
Heat Stroke,Manali,Himachal Pradesh,2025-12-01,3074,206,2868,103,4
Heat Stroke,Manali,Jammu & Kashmir,2018-01-01,2177,99,2078,88,5
Heat Stroke,Manali,Jammu & Kashmir,2018-02-01,2596,23,2573,153,1
Heat Stroke,Manali,Jammu & Kashmir,2018-03-01,920,105,815,31,7
Heat Stroke,Manali,Jammu & Kashmir,2018-04-01,3408,135,3273,11,1
Heat Stroke,Manali,Jammu & Kashmir,2018-05-01,3781,147,3634,165,6
Heat Stroke,Manali,Jammu & Kashmir,2018-06-01,1991,108,1883,64,6
Heat Stroke,Manali,Jammu & Kashmir,2018-07-01,1967,197,1770,150,6
Heat Stroke,Manali,Jammu & Kashmir,2018-08-01,2954,3,2951,109,1
Heat Stroke,Manali,Jammu & Kashmir,2018-09-01,2012,116,1896,47,6
Heat Stroke,Manali,Jammu & Kashmir,2018-10-01,2509,278,2231,137,3
Heat Stroke,Manali,Jammu & Kashmir,2018-11-01,4989,268,4721,85,9
Heat Stroke,Manali,Jammu & Kashmir,2018-12-01,2266,31,2235,51,6
Heat Stroke,Manali,Jammu & Kashmir,2019-01-01,2117,67,2050,53,1
Heat Stroke,Manali,Jammu & Kashmir,2019-02-01,1729,96,1633,18,1
Heat Stroke,Manali,Jammu & Kashmir,2019-03-01,3596,319,3277,127,3
Heat Stroke,Manali,Jammu & Kashmir,2019-04-01,2354,94,2260,59,7
Heat Stroke,Manali,Jammu & Kashmir,2019-05-01,1726,127,1599,104,8
Heat Stroke,Manali,Jammu & Kashmir,2019-06-01,4370,36,4334,97,5
Heat Stroke,Manali,Jammu & Kashmir,2019-07-01,4502,36,4466,58,5
Heat Stroke,Manali,Jammu & Kashmir,2019-08-01,1792,64,1728,29,4
Heat Stroke,Manali,Jammu & Kashmir,2019-09-01,93,8,85,200,5
Heat Stroke,Manali,Jammu & Kashmir,2019-10-01,3949,205,3744,104,8
Heat Stroke,Manali,Jammu & Kashmir,2019-11-01,1679,98,1581,199,4
Heat Stroke,Manali,Jammu & Kashmir,2019-12-01,3658,212,3446,166,7
Heat Stroke,Manali,Jammu & Kashmir,2020-01-01,78,0,78,90,3
Heat Stroke,Manali,Jammu & Kashmir,2020-02-01,3795,122,3673,115,8
Heat Stroke,Manali,Jammu & Kashmir,2020-03-01,973,68,905,114,7
Heat Stroke,Manali,Jammu & Kashmir,2020-04-01,3578,92,3486,200,8
Heat Stroke,Manali,Jammu & Kashmir,2020-05-01,2617,282,2335,148,10
Heat Stroke,Manali,Jammu & Kashmir,2020-06-01,1318,35,1283,65,1
Heat Stroke,Manali,Jammu & Kashmir,2020-07-01,2051,50,2001,124,7
Heat Stroke,Manali,Jammu & Kashmir,2020-08-01,3518,232,3286,147,6
Heat Stroke,Manali,Jammu & Kashmir,2020-09-01,2739,143,2596,46,6
Heat Stroke,Manali,Jammu & Kashmir,2020-10-01,3381,201,3180,131,6
Heat Stroke,Manali,Jammu & Kashmir,2020-11-01,4989,282,4707,175,6
Heat Stroke,Manali,Jammu & Kashmir,2020-12-01,499,9,490,63,6
Heat Stroke,Manali,Jammu & Kashmir,2021-01-01,4767,442,4325,70,7
Heat Stroke,Manali,Jammu & Kashmir,2021-02-01,2737,208,2529,165,7
Heat Stroke,Manali,Jammu & Kashmir,2021-03-01,1392,124,1268,88,5
Heat Stroke,Manali,Jammu & Kashmir,2021-04-01,813,28,785,56,4
Heat Stroke,Manali,Jammu & Kashmir,2021-05-01,2344,145,2199,151,5
Heat Stroke,Manali,Jammu & Kashmir,2021-06-01,3834,213,3621,136,4
Heat Stroke,Manali,Jammu & Kashmir,2021-07-01,2426,201,2225,111,10
Heat Stroke,Manali,Jammu & Kashmir,2021-08-01,4625,387,4238,164,1
Heat Stroke,Manali,Jammu & Kashmir,2021-09-01,651,36,615,167,7
Heat Stroke,Manali,Jammu & Kashmir,2021-10-01,2581,15,2566,102,7
Heat Stroke,Manali,Jammu & Kashmir,2021-11-01,917,93,824,200,3
Heat Stroke,Manali,Jammu & Kashmir,2021-12-01,3085,204,2881,187,6
Heat Stroke,Manali,Jammu & Kashmir,2022-01-01,3787,122,3665,11,8
Heat Stroke,Manali,Jammu & Kashmir,2022-02-01,2033,125,1908,54,4
Heat Stroke,Manali,Jammu & Kashmir,2022-03-01,78,0,78,11,9
Heat Stroke,Manali,Jammu & Kashmir,2022-04-01,2864,231,2633,90,8
Heat Stroke,Manali,Jammu & Kashmir,2022-05-01,3183,23,3160,45,3
Heat Stroke,Manali,Jammu & Kashmir,2022-06-01,3140,137,3003,65,2
Heat Stroke,Manali,Jammu & Kashmir,2022-07-01,4255,243,4012,162,5
Heat Stroke,Manali,Jammu & Kashmir,2022-08-01,1161,93,1068,17,1
Heat Stroke,Manali,Jammu & Kashmir,2022-09-01,3510,186,3324,113,1
Heat Stroke,Manali,Jammu & Kashmir,2022-10-01,4197,287,3910,113,3
Heat Stroke,Manali,Jammu & Kashmir,2022-11-01,211,10,201,102,10
Heat Stroke,Manali,Jammu & Kashmir,2022-12-01,3026,148,2878,113,4
Heat Stroke,Manali,Jammu & Kashmir,2023-01-01,1921,100,1821,11,6
Heat Stroke,Manali,Jammu & Kashmir,2023-02-01,2488,110,2378,65,7
Heat Stroke,Manali,Jammu & Kashmir,2023-03-01,3064,3,3061,185,5
Heat Stroke,Manali,Jammu & Kashmir,2023-04-01,1944,53,1891,45,4
Heat Stroke,Manali,Jammu & Kashmir,2023-05-01,1691,96,1595,191,8
Heat Stroke,Manali,Jammu & Kashmir,2023-06-01,2643,113,2530,35,5
Heat Stroke,Manali,Jammu & Kashmir,2023-07-01,1139,51,1088,28,5
Heat Stroke,Manali,Jammu & Kashmir,2023-08-01,1141,46,1095,58,7
Heat Stroke,Manali,Jammu & Kashmir,2023-09-01,3509,87,3422,164,2
Heat Stroke,Manali,Jammu & Kashmir,2023-10-01,1056,37,1019,78,1
Heat Stroke,Manali,Jammu & Kashmir,2023-11-01,3491,143,3348,124,1
Heat Stroke,Manali,Jammu & Kashmir,2023-12-01,3218,161,3057,110,6
Heat Stroke,Manali,Jammu & Kashmir,2024-01-01,282,17,265,103,4
Heat Stroke,Manali,Jammu & Kashmir,2024-02-01,1688,75,1613,171,7
Heat Stroke,Manali,Jammu & Kashmir,2024-03-01,4199,84,4115,146,5
Heat Stroke,Manali,Jammu & Kashmir,2024-04-01,1281,12,1269,48,1
Heat Stroke,Manali,Jammu & Kashmir,2024-05-01,1974,248,1726,92,4
Heat Stroke,Manali,Jammu & Kashmir,2024-06-01,3217,55,3162,195,7
Heat Stroke,Manali,Jammu & Kashmir,2024-07-01,3648,127,3521,122,4
Heat Stroke,Manali,Jammu & Kashmir,2024-08-01,2260,147,2113,29,8
Heat Stroke,Manali,Jammu & Kashmir,2024-09-01,1796,108,1688,33,4
Heat Stroke,Manali,Jammu & Kashmir,2024-10-01,4506,293,4213,152,7
Heat Stroke,Manali,Jammu & Kashmir,2024-11-01,4930,183,4747,142,1
Heat Stroke,Manali,Jammu & Kashmir,2024-12-01,3911,222,3689,59,4
Heat Stroke,Manali,Jammu & Kashmir,2025-01-01,2712,140,2572,144,4
Heat Stroke,Manali,Jammu & Kashmir,2025-02-01,1513,62,1451,188,1
Heat Stroke,Manali,Jammu & Kashmir,2025-03-01,1483,84,1399,180,8
Heat Stroke,Manali,Jammu & Kashmir,2025-04-01,3298,266,3032,188,3
Heat Stroke,Manali,Jammu & Kashmir,2025-05-01,3159,156,3003,135,3
Heat Stroke,Manali,Jammu & Kashmir,2025-06-01,4478,222,4256,97,9
Heat Stroke,Manali,Jammu & Kashmir,2025-07-01,3470,281,3189,86,5
Heat Stroke,Manali,Jammu & Kashmir,2025-08-01,581,45,536,105,7
Heat Stroke,Manali,Jammu & Kashmir,2025-09-01,4009,385,3624,62,1
Heat Stroke,Manali,Jammu & Kashmir,2025-10-01,1259,0,1259,88,3
Heat Stroke,Manali,Jammu & Kashmir,2025-11-01,2082,159,1923,171,10
Heat Stroke,Manali,Jammu & Kashmir,2025-12-01,2933,198,2735,24,7
Heat Stroke,Manali,Haryana,2018-01-01,4989,121,4868,28,2
Heat Stroke,Manali,Haryana,2018-02-01,4989,286,4703,149,5
Heat Stroke,Manali,Haryana,2018-03-01,3411,275,3136,88,2
Heat Stroke,Manali,Haryana,2018-04-01,2352,61,2291,11,9
Heat Stroke,Manali,Haryana,2018-05-01,3314,208,3106,103,1
Heat Stroke,Manali,Haryana,2018-06-01,3788,285,3503,96,6
Heat Stroke,Manali,Haryana,2018-07-01,2167,40,2127,84,6
Heat Stroke,Manali,Haryana,2018-08-01,4989,229,4760,141,2
Heat Stroke,Manali,Haryana,2018-09-01,2906,170,2736,38,4
Heat Stroke,Manali,Haryana,2018-10-01,3265,87,3178,107,6
Heat Stroke,Manali,Haryana,2018-11-01,3491,85,3406,95,1
Heat Stroke,Manali,Haryana,2018-12-01,3163,145,3018,108,1
Heat Stroke,Manali,Haryana,2019-01-01,3723,273,3450,18,4
Heat Stroke,Manali,Haryana,2019-02-01,1769,121,1648,80,2
Heat Stroke,Manali,Haryana,2019-03-01,1848,46,1802,107,3
Heat Stroke,Manali,Haryana,2019-04-01,1122,77,1045,134,5
Heat Stroke,Manali,Haryana,2019-05-01,3187,82,3105,200,2
Heat Stroke,Manali,Haryana,2019-06-01,3642,11,3631,147,5
Heat Stroke,Manali,Haryana,2019-07-01,3212,126,3086,130,6
Heat Stroke,Manali,Haryana,2019-08-01,4844,400,4444,171,7
Heat Stroke,Manali,Haryana,2019-09-01,2590,179,2411,91,1
Heat Stroke,Manali,Haryana,2019-10-01,3495,174,3321,185,3
Heat Stroke,Manali,Haryana,2019-11-01,1133,42,1091,163,7
Heat Stroke,Manali,Haryana,2019-12-01,2078,80,1998,83,1
Heat Stroke,Manali,Haryana,2020-01-01,3530,187,3343,200,5
Heat Stroke,Manali,Haryana,2020-02-01,3736,70,3666,129,5
Heat Stroke,Manali,Haryana,2020-03-01,2203,87,2116,200,1
Heat Stroke,Manali,Haryana,2020-04-01,2501,109,2392,122,3
Heat Stroke,Manali,Haryana,2020-05-01,561,6,555,78,6
Heat Stroke,Manali,Haryana,2020-06-01,2118,54,2064,67,4
Heat Stroke,Manali,Haryana,2020-07-01,3792,235,3557,88,3
Heat Stroke,Manali,Haryana,2020-08-01,3369,169,3200,77,5
Heat Stroke,Manali,Haryana,2020-09-01,3269,134,3135,171,8
Heat Stroke,Manali,Haryana,2020-10-01,2664,62,2602,105,6
Heat Stroke,Manali,Haryana,2020-11-01,2607,250,2357,24,3
Heat Stroke,Manali,Haryana,2020-12-01,1712,43,1669,117,1
Heat Stroke,Manali,Haryana,2021-01-01,3535,202,3333,113,6
Heat Stroke,Manali,Haryana,2021-02-01,3162,113,3049,82,1
Heat Stroke,Manali,Haryana,2021-03-01,3257,166,3091,120,3
Heat Stroke,Manali,Haryana,2021-04-01,1892,119,1773,104,5
Heat Stroke,Manali,Haryana,2021-05-01,78,0,78,138,8
Heat Stroke,Manali,Haryana,2021-06-01,4069,202,3867,136,9
Heat Stroke,Manali,Haryana,2021-07-01,1955,165,1790,125,5
Heat Stroke,Manali,Haryana,2021-08-01,1440,145,1295,40,3
Heat Stroke,Manali,Haryana,2021-09-01,3528,163,3365,200,1
Heat Stroke,Manali,Haryana,2021-10-01,2072,106,1966,27,10
Heat Stroke,Manali,Haryana,2021-11-01,4019,442,3577,100,4
Heat Stroke,Manali,Haryana,2021-12-01,3425,284,3141,50,7
Heat Stroke,Manali,Haryana,2022-01-01,3514,112,3402,126,5
Heat Stroke,Manali,Haryana,2022-02-01,765,24,741,113,3
Heat Stroke,Manali,Haryana,2022-03-01,4223,329,3894,98,3
Heat Stroke,Manali,Haryana,2022-04-01,2948,60,2888,184,1
Heat Stroke,Manali,Haryana,2022-05-01,2102,171,1931,163,8
Heat Stroke,Manali,Haryana,2022-06-01,2790,166,2624,90,4
Heat Stroke,Manali,Haryana,2022-07-01,215,14,201,147,9
Heat Stroke,Manali,Haryana,2022-08-01,3146,134,3012,186,4
Heat Stroke,Manali,Haryana,2022-09-01,1216,38,1178,162,4
Heat Stroke,Manali,Haryana,2022-10-01,783,72,711,99,2
Heat Stroke,Manali,Haryana,2022-11-01,555,23,532,25,4
Heat Stroke,Manali,Haryana,2022-12-01,4090,155,3935,123,1
Heat Stroke,Manali,Haryana,2023-01-01,1753,83,1670,140,6
Heat Stroke,Manali,Haryana,2023-02-01,4655,259,4396,67,5
Heat Stroke,Manali,Haryana,2023-03-01,1879,37,1842,107,9
Heat Stroke,Manali,Haryana,2023-04-01,307,10,297,102,1
Heat Stroke,Manali,Haryana,2023-05-01,1100,35,1065,177,8
Heat Stroke,Manali,Haryana,2023-06-01,4255,317,3938,200,2
Heat Stroke,Manali,Haryana,2023-07-01,2388,57,2331,166,6
Heat Stroke,Manali,Haryana,2023-08-01,1862,0,1862,102,1
Heat Stroke,Manali,Haryana,2023-09-01,2812,0,2812,165,5
Heat Stroke,Manali,Haryana,2023-10-01,3271,23,3248,139,1
Heat Stroke,Manali,Haryana,2023-11-01,4096,367,3729,102,3
Heat Stroke,Manali,Haryana,2023-12-01,4541,229,4312,200,5
Heat Stroke,Manali,Haryana,2024-01-01,2115,136,1979,69,10
Heat Stroke,Manali,Haryana,2024-02-01,819,53,766,137,1
Heat Stroke,Manali,Haryana,2024-03-01,2043,105,1938,149,5
Heat Stroke,Manali,Haryana,2024-04-01,2947,141,2806,92,3
Heat Stroke,Manali,Haryana,2024-05-01,1305,105,1200,135,1
Heat Stroke,Manali,Haryana,2024-06-01,1313,71,1242,154,2
Heat Stroke,Manali,Haryana,2024-07-01,3059,277,2782,119,3
Heat Stroke,Manali,Haryana,2024-08-01,2532,172,2360,130,6
Heat Stroke,Manali,Haryana,2024-09-01,2641,84,2557,112,5
Heat Stroke,Manali,Haryana,2024-10-01,1580,56,1524,147,1
Heat Stroke,Manali,Haryana,2024-11-01,2288,66,2222,95,1
Heat Stroke,Manali,Haryana,2024-12-01,1358,116,1242,90,6
Heat Stroke,Manali,Haryana,2025-01-01,3792,145,3647,107,4
Heat Stroke,Manali,Haryana,2025-02-01,3986,106,3880,167,10
Heat Stroke,Manali,Haryana,2025-03-01,121,7,114,17,4
Heat Stroke,Manali,Haryana,2025-04-01,1350,63,1287,60,8
Heat Stroke,Manali,Haryana,2025-05-01,590,34,556,200,6
Heat Stroke,Manali,Haryana,2025-06-01,1725,181,1544,120,7
Heat Stroke,Manali,Haryana,2025-07-01,2485,190,2295,85,6
Heat Stroke,Manali,Haryana,2025-08-01,653,33,620,147,6
Heat Stroke,Manali,Haryana,2025-09-01,1361,12,1349,66,1
Heat Stroke,Manali,Haryana,2025-10-01,1251,44,1207,11,4
Heat Stroke,Manali,Haryana,2025-11-01,2875,203,2672,124,3
Heat Stroke,Manali,Haryana,2025-12-01,2690,43,2647,69,9
Heat Stroke,Jammu,Punjab,2018-01-01,1629,183,1446,111,2
Heat Stroke,Jammu,Punjab,2018-02-01,2835,143,2692,123,4
Heat Stroke,Jammu,Punjab,2018-03-01,1864,95,1769,113,7
Heat Stroke,Jammu,Punjab,2018-04-01,2233,68,2165,19,6
Heat Stroke,Jammu,Punjab,2018-05-01,4842,312,4530,108,5
Heat Stroke,Jammu,Punjab,2018-06-01,4396,71,4325,129,8
Heat Stroke,Jammu,Punjab,2018-07-01,854,96,758,35,6
Heat Stroke,Jammu,Punjab,2018-08-01,3710,328,3382,29,3
Heat Stroke,Jammu,Punjab,2018-09-01,3686,290,3396,52,1
Heat Stroke,Jammu,Punjab,2018-10-01,1057,10,1047,144,6
Heat Stroke,Jammu,Punjab,2018-11-01,3696,207,3489,11,3
Heat Stroke,Jammu,Punjab,2018-12-01,4661,397,4264,148,4
Heat Stroke,Jammu,Punjab,2019-01-01,1092,73,1019,126,8
Heat Stroke,Jammu,Punjab,2019-02-01,1367,28,1339,93,4
Heat Stroke,Jammu,Punjab,2019-03-01,3963,123,3840,31,4
Heat Stroke,Jammu,Punjab,2019-04-01,2962,109,2853,66,4
Heat Stroke,Jammu,Punjab,2019-05-01,3337,108,3229,146,4
Heat Stroke,Jammu,Punjab,2019-06-01,3054,288,2766,170,2
Heat Stroke,Jammu,Punjab,2019-07-01,3122,0,3122,54,10
Heat Stroke,Jammu,Punjab,2019-08-01,818,56,762,164,3
Heat Stroke,Jammu,Punjab,2019-09-01,4002,49,3953,141,7
Heat Stroke,Jammu,Punjab,2019-10-01,4166,92,4074,106,2
Heat Stroke,Jammu,Punjab,2019-11-01,2290,0,2290,69,6
Heat Stroke,Jammu,Punjab,2019-12-01,2539,86,2453,77,5
Heat Stroke,Jammu,Punjab,2020-01-01,543,51,492,199,5
Heat Stroke,Jammu,Punjab,2020-02-01,3287,189,3098,115,5
Heat Stroke,Jammu,Punjab,2020-03-01,3365,51,3314,174,6
Heat Stroke,Jammu,Punjab,2020-04-01,2514,200,2314,119,4
Heat Stroke,Jammu,Punjab,2020-05-01,4106,352,3754,83,4
Heat Stroke,Jammu,Punjab,2020-06-01,2149,114,2035,136,6
Heat Stroke,Jammu,Punjab,2020-07-01,3355,366,2989,200,2
Heat Stroke,Jammu,Punjab,2020-08-01,1230,90,1140,73,1
Heat Stroke,Jammu,Punjab,2020-09-01,2566,179,2387,153,5
Heat Stroke,Jammu,Punjab,2020-10-01,2364,63,2301,116,1
Heat Stroke,Jammu,Punjab,2020-11-01,2900,198,2702,32,1
Heat Stroke,Jammu,Punjab,2020-12-01,2102,118,1984,31,10
Heat Stroke,Jammu,Punjab,2021-01-01,2421,157,2264,83,9
Heat Stroke,Jammu,Punjab,2021-02-01,3706,111,3595,124,3
Heat Stroke,Jammu,Punjab,2021-03-01,2011,108,1903,151,8
Heat Stroke,Jammu,Punjab,2021-04-01,442,11,431,26,8
Heat Stroke,Jammu,Punjab,2021-05-01,4944,0,4944,139,6
Heat Stroke,Jammu,Punjab,2021-06-01,4451,352,4099,100,5
Heat Stroke,Jammu,Punjab,2021-07-01,864,5,859,106,7
Heat Stroke,Jammu,Punjab,2021-08-01,3523,187,3336,136,7
Heat Stroke,Jammu,Punjab,2021-09-01,1923,114,1809,195,7
Heat Stroke,Jammu,Punjab,2021-10-01,2951,175,2776,122,1
Heat Stroke,Jammu,Punjab,2021-11-01,2992,125,2867,37,10
Heat Stroke,Jammu,Punjab,2021-12-01,2283,132,2151,97,10
Heat Stroke,Jammu,Punjab,2022-01-01,1546,98,1448,150,1
Heat Stroke,Jammu,Punjab,2022-02-01,1671,119,1552,151,6
Heat Stroke,Jammu,Punjab,2022-03-01,1368,137,1231,140,10
Heat Stroke,Jammu,Punjab,2022-04-01,1482,84,1398,80,8
Heat Stroke,Jammu,Punjab,2022-05-01,2507,130,2377,37,8
Heat Stroke,Jammu,Punjab,2022-06-01,1637,38,1599,136,1
Heat Stroke,Jammu,Punjab,2022-07-01,3512,220,3292,44,7
Heat Stroke,Jammu,Punjab,2022-08-01,4593,319,4274,142,6
Heat Stroke,Jammu,Punjab,2022-09-01,1819,80,1739,142,7
Heat Stroke,Jammu,Punjab,2022-10-01,2919,192,2727,82,2
Heat Stroke,Jammu,Punjab,2022-11-01,3268,135,3133,100,2
Heat Stroke,Jammu,Punjab,2022-12-01,3231,224,3007,116,4
Heat Stroke,Jammu,Punjab,2023-01-01,2699,206,2493,75,4
Heat Stroke,Jammu,Punjab,2023-02-01,3594,273,3321,36,4
Heat Stroke,Jammu,Punjab,2023-03-01,3244,173,3071,104,3
Heat Stroke,Jammu,Punjab,2023-04-01,937,18,919,110,4
Heat Stroke,Jammu,Punjab,2023-05-01,3763,121,3642,176,3
Heat Stroke,Jammu,Punjab,2023-06-01,3788,255,3533,66,5
Heat Stroke,Jammu,Punjab,2023-07-01,1573,190,1383,161,1
Heat Stroke,Jammu,Punjab,2023-08-01,2648,106,2542,48,6
Heat Stroke,Jammu,Punjab,2023-09-01,3514,222,3292,38,6
Heat Stroke,Jammu,Punjab,2023-10-01,2317,78,2239,91,1
Heat Stroke,Jammu,Punjab,2023-11-01,4037,87,3950,58,9
Heat Stroke,Jammu,Punjab,2023-12-01,4989,151,4838,37,2
Heat Stroke,Jammu,Punjab,2024-01-01,1543,0,1543,200,8
Heat Stroke,Jammu,Punjab,2024-02-01,745,66,679,83,6
Heat Stroke,Jammu,Punjab,2024-03-01,3005,0,3005,200,8
Heat Stroke,Jammu,Punjab,2024-04-01,3565,151,3414,56,5
Heat Stroke,Jammu,Punjab,2024-05-01,2288,36,2252,19,6
Heat Stroke,Jammu,Punjab,2024-06-01,4547,110,4437,172,8
Heat Stroke,Jammu,Punjab,2024-07-01,802,72,730,69,10
Heat Stroke,Jammu,Punjab,2024-08-01,3527,197,3330,113,8
Heat Stroke,Jammu,Punjab,2024-09-01,1785,39,1746,37,6
Heat Stroke,Jammu,Punjab,2024-10-01,4904,161,4743,104,1
Heat Stroke,Jammu,Punjab,2024-11-01,4989,138,4851,36,1
Heat Stroke,Jammu,Punjab,2024-12-01,1569,76,1493,102,4
Heat Stroke,Jammu,Punjab,2025-01-01,1860,102,1758,82,3
Heat Stroke,Jammu,Punjab,2025-02-01,3751,394,3357,118,3
Heat Stroke,Jammu,Punjab,2025-03-01,2078,0,2078,138,5
Heat Stroke,Jammu,Punjab,2025-04-01,2536,124,2412,118,7
Heat Stroke,Jammu,Punjab,2025-05-01,2631,107,2524,129,3
Heat Stroke,Jammu,Punjab,2025-06-01,78,0,78,101,7
Heat Stroke,Jammu,Punjab,2025-07-01,2579,155,2424,84,5
Heat Stroke,Jammu,Punjab,2025-08-01,1672,112,1560,130,5
Heat Stroke,Jammu,Punjab,2025-09-01,1936,116,1820,101,10
Heat Stroke,Jammu,Punjab,2025-10-01,4534,104,4430,102,5
Heat Stroke,Jammu,Punjab,2025-11-01,912,77,835,126,5
Heat Stroke,Jammu,Punjab,2025-12-01,3688,270,3418,54,6
Heat Stroke,Jammu,Chandigarh,2018-01-01,2223,170,2053,179,10
Heat Stroke,Jammu,Chandigarh,2018-02-01,2222,193,2029,94,5
Heat Stroke,Jammu,Chandigarh,2018-03-01,3658,227,3431,113,6
Heat Stroke,Jammu,Chandigarh,2018-04-01,3054,284,2770,104,5
Heat Stroke,Jammu,Chandigarh,2018-05-01,3363,205,3158,139,5
Heat Stroke,Jammu,Chandigarh,2018-06-01,3896,170,3726,123,3
Heat Stroke,Jammu,Chandigarh,2018-07-01,2153,107,2046,104,3
Heat Stroke,Jammu,Chandigarh,2018-08-01,1776,87,1689,180,10
Heat Stroke,Jammu,Chandigarh,2018-09-01,1142,39,1103,11,3
Heat Stroke,Jammu,Chandigarh,2018-10-01,1490,145,1345,170,1
Heat Stroke,Jammu,Chandigarh,2018-11-01,4989,292,4697,153,5
Heat Stroke,Jammu,Chandigarh,2018-12-01,4267,225,4042,13,8
Heat Stroke,Jammu,Chandigarh,2019-01-01,785,48,737,154,8
Heat Stroke,Jammu,Chandigarh,2019-02-01,823,112,711,160,1
Heat Stroke,Jammu,Chandigarh,2019-03-01,3244,55,3189,135,8
Heat Stroke,Jammu,Chandigarh,2019-04-01,3332,84,3248,27,10
Heat Stroke,Jammu,Chandigarh,2019-05-01,3334,32,3302,141,3
Heat Stroke,Jammu,Chandigarh,2019-06-01,2255,97,2158,158,4
Heat Stroke,Jammu,Chandigarh,2019-07-01,2429,138,2291,77,1
Heat Stroke,Jammu,Chandigarh,2019-08-01,3037,110,2927,129,10
Heat Stroke,Jammu,Chandigarh,2019-09-01,2713,93,2620,88,1
Heat Stroke,Jammu,Chandigarh,2019-10-01,78,0,78,151,4
Heat Stroke,Jammu,Chandigarh,2019-11-01,2289,81,2208,90,7
Heat Stroke,Jammu,Chandigarh,2019-12-01,1455,85,1370,77,3
Heat Stroke,Jammu,Chandigarh,2020-01-01,2832,233,2599,104,2
Heat Stroke,Jammu,Chandigarh,2020-02-01,4989,348,4641,38,5
Heat Stroke,Jammu,Chandigarh,2020-03-01,3090,233,2857,99,10
Heat Stroke,Jammu,Chandigarh,2020-04-01,2177,177,2000,125,4
Heat Stroke,Jammu,Chandigarh,2020-05-01,3834,223,3611,151,4
Heat Stroke,Jammu,Chandigarh,2020-06-01,3245,147,3098,119,2
Heat Stroke,Jammu,Chandigarh,2020-07-01,3161,87,3074,33,6
Heat Stroke,Jammu,Chandigarh,2020-08-01,3411,131,3280,175,7
Heat Stroke,Jammu,Chandigarh,2020-09-01,4989,173,4816,179,3
Heat Stroke,Jammu,Chandigarh,2020-10-01,1080,77,1003,112,6
Heat Stroke,Jammu,Chandigarh,2020-11-01,3233,194,3039,68,3
Heat Stroke,Jammu,Chandigarh,2020-12-01,1355,95,1260,79,1
Heat Stroke,Jammu,Chandigarh,2021-01-01,3343,54,3289,96,6
Heat Stroke,Jammu,Chandigarh,2021-02-01,1365,125,1240,120,10
Heat Stroke,Jammu,Chandigarh,2021-03-01,2038,76,1962,91,1
Heat Stroke,Jammu,Chandigarh,2021-04-01,2202,39,2163,62,5
Heat Stroke,Jammu,Chandigarh,2021-05-01,3906,145,3761,158,9
Heat Stroke,Jammu,Chandigarh,2021-06-01,3830,442,3388,119,5
Heat Stroke,Jammu,Chandigarh,2021-07-01,926,35,891,53,1
Heat Stroke,Jammu,Chandigarh,2021-08-01,2671,108,2563,121,5
Heat Stroke,Jammu,Chandigarh,2021-09-01,1645,73,1572,114,9
Heat Stroke,Jammu,Chandigarh,2021-10-01,909,41,868,70,3
Heat Stroke,Jammu,Chandigarh,2021-11-01,2306,63,2243,167,5
Heat Stroke,Jammu,Chandigarh,2021-12-01,2184,118,2066,113,2
Heat Stroke,Jammu,Chandigarh,2022-01-01,4989,405,4584,95,5
Heat Stroke,Jammu,Chandigarh,2022-02-01,3178,188,2990,102,6
Heat Stroke,Jammu,Chandigarh,2022-03-01,749,13,736,129,5
Heat Stroke,Jammu,Chandigarh,2022-04-01,1840,73,1767,103,4
Heat Stroke,Jammu,Chandigarh,2022-05-01,3968,134,3834,102,6
Heat Stroke,Jammu,Chandigarh,2022-06-01,4989,257,4732,161,7
Heat Stroke,Jammu,Chandigarh,2022-07-01,470,41,429,34,7
Heat Stroke,Jammu,Chandigarh,2022-08-01,78,0,78,42,4
Heat Stroke,Jammu,Chandigarh,2022-09-01,4989,237,4752,146,3
Heat Stroke,Jammu,Chandigarh,2022-10-01,3120,317,2803,200,10
Heat Stroke,Jammu,Chandigarh,2022-11-01,1433,108,1325,151,5
Heat Stroke,Jammu,Chandigarh,2022-12-01,3315,221,3094,200,4
Heat Stroke,Jammu,Chandigarh,2023-01-01,78,0,78,84,1
Heat Stroke,Jammu,Chandigarh,2023-02-01,2602,167,2435,74,2
Heat Stroke,Jammu,Chandigarh,2023-03-01,3037,0,3037,129,3
Heat Stroke,Jammu,Chandigarh,2023-04-01,3837,285,3552,155,6
Heat Stroke,Jammu,Chandigarh,2023-05-01,1237,4,1233,39,4
Heat Stroke,Jammu,Chandigarh,2023-06-01,2712,171,2541,95,5
Heat Stroke,Jammu,Chandigarh,2023-07-01,1356,0,1356,105,1
Heat Stroke,Jammu,Chandigarh,2023-08-01,2940,107,2833,72,9
Heat Stroke,Jammu,Chandigarh,2023-09-01,1396,55,1341,78,3
Heat Stroke,Jammu,Chandigarh,2023-10-01,2050,56,1994,149,6
Heat Stroke,Jammu,Chandigarh,2023-11-01,1262,50,1212,130,3
Heat Stroke,Jammu,Chandigarh,2023-12-01,3471,278,3193,147,4
Heat Stroke,Jammu,Chandigarh,2024-01-01,3749,109,3640,123,3
Heat Stroke,Jammu,Chandigarh,2024-02-01,2283,150,2133,62,6
Heat Stroke,Jammu,Chandigarh,2024-03-01,2649,58,2591,128,2
Heat Stroke,Jammu,Chandigarh,2024-04-01,654,29,625,58,6
Heat Stroke,Jammu,Chandigarh,2024-05-01,2195,130,2065,90,4
Heat Stroke,Jammu,Chandigarh,2024-06-01,2530,53,2477,53,7
Heat Stroke,Jammu,Chandigarh,2024-07-01,4989,59,4930,75,7
Heat Stroke,Jammu,Chandigarh,2024-08-01,1106,71,1035,111,4
Heat Stroke,Jammu,Chandigarh,2024-09-01,4562,377,4185,83,6
Heat Stroke,Jammu,Chandigarh,2024-10-01,3935,187,3748,61,4
Heat Stroke,Jammu,Chandigarh,2024-11-01,2974,109,2865,164,9
Heat Stroke,Jammu,Chandigarh,2024-12-01,4957,270,4687,100,4
Heat Stroke,Jammu,Chandigarh,2025-01-01,3097,160,2937,79,4
Heat Stroke,Jammu,Chandigarh,2025-02-01,3119,178,2941,51,3
Heat Stroke,Jammu,Chandigarh,2025-03-01,2526,0,2526,11,3
Heat Stroke,Jammu,Chandigarh,2025-04-01,4239,80,4159,95,10
Heat Stroke,Jammu,Chandigarh,2025-05-01,4068,103,3965,36,6
Heat Stroke,Jammu,Chandigarh,2025-06-01,1758,95,1663,142,5
Heat Stroke,Jammu,Chandigarh,2025-07-01,828,45,783,108,3
Heat Stroke,Jammu,Chandigarh,2025-08-01,2325,159,2166,186,8
Heat Stroke,Jammu,Chandigarh,2025-09-01,1524,87,1437,118,3
Heat Stroke,Jammu,Chandigarh,2025-10-01,2512,30,2482,69,5
Heat Stroke,Jammu,Chandigarh,2025-11-01,4257,392,3865,11,10
Heat Stroke,Jammu,Chandigarh,2025-12-01,1984,172,1812,147,2
Heat Stroke,Jammu,Himachal Pradesh,2018-01-01,2540,34,2506,40,6
Heat Stroke,Jammu,Himachal Pradesh,2018-02-01,2675,159,2516,85,6
Heat Stroke,Jammu,Himachal Pradesh,2018-03-01,3736,122,3614,191,6
Heat Stroke,Jammu,Himachal Pradesh,2018-04-01,78,0,78,137,4
Heat Stroke,Jammu,Himachal Pradesh,2018-05-01,1784,144,1640,126,3
Heat Stroke,Jammu,Himachal Pradesh,2018-06-01,2881,322,2559,154,5
Heat Stroke,Jammu,Himachal Pradesh,2018-07-01,4207,302,3905,152,3
Heat Stroke,Jammu,Himachal Pradesh,2018-08-01,1938,113,1825,187,1
Heat Stroke,Jammu,Himachal Pradesh,2018-09-01,80,2,78,76,2
Heat Stroke,Jammu,Himachal Pradesh,2018-10-01,3429,189,3240,87,4
Heat Stroke,Jammu,Himachal Pradesh,2018-11-01,1745,156,1589,59,2
Heat Stroke,Jammu,Himachal Pradesh,2018-12-01,1001,48,953,105,5
Heat Stroke,Jammu,Himachal Pradesh,2019-01-01,1760,42,1718,99,3
Heat Stroke,Jammu,Himachal Pradesh,2019-02-01,2350,6,2344,17,5
Heat Stroke,Jammu,Himachal Pradesh,2019-03-01,1786,116,1670,73,10
Heat Stroke,Jammu,Himachal Pradesh,2019-04-01,78,0,78,180,8
Heat Stroke,Jammu,Himachal Pradesh,2019-05-01,3801,118,3683,119,7
Heat Stroke,Jammu,Himachal Pradesh,2019-06-01,4308,344,3964,143,10
Heat Stroke,Jammu,Himachal Pradesh,2019-07-01,3471,131,3340,100,5
Heat Stroke,Jammu,Himachal Pradesh,2019-08-01,1071,49,1022,11,5
Heat Stroke,Jammu,Himachal Pradesh,2019-09-01,2327,115,2212,100,2
Heat Stroke,Jammu,Himachal Pradesh,2019-10-01,2589,103,2486,159,9
Heat Stroke,Jammu,Himachal Pradesh,2019-11-01,3401,193,3208,46,10
Heat Stroke,Jammu,Himachal Pradesh,2019-12-01,3494,292,3202,144,7
Heat Stroke,Jammu,Himachal Pradesh,2020-01-01,1613,27,1586,20,9
Heat Stroke,Jammu,Himachal Pradesh,2020-02-01,2707,174,2533,107,1
Heat Stroke,Jammu,Himachal Pradesh,2020-03-01,3211,176,3035,134,10
Heat Stroke,Jammu,Himachal Pradesh,2020-04-01,4550,248,4302,90,5
Heat Stroke,Jammu,Himachal Pradesh,2020-05-01,3543,267,3276,200,10
Heat Stroke,Jammu,Himachal Pradesh,2020-06-01,3656,188,3468,81,10
Heat Stroke,Jammu,Himachal Pradesh,2020-07-01,2710,173,2537,77,7
Heat Stroke,Jammu,Himachal Pradesh,2020-08-01,4490,318,4172,117,4
Heat Stroke,Jammu,Himachal Pradesh,2020-09-01,3147,111,3036,68,5
Heat Stroke,Jammu,Himachal Pradesh,2020-10-01,1442,84,1358,33,1
Heat Stroke,Jammu,Himachal Pradesh,2020-11-01,4480,191,4289,50,8
Heat Stroke,Jammu,Himachal Pradesh,2020-12-01,3534,163,3371,145,1
Heat Stroke,Jammu,Himachal Pradesh,2021-01-01,2003,81,1922,91,4
Heat Stroke,Jammu,Himachal Pradesh,2021-02-01,1954,124,1830,193,9
Heat Stroke,Jammu,Himachal Pradesh,2021-03-01,2995,157,2838,84,7
Heat Stroke,Jammu,Himachal Pradesh,2021-04-01,3219,198,3021,142,1
Heat Stroke,Jammu,Himachal Pradesh,2021-05-01,2862,141,2721,132,1
Heat Stroke,Jammu,Himachal Pradesh,2021-06-01,3015,10,3005,83,3
Heat Stroke,Jammu,Himachal Pradesh,2021-07-01,4878,248,4630,61,5
Heat Stroke,Jammu,Himachal Pradesh,2021-08-01,4035,209,3826,18,7
Heat Stroke,Jammu,Himachal Pradesh,2021-09-01,2853,162,2691,134,7
Heat Stroke,Jammu,Himachal Pradesh,2021-10-01,3860,126,3734,167,2
Heat Stroke,Jammu,Himachal Pradesh,2021-11-01,1212,18,1194,25,7
Heat Stroke,Jammu,Himachal Pradesh,2021-12-01,3131,213,2918,87,7
Heat Stroke,Jammu,Himachal Pradesh,2022-01-01,4989,210,4779,72,6
Heat Stroke,Jammu,Himachal Pradesh,2022-02-01,2305,126,2179,134,10
Heat Stroke,Jammu,Himachal Pradesh,2022-03-01,1460,61,1399,89,7
Heat Stroke,Jammu,Himachal Pradesh,2022-04-01,1723,85,1638,174,8
Heat Stroke,Jammu,Himachal Pradesh,2022-05-01,1136,42,1094,87,10
Heat Stroke,Jammu,Himachal Pradesh,2022-06-01,1545,33,1512,43,7
Heat Stroke,Jammu,Himachal Pradesh,2022-07-01,2100,134,1966,82,3
Heat Stroke,Jammu,Himachal Pradesh,2022-08-01,712,23,689,88,8
Heat Stroke,Jammu,Himachal Pradesh,2022-09-01,2618,143,2475,133,4
Heat Stroke,Jammu,Himachal Pradesh,2022-10-01,3808,236,3572,87,2
Heat Stroke,Jammu,Himachal Pradesh,2022-11-01,1380,45,1335,129,2
Heat Stroke,Jammu,Himachal Pradesh,2022-12-01,4636,69,4567,66,8
Heat Stroke,Jammu,Himachal Pradesh,2023-01-01,3283,396,2887,91,7
Heat Stroke,Jammu,Himachal Pradesh,2023-02-01,3980,138,3842,66,8
Heat Stroke,Jammu,Himachal Pradesh,2023-03-01,1715,116,1599,63,7
Heat Stroke,Jammu,Himachal Pradesh,2023-04-01,3744,398,3346,171,5
Heat Stroke,Jammu,Himachal Pradesh,2023-05-01,1133,82,1051,70,6
Heat Stroke,Jammu,Himachal Pradesh,2023-06-01,3792,156,3636,89,7
Heat Stroke,Jammu,Himachal Pradesh,2023-07-01,2828,136,2692,159,3
Heat Stroke,Jammu,Himachal Pradesh,2023-08-01,3340,86,3254,144,1
Heat Stroke,Jammu,Himachal Pradesh,2023-09-01,1020,77,943,190,3
Heat Stroke,Jammu,Himachal Pradesh,2023-10-01,1397,92,1305,131,6
Heat Stroke,Jammu,Himachal Pradesh,2023-11-01,3399,119,3280,76,3
Heat Stroke,Jammu,Himachal Pradesh,2023-12-01,1325,26,1299,200,10
Heat Stroke,Jammu,Himachal Pradesh,2024-01-01,3219,37,3182,136,6
Heat Stroke,Jammu,Himachal Pradesh,2024-02-01,763,60,703,98,5
Heat Stroke,Jammu,Himachal Pradesh,2024-03-01,3735,200,3535,109,3
Heat Stroke,Jammu,Himachal Pradesh,2024-04-01,944,53,891,115,7
Heat Stroke,Jammu,Himachal Pradesh,2024-05-01,3338,87,3251,94,1
Heat Stroke,Jammu,Himachal Pradesh,2024-06-01,3437,25,3412,36,6
Heat Stroke,Jammu,Himachal Pradesh,2024-07-01,1663,129,1534,189,4
Heat Stroke,Jammu,Himachal Pradesh,2024-08-01,3378,173,3205,105,5
Heat Stroke,Jammu,Himachal Pradesh,2024-09-01,2947,225,2722,116,6
Heat Stroke,Jammu,Himachal Pradesh,2024-10-01,1875,72,1803,200,1
Heat Stroke,Jammu,Himachal Pradesh,2024-11-01,1244,53,1191,71,1
Heat Stroke,Jammu,Himachal Pradesh,2024-12-01,78,0,78,140,2
Heat Stroke,Jammu,Himachal Pradesh,2025-01-01,3066,218,2848,66,7
Heat Stroke,Jammu,Himachal Pradesh,2025-02-01,498,36,462,123,6
Heat Stroke,Jammu,Himachal Pradesh,2025-03-01,2725,113,2612,116,4
Heat Stroke,Jammu,Himachal Pradesh,2025-04-01,2244,152,2092,146,10
Heat Stroke,Jammu,Himachal Pradesh,2025-05-01,3508,288,3220,168,9
Heat Stroke,Jammu,Himachal Pradesh,2025-06-01,2192,103,2089,77,8
Heat Stroke,Jammu,Himachal Pradesh,2025-07-01,2155,75,2080,178,3
Heat Stroke,Jammu,Himachal Pradesh,2025-08-01,3579,319,3260,182,8
Heat Stroke,Jammu,Himachal Pradesh,2025-09-01,3047,94,2953,93,6
Heat Stroke,Jammu,Himachal Pradesh,2025-10-01,3022,206,2816,106,3
Heat Stroke,Jammu,Himachal Pradesh,2025-11-01,3227,156,3071,81,5
Heat Stroke,Jammu,Himachal Pradesh,2025-12-01,537,0,537,91,2
Heat Stroke,Jammu,Jammu & Kashmir,2018-01-01,3613,299,3314,45,3
Heat Stroke,Jammu,Jammu & Kashmir,2018-02-01,3419,0,3419,146,1
Heat Stroke,Jammu,Jammu & Kashmir,2018-03-01,1234,0,1234,11,8
Heat Stroke,Jammu,Jammu & Kashmir,2018-04-01,2270,148,2122,71,5
Heat Stroke,Jammu,Jammu & Kashmir,2018-05-01,2545,166,2379,104,2
Heat Stroke,Jammu,Jammu & Kashmir,2018-06-01,2417,76,2341,172,6
Heat Stroke,Jammu,Jammu & Kashmir,2018-07-01,3045,165,2880,78,5
Heat Stroke,Jammu,Jammu & Kashmir,2018-08-01,4518,0,4518,128,8
Heat Stroke,Jammu,Jammu & Kashmir,2018-09-01,4049,286,3763,102,5
Heat Stroke,Jammu,Jammu & Kashmir,2018-10-01,837,47,790,154,1
Heat Stroke,Jammu,Jammu & Kashmir,2018-11-01,3432,167,3265,125,3
Heat Stroke,Jammu,Jammu & Kashmir,2018-12-01,4380,221,4159,149,1
Heat Stroke,Jammu,Jammu & Kashmir,2019-01-01,3116,200,2916,78,6
Heat Stroke,Jammu,Jammu & Kashmir,2019-02-01,4061,199,3862,55,8
Heat Stroke,Jammu,Jammu & Kashmir,2019-03-01,4989,20,4969,125,1
Heat Stroke,Jammu,Jammu & Kashmir,2019-04-01,3971,442,3529,81,4
Heat Stroke,Jammu,Jammu & Kashmir,2019-05-01,2932,249,2683,108,8
Heat Stroke,Jammu,Jammu & Kashmir,2019-06-01,3999,50,3949,122,1
Heat Stroke,Jammu,Jammu & Kashmir,2019-07-01,2792,111,2681,169,4
Heat Stroke,Jammu,Jammu & Kashmir,2019-08-01,2629,113,2516,146,5
Heat Stroke,Jammu,Jammu & Kashmir,2019-09-01,2126,173,1953,72,8
Heat Stroke,Jammu,Jammu & Kashmir,2019-10-01,4695,0,4695,48,6
Heat Stroke,Jammu,Jammu & Kashmir,2019-11-01,1499,53,1446,193,7
Heat Stroke,Jammu,Jammu & Kashmir,2019-12-01,4653,0,4653,26,7
Heat Stroke,Jammu,Jammu & Kashmir,2020-01-01,3268,136,3132,83,4
Heat Stroke,Jammu,Jammu & Kashmir,2020-02-01,720,26,694,139,10
Heat Stroke,Jammu,Jammu & Kashmir,2020-03-01,3091,161,2930,190,3
Heat Stroke,Jammu,Jammu & Kashmir,2020-04-01,78,0,78,97,1
Heat Stroke,Jammu,Jammu & Kashmir,2020-05-01,3437,96,3341,108,1
Heat Stroke,Jammu,Jammu & Kashmir,2020-06-01,3785,257,3528,62,4
Heat Stroke,Jammu,Jammu & Kashmir,2020-07-01,1803,114,1689,113,4
Heat Stroke,Jammu,Jammu & Kashmir,2020-08-01,2763,182,2581,48,3
Heat Stroke,Jammu,Jammu & Kashmir,2020-09-01,4989,224,4765,68,5
Heat Stroke,Jammu,Jammu & Kashmir,2020-10-01,1919,64,1855,145,8
Heat Stroke,Jammu,Jammu & Kashmir,2020-11-01,1177,54,1123,84,6
Heat Stroke,Jammu,Jammu & Kashmir,2020-12-01,4585,296,4289,153,7
Heat Stroke,Jammu,Jammu & Kashmir,2021-01-01,4989,20,4969,98,2
Heat Stroke,Jammu,Jammu & Kashmir,2021-02-01,2602,160,2442,36,3
Heat Stroke,Jammu,Jammu & Kashmir,2021-03-01,3954,233,3721,166,7
Heat Stroke,Jammu,Jammu & Kashmir,2021-04-01,4397,228,4169,39,5
Heat Stroke,Jammu,Jammu & Kashmir,2021-05-01,1601,73,1528,76,6
Heat Stroke,Jammu,Jammu & Kashmir,2021-06-01,1946,0,1946,96,7
Heat Stroke,Jammu,Jammu & Kashmir,2021-07-01,4249,158,4091,157,5
Heat Stroke,Jammu,Jammu & Kashmir,2021-08-01,4858,442,4416,79,9
Heat Stroke,Jammu,Jammu & Kashmir,2021-09-01,3353,169,3184,59,3
Heat Stroke,Jammu,Jammu & Kashmir,2021-10-01,1417,58,1359,114,2
Heat Stroke,Jammu,Jammu & Kashmir,2021-11-01,4989,252,4737,95,1
Heat Stroke,Jammu,Jammu & Kashmir,2021-12-01,1885,113,1772,82,7
Heat Stroke,Jammu,Jammu & Kashmir,2022-01-01,2148,148,2000,117,3
Heat Stroke,Jammu,Jammu & Kashmir,2022-02-01,3057,132,2925,45,8
Heat Stroke,Jammu,Jammu & Kashmir,2022-03-01,4682,292,4390,18,6
Heat Stroke,Jammu,Jammu & Kashmir,2022-04-01,3743,370,3373,200,4
Heat Stroke,Jammu,Jammu & Kashmir,2022-05-01,3154,250,2904,112,2
Heat Stroke,Jammu,Jammu & Kashmir,2022-06-01,3219,380,2839,115,7
Heat Stroke,Jammu,Jammu & Kashmir,2022-07-01,2656,82,2574,66,5
Heat Stroke,Jammu,Jammu & Kashmir,2022-08-01,3346,330,3016,152,6
Heat Stroke,Jammu,Jammu & Kashmir,2022-09-01,78,0,78,79,7
Heat Stroke,Jammu,Jammu & Kashmir,2022-10-01,2200,132,2068,11,6
Heat Stroke,Jammu,Jammu & Kashmir,2022-11-01,2921,208,2713,77,2
Heat Stroke,Jammu,Jammu & Kashmir,2022-12-01,1053,37,1016,92,6
Heat Stroke,Jammu,Jammu & Kashmir,2023-01-01,3116,163,2953,98,7
Heat Stroke,Jammu,Jammu & Kashmir,2023-02-01,2323,177,2146,96,6
Heat Stroke,Jammu,Jammu & Kashmir,2023-03-01,4952,145,4807,73,7
Heat Stroke,Jammu,Jammu & Kashmir,2023-04-01,4708,442,4266,68,7
Heat Stroke,Jammu,Jammu & Kashmir,2023-05-01,1973,19,1954,91,4
Heat Stroke,Jammu,Jammu & Kashmir,2023-06-01,2395,255,2140,22,4
Heat Stroke,Jammu,Jammu & Kashmir,2023-07-01,2498,197,2301,11,10
Heat Stroke,Jammu,Jammu & Kashmir,2023-08-01,1992,94,1898,111,9
Heat Stroke,Jammu,Jammu & Kashmir,2023-09-01,2859,109,2750,112,5
Heat Stroke,Jammu,Jammu & Kashmir,2023-10-01,1580,55,1525,151,7
Heat Stroke,Jammu,Jammu & Kashmir,2023-11-01,1081,49,1032,93,2
Heat Stroke,Jammu,Jammu & Kashmir,2023-12-01,3433,167,3266,45,3
Heat Stroke,Jammu,Jammu & Kashmir,2024-01-01,3442,298,3144,11,1
Heat Stroke,Jammu,Jammu & Kashmir,2024-02-01,1518,162,1356,61,6
Heat Stroke,Jammu,Jammu & Kashmir,2024-03-01,3799,212,3587,128,6
Heat Stroke,Jammu,Jammu & Kashmir,2024-04-01,1750,44,1706,180,8
Heat Stroke,Jammu,Jammu & Kashmir,2024-05-01,2937,100,2837,109,4
Heat Stroke,Jammu,Jammu & Kashmir,2024-06-01,3698,165,3533,44,8
Heat Stroke,Jammu,Jammu & Kashmir,2024-07-01,2552,51,2501,61,7
Heat Stroke,Jammu,Jammu & Kashmir,2024-08-01,3207,50,3157,63,10
Heat Stroke,Jammu,Jammu & Kashmir,2024-09-01,1905,211,1694,86,10
Heat Stroke,Jammu,Jammu & Kashmir,2024-10-01,2334,137,2197,163,9
Heat Stroke,Jammu,Jammu & Kashmir,2024-11-01,2321,59,2262,167,7
Heat Stroke,Jammu,Jammu & Kashmir,2024-12-01,1596,117,1479,97,2
Heat Stroke,Jammu,Jammu & Kashmir,2025-01-01,2360,37,2323,116,6
Heat Stroke,Jammu,Jammu & Kashmir,2025-02-01,520,9,511,66,10
Heat Stroke,Jammu,Jammu & Kashmir,2025-03-01,1939,51,1888,19,6
Heat Stroke,Jammu,Jammu & Kashmir,2025-04-01,2215,217,1998,197,2
Heat Stroke,Jammu,Jammu & Kashmir,2025-05-01,2254,96,2158,11,6
Heat Stroke,Jammu,Jammu & Kashmir,2025-06-01,2273,0,2273,13,2
Heat Stroke,Jammu,Jammu & Kashmir,2025-07-01,2515,214,2301,198,2
Heat Stroke,Jammu,Jammu & Kashmir,2025-08-01,3241,133,3108,107,6
Heat Stroke,Jammu,Jammu & Kashmir,2025-09-01,3771,0,3771,49,7
Heat Stroke,Jammu,Jammu & Kashmir,2025-10-01,1726,70,1656,141,3
Heat Stroke,Jammu,Jammu & Kashmir,2025-11-01,983,64,919,146,3
Heat Stroke,Jammu,Jammu & Kashmir,2025-12-01,1199,74,1125,38,1
Heat Stroke,Jammu,Haryana,2018-01-01,1944,199,1745,79,4
Heat Stroke,Jammu,Haryana,2018-02-01,2125,53,2072,151,1
Heat Stroke,Jammu,Haryana,2018-03-01,1564,80,1484,65,4
Heat Stroke,Jammu,Haryana,2018-04-01,859,25,834,121,5
Heat Stroke,Jammu,Haryana,2018-05-01,1986,10,1976,179,1
Heat Stroke,Jammu,Haryana,2018-06-01,2841,215,2626,11,2
Heat Stroke,Jammu,Haryana,2018-07-01,3396,215,3181,89,5
Heat Stroke,Jammu,Haryana,2018-08-01,1850,107,1743,120,4
Heat Stroke,Jammu,Haryana,2018-09-01,2043,127,1916,15,4
Heat Stroke,Jammu,Haryana,2018-10-01,1354,40,1314,79,6
Heat Stroke,Jammu,Haryana,2018-11-01,2555,53,2502,159,1
Heat Stroke,Jammu,Haryana,2018-12-01,1459,74,1385,70,7
Heat Stroke,Jammu,Haryana,2019-01-01,3366,282,3084,31,4
Heat Stroke,Jammu,Haryana,2019-02-01,202,19,183,164,3
Heat Stroke,Jammu,Haryana,2019-03-01,2115,154,1961,129,1
Heat Stroke,Jammu,Haryana,2019-04-01,3001,152,2849,103,4
Heat Stroke,Jammu,Haryana,2019-05-01,2844,164,2680,101,6
Heat Stroke,Jammu,Haryana,2019-06-01,4989,251,4738,159,5
Heat Stroke,Jammu,Haryana,2019-07-01,3067,61,3006,121,5
Heat Stroke,Jammu,Haryana,2019-08-01,1250,63,1187,139,4
Heat Stroke,Jammu,Haryana,2019-09-01,2469,27,2442,71,5
Heat Stroke,Jammu,Haryana,2019-10-01,215,9,206,11,2
Heat Stroke,Jammu,Haryana,2019-11-01,2489,243,2246,138,5
Heat Stroke,Jammu,Haryana,2019-12-01,1480,109,1371,162,3
Heat Stroke,Jammu,Haryana,2020-01-01,3825,88,3737,95,2
Heat Stroke,Jammu,Haryana,2020-02-01,1860,89,1771,151,7
Heat Stroke,Jammu,Haryana,2020-03-01,2441,62,2379,89,1
Heat Stroke,Jammu,Haryana,2020-04-01,1745,84,1661,102,6
Heat Stroke,Jammu,Haryana,2020-05-01,4930,396,4534,195,7
Heat Stroke,Jammu,Haryana,2020-06-01,2166,149,2017,91,3
Heat Stroke,Jammu,Haryana,2020-07-01,4989,442,4547,88,8
Heat Stroke,Jammu,Haryana,2020-08-01,3690,312,3378,11,3
Heat Stroke,Jammu,Haryana,2020-09-01,3244,181,3063,141,3
Heat Stroke,Jammu,Haryana,2020-10-01,3092,215,2877,70,1
Heat Stroke,Jammu,Haryana,2020-11-01,3126,138,2988,114,5
Heat Stroke,Jammu,Haryana,2020-12-01,78,0,78,90,2
Heat Stroke,Jammu,Haryana,2021-01-01,2223,195,2028,83,3
Heat Stroke,Jammu,Haryana,2021-02-01,3731,296,3435,100,5
Heat Stroke,Jammu,Haryana,2021-03-01,2532,109,2423,104,5
Heat Stroke,Jammu,Haryana,2021-04-01,712,41,671,166,8
Heat Stroke,Jammu,Haryana,2021-05-01,2527,217,2310,184,8
Heat Stroke,Jammu,Haryana,2021-06-01,4883,364,4519,139,6
Heat Stroke,Jammu,Haryana,2021-07-01,4270,31,4239,171,4
Heat Stroke,Jammu,Haryana,2021-08-01,2514,143,2371,150,4
Heat Stroke,Jammu,Haryana,2021-09-01,3874,175,3699,131,5
Heat Stroke,Jammu,Haryana,2021-10-01,2106,173,1933,180,3
Heat Stroke,Jammu,Haryana,2021-11-01,312,24,288,40,3
Heat Stroke,Jammu,Haryana,2021-12-01,1357,120,1237,71,5
Heat Stroke,Jammu,Haryana,2022-01-01,4694,82,4612,64,2
Heat Stroke,Jammu,Haryana,2022-02-01,2230,60,2170,91,2
Heat Stroke,Jammu,Haryana,2022-03-01,2271,187,2084,141,8
Heat Stroke,Jammu,Haryana,2022-04-01,2195,72,2123,49,1
Heat Stroke,Jammu,Haryana,2022-05-01,4989,28,4961,132,2
Heat Stroke,Jammu,Haryana,2022-06-01,4779,313,4466,76,9
Heat Stroke,Jammu,Haryana,2022-07-01,4989,170,4819,89,4
Heat Stroke,Jammu,Haryana,2022-08-01,2384,243,2141,116,9
Heat Stroke,Jammu,Haryana,2022-09-01,2994,175,2819,192,1
Heat Stroke,Jammu,Haryana,2022-10-01,563,30,533,70,5
Heat Stroke,Jammu,Haryana,2022-11-01,4579,180,4399,102,7
Heat Stroke,Jammu,Haryana,2022-12-01,1031,99,932,51,2
Heat Stroke,Jammu,Haryana,2023-01-01,2888,174,2714,69,10
Heat Stroke,Jammu,Haryana,2023-02-01,1125,42,1083,51,4
Heat Stroke,Jammu,Haryana,2023-03-01,1807,48,1759,119,6
Heat Stroke,Jammu,Haryana,2023-04-01,1474,70,1404,128,3
Heat Stroke,Jammu,Haryana,2023-05-01,1782,38,1744,141,9
Heat Stroke,Jammu,Haryana,2023-06-01,1874,149,1725,68,6
Heat Stroke,Jammu,Haryana,2023-07-01,1862,0,1862,132,10
Heat Stroke,Jammu,Haryana,2023-08-01,3715,170,3545,112,8
Heat Stroke,Jammu,Haryana,2023-09-01,1115,75,1040,103,7
Heat Stroke,Jammu,Haryana,2023-10-01,2893,173,2720,43,2
Heat Stroke,Jammu,Haryana,2023-11-01,4231,123,4108,114,5
Heat Stroke,Jammu,Haryana,2023-12-01,1909,132,1777,116,4
Heat Stroke,Jammu,Haryana,2024-01-01,1634,39,1595,111,5
Heat Stroke,Jammu,Haryana,2024-02-01,2288,113,2175,127,5
Heat Stroke,Jammu,Haryana,2024-03-01,4180,288,3892,142,2
Heat Stroke,Jammu,Haryana,2024-04-01,2858,181,2677,50,4
Heat Stroke,Jammu,Haryana,2024-05-01,1885,57,1828,95,5
Heat Stroke,Jammu,Haryana,2024-06-01,3247,275,2972,132,2
Heat Stroke,Jammu,Haryana,2024-07-01,1119,58,1061,93,7
Heat Stroke,Jammu,Haryana,2024-08-01,3511,251,3260,155,5
Heat Stroke,Jammu,Haryana,2024-09-01,3146,297,2849,111,7
Heat Stroke,Jammu,Haryana,2024-10-01,2184,180,2004,11,6
Heat Stroke,Jammu,Haryana,2024-11-01,1472,121,1351,149,1
Heat Stroke,Jammu,Haryana,2024-12-01,1408,78,1330,100,2
Heat Stroke,Jammu,Haryana,2025-01-01,3315,242,3073,16,10
Heat Stroke,Jammu,Haryana,2025-02-01,4246,238,4008,93,7
Heat Stroke,Jammu,Haryana,2025-03-01,1742,25,1717,42,1
Heat Stroke,Jammu,Haryana,2025-04-01,3212,189,3023,145,6
Heat Stroke,Jammu,Haryana,2025-05-01,78,0,78,104,2
Heat Stroke,Jammu,Haryana,2025-06-01,1813,121,1692,59,1
Heat Stroke,Jammu,Haryana,2025-07-01,2556,118,2438,148,10
Heat Stroke,Jammu,Haryana,2025-08-01,1377,38,1339,130,5
Heat Stroke,Jammu,Haryana,2025-09-01,1341,92,1249,94,5
Heat Stroke,Jammu,Haryana,2025-10-01,1702,20,1682,43,1
Heat Stroke,Jammu,Haryana,2025-11-01,2989,276,2713,63,1
Heat Stroke,Jammu,Haryana,2025-12-01,2346,101,2245,63,1
Heat Stroke,Srinagar,Punjab,2018-01-01,78,0,78,144,9
Heat Stroke,Srinagar,Punjab,2018-02-01,78,0,78,21,1
Heat Stroke,Srinagar,Punjab,2018-03-01,1783,119,1664,104,10
Heat Stroke,Srinagar,Punjab,2018-04-01,3211,29,3182,93,2
Heat Stroke,Srinagar,Punjab,2018-05-01,78,0,78,159,1
Heat Stroke,Srinagar,Punjab,2018-06-01,1927,113,1814,118,5
Heat Stroke,Srinagar,Punjab,2018-07-01,1891,59,1832,133,3
Heat Stroke,Srinagar,Punjab,2018-08-01,4460,126,4334,79,5
Heat Stroke,Srinagar,Punjab,2018-09-01,2081,83,1998,43,2
Heat Stroke,Srinagar,Punjab,2018-10-01,3111,38,3073,90,4
Heat Stroke,Srinagar,Punjab,2018-11-01,2787,279,2508,146,3
Heat Stroke,Srinagar,Punjab,2018-12-01,78,0,78,146,7
Heat Stroke,Srinagar,Punjab,2019-01-01,3628,229,3399,84,6
Heat Stroke,Srinagar,Punjab,2019-02-01,2886,125,2761,62,6
Heat Stroke,Srinagar,Punjab,2019-03-01,3279,145,3134,52,8
Heat Stroke,Srinagar,Punjab,2019-04-01,4989,359,4630,99,6
Heat Stroke,Srinagar,Punjab,2019-05-01,78,0,78,113,5
Heat Stroke,Srinagar,Punjab,2019-06-01,4911,164,4747,181,4
Heat Stroke,Srinagar,Punjab,2019-07-01,2212,38,2174,112,3
Heat Stroke,Srinagar,Punjab,2019-08-01,2983,283,2700,137,3
Heat Stroke,Srinagar,Punjab,2019-09-01,2536,0,2536,66,5
Heat Stroke,Srinagar,Punjab,2019-10-01,2028,42,1986,108,8
Heat Stroke,Srinagar,Punjab,2019-11-01,1833,78,1755,113,6
Heat Stroke,Srinagar,Punjab,2019-12-01,3039,14,3025,99,6
Heat Stroke,Srinagar,Punjab,2020-01-01,562,46,516,105,2
Heat Stroke,Srinagar,Punjab,2020-02-01,3604,270,3334,113,6
Heat Stroke,Srinagar,Punjab,2020-03-01,2039,67,1972,131,4
Heat Stroke,Srinagar,Punjab,2020-04-01,1081,94,987,166,5
Heat Stroke,Srinagar,Punjab,2020-05-01,1994,183,1811,11,6
Heat Stroke,Srinagar,Punjab,2020-06-01,4284,200,4084,163,1
Heat Stroke,Srinagar,Punjab,2020-07-01,1879,69,1810,19,5
Heat Stroke,Srinagar,Punjab,2020-08-01,3078,356,2722,122,6
Heat Stroke,Srinagar,Punjab,2020-09-01,1617,114,1503,200,8
Heat Stroke,Srinagar,Punjab,2020-10-01,3614,207,3407,104,3
Heat Stroke,Srinagar,Punjab,2020-11-01,3517,315,3202,115,5
Heat Stroke,Srinagar,Punjab,2020-12-01,4989,293,4696,90,5
Heat Stroke,Srinagar,Punjab,2021-01-01,2362,83,2279,140,3
Heat Stroke,Srinagar,Punjab,2021-02-01,3494,183,3311,125,3
Heat Stroke,Srinagar,Punjab,2021-03-01,2729,219,2510,72,3
Heat Stroke,Srinagar,Punjab,2021-04-01,4336,0,4336,100,4
Heat Stroke,Srinagar,Punjab,2021-05-01,1633,68,1565,49,10
Heat Stroke,Srinagar,Punjab,2021-06-01,3597,324,3273,100,5
Heat Stroke,Srinagar,Punjab,2021-07-01,2336,82,2254,85,6
Heat Stroke,Srinagar,Punjab,2021-08-01,2511,238,2273,113,5
Heat Stroke,Srinagar,Punjab,2021-09-01,2720,248,2472,70,4
Heat Stroke,Srinagar,Punjab,2021-10-01,2936,141,2795,95,5
Heat Stroke,Srinagar,Punjab,2021-11-01,2441,81,2360,107,7
Heat Stroke,Srinagar,Punjab,2021-12-01,2885,120,2765,110,5
Heat Stroke,Srinagar,Punjab,2022-01-01,4714,442,4272,120,4
Heat Stroke,Srinagar,Punjab,2022-02-01,3919,410,3509,97,4
Heat Stroke,Srinagar,Punjab,2022-03-01,3763,202,3561,66,2
Heat Stroke,Srinagar,Punjab,2022-04-01,1986,64,1922,110,8
Heat Stroke,Srinagar,Punjab,2022-05-01,1404,75,1329,97,4
Heat Stroke,Srinagar,Punjab,2022-06-01,3879,221,3658,158,9
Heat Stroke,Srinagar,Punjab,2022-07-01,3773,52,3721,165,6
Heat Stroke,Srinagar,Punjab,2022-08-01,4573,239,4334,36,9
Heat Stroke,Srinagar,Punjab,2022-09-01,1787,158,1629,138,4
Heat Stroke,Srinagar,Punjab,2022-10-01,2289,0,2289,148,3
Heat Stroke,Srinagar,Punjab,2022-11-01,398,29,369,38,8
Heat Stroke,Srinagar,Punjab,2022-12-01,2071,186,1885,136,3
Heat Stroke,Srinagar,Punjab,2023-01-01,3934,132,3802,152,9
Heat Stroke,Srinagar,Punjab,2023-02-01,1972,195,1777,58,7
Heat Stroke,Srinagar,Punjab,2023-03-01,3457,103,3354,94,9
Heat Stroke,Srinagar,Punjab,2023-04-01,2342,147,2195,116,2
Heat Stroke,Srinagar,Punjab,2023-05-01,3032,124,2908,135,8
Heat Stroke,Srinagar,Punjab,2023-06-01,1058,43,1015,56,3
Heat Stroke,Srinagar,Punjab,2023-07-01,2712,87,2625,165,1
Heat Stroke,Srinagar,Punjab,2023-08-01,78,0,78,11,7
Heat Stroke,Srinagar,Punjab,2023-09-01,2347,175,2172,174,5
Heat Stroke,Srinagar,Punjab,2023-10-01,410,19,391,134,8
Heat Stroke,Srinagar,Punjab,2023-11-01,4215,44,4171,75,5
Heat Stroke,Srinagar,Punjab,2023-12-01,3640,224,3416,150,5
Heat Stroke,Srinagar,Punjab,2024-01-01,3223,200,3023,53,9
Heat Stroke,Srinagar,Punjab,2024-02-01,4638,202,4436,112,5
Heat Stroke,Srinagar,Punjab,2024-03-01,1324,138,1186,118,3
Heat Stroke,Srinagar,Punjab,2024-04-01,4942,22,4920,118,5
Heat Stroke,Srinagar,Punjab,2024-05-01,3848,0,3848,63,5
Heat Stroke,Srinagar,Punjab,2024-06-01,2280,65,2215,81,1
Heat Stroke,Srinagar,Punjab,2024-07-01,4121,291,3830,113,6
Heat Stroke,Srinagar,Punjab,2024-08-01,1113,21,1092,69,9
Heat Stroke,Srinagar,Punjab,2024-09-01,1491,32,1459,120,5
Heat Stroke,Srinagar,Punjab,2024-10-01,1781,138,1643,75,4
Heat Stroke,Srinagar,Punjab,2024-11-01,1888,119,1769,157,6
Heat Stroke,Srinagar,Punjab,2024-12-01,1180,72,1108,186,10
Heat Stroke,Srinagar,Punjab,2025-01-01,4238,308,3930,91,6
Heat Stroke,Srinagar,Punjab,2025-02-01,2250,84,2166,153,5
Heat Stroke,Srinagar,Punjab,2025-03-01,3070,119,2951,95,4
Heat Stroke,Srinagar,Punjab,2025-04-01,1832,134,1698,59,2
Heat Stroke,Srinagar,Punjab,2025-05-01,155,1,154,85,5
Heat Stroke,Srinagar,Punjab,2025-06-01,2960,0,2960,111,5
Heat Stroke,Srinagar,Punjab,2025-07-01,78,0,78,15,1
Heat Stroke,Srinagar,Punjab,2025-08-01,2505,193,2312,138,3
Heat Stroke,Srinagar,Punjab,2025-09-01,762,43,719,111,8
Heat Stroke,Srinagar,Punjab,2025-10-01,4989,374,4615,157,4
Heat Stroke,Srinagar,Punjab,2025-11-01,3820,0,3820,137,1
Heat Stroke,Srinagar,Punjab,2025-12-01,2739,162,2577,112,9
Heat Stroke,Srinagar,Chandigarh,2018-01-01,4293,296,3997,88,2
Heat Stroke,Srinagar,Chandigarh,2018-02-01,1462,15,1447,184,3
Heat Stroke,Srinagar,Chandigarh,2018-03-01,3326,249,3077,200,8
Heat Stroke,Srinagar,Chandigarh,2018-04-01,2865,134,2731,89,3
Heat Stroke,Srinagar,Chandigarh,2018-05-01,2952,411,2541,159,1
Heat Stroke,Srinagar,Chandigarh,2018-06-01,4304,0,4304,70,5
Heat Stroke,Srinagar,Chandigarh,2018-07-01,3580,321,3259,76,7
Heat Stroke,Srinagar,Chandigarh,2018-08-01,2985,115,2870,87,3
Heat Stroke,Srinagar,Chandigarh,2018-09-01,377,1,376,141,4
Heat Stroke,Srinagar,Chandigarh,2018-10-01,1309,45,1264,51,1
Heat Stroke,Srinagar,Chandigarh,2018-11-01,2433,141,2292,185,2
Heat Stroke,Srinagar,Chandigarh,2018-12-01,2723,218,2505,154,4
Heat Stroke,Srinagar,Chandigarh,2019-01-01,1081,108,973,140,7
Heat Stroke,Srinagar,Chandigarh,2019-02-01,4989,442,4547,91,5
Heat Stroke,Srinagar,Chandigarh,2019-03-01,4632,101,4531,148,8
Heat Stroke,Srinagar,Chandigarh,2019-04-01,3405,282,3123,11,10
Heat Stroke,Srinagar,Chandigarh,2019-05-01,2694,165,2529,129,7
Heat Stroke,Srinagar,Chandigarh,2019-06-01,2313,71,2242,114,1
Heat Stroke,Srinagar,Chandigarh,2019-07-01,1320,57,1263,11,4
Heat Stroke,Srinagar,Chandigarh,2019-08-01,2701,79,2622,127,7
Heat Stroke,Srinagar,Chandigarh,2019-09-01,2943,150,2793,136,4
Heat Stroke,Srinagar,Chandigarh,2019-10-01,932,26,906,12,1
Heat Stroke,Srinagar,Chandigarh,2019-11-01,3046,61,2985,46,3
Heat Stroke,Srinagar,Chandigarh,2019-12-01,2389,152,2237,200,1
Heat Stroke,Srinagar,Chandigarh,2020-01-01,78,0,78,97,4
Heat Stroke,Srinagar,Chandigarh,2020-02-01,1443,64,1379,156,3
Heat Stroke,Srinagar,Chandigarh,2020-03-01,2043,183,1860,164,4
Heat Stroke,Srinagar,Chandigarh,2020-04-01,4989,211,4778,126,8
Heat Stroke,Srinagar,Chandigarh,2020-05-01,3344,137,3207,158,1
Heat Stroke,Srinagar,Chandigarh,2020-06-01,806,55,751,11,3
Heat Stroke,Srinagar,Chandigarh,2020-07-01,3249,150,3099,94,2
Heat Stroke,Srinagar,Chandigarh,2020-08-01,522,27,495,11,8
Heat Stroke,Srinagar,Chandigarh,2020-09-01,4050,0,4050,17,8
Heat Stroke,Srinagar,Chandigarh,2020-10-01,1965,99,1866,78,6
Heat Stroke,Srinagar,Chandigarh,2020-11-01,2472,0,2472,72,6
Heat Stroke,Srinagar,Chandigarh,2020-12-01,4376,63,4313,108,1
Heat Stroke,Srinagar,Chandigarh,2021-01-01,871,9,862,105,5
Heat Stroke,Srinagar,Chandigarh,2021-02-01,723,14,709,113,2
Heat Stroke,Srinagar,Chandigarh,2021-03-01,1815,61,1754,115,5
Heat Stroke,Srinagar,Chandigarh,2021-04-01,3990,143,3847,123,4
Heat Stroke,Srinagar,Chandigarh,2021-05-01,559,38,521,57,3
Heat Stroke,Srinagar,Chandigarh,2021-06-01,78,0,78,69,5
Heat Stroke,Srinagar,Chandigarh,2021-07-01,1992,0,1992,104,7
Heat Stroke,Srinagar,Chandigarh,2021-08-01,3338,175,3163,105,10
Heat Stroke,Srinagar,Chandigarh,2021-09-01,4208,249,3959,51,6
Heat Stroke,Srinagar,Chandigarh,2021-10-01,1976,80,1896,161,10
Heat Stroke,Srinagar,Chandigarh,2021-11-01,2045,98,1947,143,5
Heat Stroke,Srinagar,Chandigarh,2021-12-01,4145,230,3915,62,10
Heat Stroke,Srinagar,Chandigarh,2022-01-01,89,6,83,96,6
Heat Stroke,Srinagar,Chandigarh,2022-02-01,2076,8,2068,200,6
Heat Stroke,Srinagar,Chandigarh,2022-03-01,2853,122,2731,114,4
Heat Stroke,Srinagar,Chandigarh,2022-04-01,3200,300,2900,126,6
Heat Stroke,Srinagar,Chandigarh,2022-05-01,1913,174,1739,75,6
Heat Stroke,Srinagar,Chandigarh,2022-06-01,2644,197,2447,90,1
Heat Stroke,Srinagar,Chandigarh,2022-07-01,78,0,78,183,7
Heat Stroke,Srinagar,Chandigarh,2022-08-01,1714,168,1546,112,1
Heat Stroke,Srinagar,Chandigarh,2022-09-01,3206,339,2867,103,7
Heat Stroke,Srinagar,Chandigarh,2022-10-01,1280,59,1221,107,7
Heat Stroke,Srinagar,Chandigarh,2022-11-01,2677,58,2619,200,9
Heat Stroke,Srinagar,Chandigarh,2022-12-01,3197,134,3063,108,2
Heat Stroke,Srinagar,Chandigarh,2023-01-01,2138,299,1839,64,2
Heat Stroke,Srinagar,Chandigarh,2023-02-01,2826,12,2814,73,8
Heat Stroke,Srinagar,Chandigarh,2023-03-01,1306,47,1259,146,2
Heat Stroke,Srinagar,Chandigarh,2023-04-01,2320,20,2300,33,1
Heat Stroke,Srinagar,Chandigarh,2023-05-01,3416,183,3233,129,5
Heat Stroke,Srinagar,Chandigarh,2023-06-01,2808,42,2766,69,5
Heat Stroke,Srinagar,Chandigarh,2023-07-01,1811,84,1727,12,5
Heat Stroke,Srinagar,Chandigarh,2023-08-01,2898,0,2898,56,6
Heat Stroke,Srinagar,Chandigarh,2023-09-01,3556,241,3315,108,6
Heat Stroke,Srinagar,Chandigarh,2023-10-01,78,0,78,177,5
Heat Stroke,Srinagar,Chandigarh,2023-11-01,4152,161,3991,153,5
Heat Stroke,Srinagar,Chandigarh,2023-12-01,2146,99,2047,91,5
Heat Stroke,Srinagar,Chandigarh,2024-01-01,3168,143,3025,156,5
Heat Stroke,Srinagar,Chandigarh,2024-02-01,4204,232,3972,88,1
Heat Stroke,Srinagar,Chandigarh,2024-03-01,757,37,720,31,7
Heat Stroke,Srinagar,Chandigarh,2024-04-01,1646,119,1527,107,8
Heat Stroke,Srinagar,Chandigarh,2024-05-01,2210,189,2021,29,7
Heat Stroke,Srinagar,Chandigarh,2024-06-01,1546,40,1506,147,6
Heat Stroke,Srinagar,Chandigarh,2024-07-01,4925,202,4723,147,2
Heat Stroke,Srinagar,Chandigarh,2024-08-01,1448,110,1338,61,1
Heat Stroke,Srinagar,Chandigarh,2024-09-01,1852,16,1836,114,7
Heat Stroke,Srinagar,Chandigarh,2024-10-01,2872,0,2872,113,5
Heat Stroke,Srinagar,Chandigarh,2024-11-01,985,55,930,151,5
Heat Stroke,Srinagar,Chandigarh,2024-12-01,2067,133,1934,43,5
Heat Stroke,Srinagar,Chandigarh,2025-01-01,3023,87,2936,137,6
Heat Stroke,Srinagar,Chandigarh,2025-02-01,2151,71,2080,39,7
Heat Stroke,Srinagar,Chandigarh,2025-03-01,2472,69,2403,146,5
Heat Stroke,Srinagar,Chandigarh,2025-04-01,1887,46,1841,160,1
Heat Stroke,Srinagar,Chandigarh,2025-05-01,566,39,527,72,7
Heat Stroke,Srinagar,Chandigarh,2025-06-01,3029,47,2982,168,6
Heat Stroke,Srinagar,Chandigarh,2025-07-01,4952,209,4743,26,1
Heat Stroke,Srinagar,Chandigarh,2025-08-01,2622,62,2560,162,1
Heat Stroke,Srinagar,Chandigarh,2025-09-01,2900,22,2878,179,7
Heat Stroke,Srinagar,Chandigarh,2025-10-01,3527,265,3262,124,8
Heat Stroke,Srinagar,Chandigarh,2025-11-01,895,31,864,96,1
Heat Stroke,Srinagar,Chandigarh,2025-12-01,4881,271,4610,122,6
Heat Stroke,Srinagar,Himachal Pradesh,2018-01-01,2869,17,2852,75,4
Heat Stroke,Srinagar,Himachal Pradesh,2018-02-01,4787,136,4651,200,5
Heat Stroke,Srinagar,Himachal Pradesh,2018-03-01,1614,116,1498,76,5
Heat Stroke,Srinagar,Himachal Pradesh,2018-04-01,4989,442,4547,173,3
Heat Stroke,Srinagar,Himachal Pradesh,2018-05-01,3637,0,3637,68,7
Heat Stroke,Srinagar,Himachal Pradesh,2018-06-01,3339,147,3192,188,3
Heat Stroke,Srinagar,Himachal Pradesh,2018-07-01,2911,180,2731,200,7
Heat Stroke,Srinagar,Himachal Pradesh,2018-08-01,2264,72,2192,126,8
Heat Stroke,Srinagar,Himachal Pradesh,2018-09-01,4208,314,3894,121,2
Heat Stroke,Srinagar,Himachal Pradesh,2018-10-01,2786,69,2717,57,2
Heat Stroke,Srinagar,Himachal Pradesh,2018-11-01,78,0,78,51,5
Heat Stroke,Srinagar,Himachal Pradesh,2018-12-01,1099,38,1061,121,9
Heat Stroke,Srinagar,Himachal Pradesh,2019-01-01,2348,200,2148,180,3
Heat Stroke,Srinagar,Himachal Pradesh,2019-02-01,3013,91,2922,78,4
Heat Stroke,Srinagar,Himachal Pradesh,2019-03-01,2521,100,2421,200,6
Heat Stroke,Srinagar,Himachal Pradesh,2019-04-01,4233,328,3905,75,7
Heat Stroke,Srinagar,Himachal Pradesh,2019-05-01,78,0,78,118,6
Heat Stroke,Srinagar,Himachal Pradesh,2019-06-01,2790,145,2645,118,5
Heat Stroke,Srinagar,Himachal Pradesh,2019-07-01,159,0,159,101,4
Heat Stroke,Srinagar,Himachal Pradesh,2019-08-01,3617,66,3551,11,6
Heat Stroke,Srinagar,Himachal Pradesh,2019-09-01,2471,151,2320,75,1
Heat Stroke,Srinagar,Himachal Pradesh,2019-10-01,3160,67,3093,116,10
Heat Stroke,Srinagar,Himachal Pradesh,2019-11-01,1439,49,1390,101,4
Heat Stroke,Srinagar,Himachal Pradesh,2019-12-01,4314,277,4037,139,5
Heat Stroke,Srinagar,Himachal Pradesh,2020-01-01,3995,132,3863,145,10
Heat Stroke,Srinagar,Himachal Pradesh,2020-02-01,3380,250,3130,94,3
Heat Stroke,Srinagar,Himachal Pradesh,2020-03-01,2424,136,2288,57,10
Heat Stroke,Srinagar,Himachal Pradesh,2020-04-01,3375,211,3164,185,7
Heat Stroke,Srinagar,Himachal Pradesh,2020-05-01,1649,142,1507,37,6
Heat Stroke,Srinagar,Himachal Pradesh,2020-06-01,3745,222,3523,76,7
Heat Stroke,Srinagar,Himachal Pradesh,2020-07-01,4810,442,4368,63,2
Heat Stroke,Srinagar,Himachal Pradesh,2020-08-01,4034,308,3726,144,1
Heat Stroke,Srinagar,Himachal Pradesh,2020-09-01,1619,56,1563,173,1
Heat Stroke,Srinagar,Himachal Pradesh,2020-10-01,3082,270,2812,97,8
Heat Stroke,Srinagar,Himachal Pradesh,2020-11-01,863,49,814,118,2
Heat Stroke,Srinagar,Himachal Pradesh,2020-12-01,3365,129,3236,128,1
Heat Stroke,Srinagar,Himachal Pradesh,2021-01-01,3202,186,3016,198,5
Heat Stroke,Srinagar,Himachal Pradesh,2021-02-01,89,7,82,16,6
Heat Stroke,Srinagar,Himachal Pradesh,2021-03-01,1039,65,974,144,5
Heat Stroke,Srinagar,Himachal Pradesh,2021-04-01,2218,228,1990,125,7
Heat Stroke,Srinagar,Himachal Pradesh,2021-05-01,2194,179,2015,87,8
Heat Stroke,Srinagar,Himachal Pradesh,2021-06-01,975,63,912,123,6
Heat Stroke,Srinagar,Himachal Pradesh,2021-07-01,3119,63,3056,144,4
Heat Stroke,Srinagar,Himachal Pradesh,2021-08-01,2935,131,2804,136,3
Heat Stroke,Srinagar,Himachal Pradesh,2021-09-01,2337,121,2216,200,7
Heat Stroke,Srinagar,Himachal Pradesh,2021-10-01,1584,111,1473,113,6
Heat Stroke,Srinagar,Himachal Pradesh,2021-11-01,4004,274,3730,108,2
Heat Stroke,Srinagar,Himachal Pradesh,2021-12-01,4818,265,4553,97,9
Heat Stroke,Srinagar,Himachal Pradesh,2022-01-01,1949,104,1845,134,6
Heat Stroke,Srinagar,Himachal Pradesh,2022-02-01,1776,126,1650,105,7
Heat Stroke,Srinagar,Himachal Pradesh,2022-03-01,3256,81,3175,107,4
Heat Stroke,Srinagar,Himachal Pradesh,2022-04-01,2117,210,1907,107,8
Heat Stroke,Srinagar,Himachal Pradesh,2022-05-01,2410,0,2410,99,1
Heat Stroke,Srinagar,Himachal Pradesh,2022-06-01,3590,331,3259,75,10
Heat Stroke,Srinagar,Himachal Pradesh,2022-07-01,78,0,78,128,1
Heat Stroke,Srinagar,Himachal Pradesh,2022-08-01,4366,346,4020,92,1
Heat Stroke,Srinagar,Himachal Pradesh,2022-09-01,2695,163,2532,137,6
Heat Stroke,Srinagar,Himachal Pradesh,2022-10-01,2045,122,1923,112,3
Heat Stroke,Srinagar,Himachal Pradesh,2022-11-01,2478,164,2314,87,4
Heat Stroke,Srinagar,Himachal Pradesh,2022-12-01,2547,187,2360,186,3
Heat Stroke,Srinagar,Himachal Pradesh,2023-01-01,275,11,264,101,3
Heat Stroke,Srinagar,Himachal Pradesh,2023-02-01,4603,369,4234,138,6
Heat Stroke,Srinagar,Himachal Pradesh,2023-03-01,2653,49,2604,71,5
Heat Stroke,Srinagar,Himachal Pradesh,2023-04-01,3192,159,3033,11,7
Heat Stroke,Srinagar,Himachal Pradesh,2023-05-01,3874,288,3586,77,5
Heat Stroke,Srinagar,Himachal Pradesh,2023-06-01,1228,97,1131,11,4
Heat Stroke,Srinagar,Himachal Pradesh,2023-07-01,3233,205,3028,94,7
Heat Stroke,Srinagar,Himachal Pradesh,2023-08-01,2238,86,2152,181,1
Heat Stroke,Srinagar,Himachal Pradesh,2023-09-01,3733,284,3449,60,1
Heat Stroke,Srinagar,Himachal Pradesh,2023-10-01,78,0,78,11,1
Heat Stroke,Srinagar,Himachal Pradesh,2023-11-01,2464,248,2216,183,4
Heat Stroke,Srinagar,Himachal Pradesh,2023-12-01,1789,85,1704,82,6
Heat Stroke,Srinagar,Himachal Pradesh,2024-01-01,3177,16,3161,105,1
Heat Stroke,Srinagar,Himachal Pradesh,2024-02-01,3228,49,3179,146,5
Heat Stroke,Srinagar,Himachal Pradesh,2024-03-01,1648,84,1564,133,4
Heat Stroke,Srinagar,Himachal Pradesh,2024-04-01,1642,88,1554,144,5
Heat Stroke,Srinagar,Himachal Pradesh,2024-05-01,2449,263,2186,152,1
Heat Stroke,Srinagar,Himachal Pradesh,2024-06-01,1395,27,1368,17,10
Heat Stroke,Srinagar,Himachal Pradesh,2024-07-01,3727,190,3537,34,5
Heat Stroke,Srinagar,Himachal Pradesh,2024-08-01,2102,40,2062,166,1
Heat Stroke,Srinagar,Himachal Pradesh,2024-09-01,78,0,78,66,5
Heat Stroke,Srinagar,Himachal Pradesh,2024-10-01,2095,207,1888,72,9
Heat Stroke,Srinagar,Himachal Pradesh,2024-11-01,1204,20,1184,42,1
Heat Stroke,Srinagar,Himachal Pradesh,2024-12-01,409,27,382,86,1
Heat Stroke,Srinagar,Himachal Pradesh,2025-01-01,937,57,880,88,4
Heat Stroke,Srinagar,Himachal Pradesh,2025-02-01,2744,135,2609,58,5
Heat Stroke,Srinagar,Himachal Pradesh,2025-03-01,4380,285,4095,53,7
Heat Stroke,Srinagar,Himachal Pradesh,2025-04-01,3018,49,2969,122,9
Heat Stroke,Srinagar,Himachal Pradesh,2025-05-01,1784,175,1609,65,7
Heat Stroke,Srinagar,Himachal Pradesh,2025-06-01,3209,340,2869,75,1
Heat Stroke,Srinagar,Himachal Pradesh,2025-07-01,1982,101,1881,11,2
Heat Stroke,Srinagar,Himachal Pradesh,2025-08-01,1666,200,1466,200,3
Heat Stroke,Srinagar,Himachal Pradesh,2025-09-01,1049,40,1009,154,7
Heat Stroke,Srinagar,Himachal Pradesh,2025-10-01,247,15,232,81,7
Heat Stroke,Srinagar,Himachal Pradesh,2025-11-01,2074,190,1884,60,8
Heat Stroke,Srinagar,Himachal Pradesh,2025-12-01,2809,103,2706,107,6
Heat Stroke,Srinagar,Jammu & Kashmir,2018-01-01,2468,24,2444,105,3
Heat Stroke,Srinagar,Jammu & Kashmir,2018-02-01,2039,6,2033,41,4
Heat Stroke,Srinagar,Jammu & Kashmir,2018-03-01,1329,146,1183,11,1
Heat Stroke,Srinagar,Jammu & Kashmir,2018-04-01,3413,118,3295,79,7
Heat Stroke,Srinagar,Jammu & Kashmir,2018-05-01,830,37,793,27,3
Heat Stroke,Srinagar,Jammu & Kashmir,2018-06-01,3638,64,3574,115,8
Heat Stroke,Srinagar,Jammu & Kashmir,2018-07-01,1253,97,1156,115,7
Heat Stroke,Srinagar,Jammu & Kashmir,2018-08-01,1588,43,1545,57,10
Heat Stroke,Srinagar,Jammu & Kashmir,2018-09-01,630,22,608,79,6
Heat Stroke,Srinagar,Jammu & Kashmir,2018-10-01,1925,113,1812,196,6
Heat Stroke,Srinagar,Jammu & Kashmir,2018-11-01,3906,74,3832,146,4
Heat Stroke,Srinagar,Jammu & Kashmir,2018-12-01,3289,147,3142,83,4
Heat Stroke,Srinagar,Jammu & Kashmir,2019-01-01,3910,355,3555,200,4
Heat Stroke,Srinagar,Jammu & Kashmir,2019-02-01,3298,206,3092,45,8
Heat Stroke,Srinagar,Jammu & Kashmir,2019-03-01,1117,60,1057,65,1
Heat Stroke,Srinagar,Jammu & Kashmir,2019-04-01,2154,121,2033,101,5
Heat Stroke,Srinagar,Jammu & Kashmir,2019-05-01,1551,60,1491,28,1
Heat Stroke,Srinagar,Jammu & Kashmir,2019-06-01,4382,442,3940,197,6
Heat Stroke,Srinagar,Jammu & Kashmir,2019-07-01,992,26,966,116,3
Heat Stroke,Srinagar,Jammu & Kashmir,2019-08-01,3796,213,3583,66,6
Heat Stroke,Srinagar,Jammu & Kashmir,2019-09-01,3795,202,3593,129,3
Heat Stroke,Srinagar,Jammu & Kashmir,2019-10-01,4989,396,4593,114,4
Heat Stroke,Srinagar,Jammu & Kashmir,2019-11-01,2048,168,1880,91,7
Heat Stroke,Srinagar,Jammu & Kashmir,2019-12-01,3553,174,3379,45,5
Heat Stroke,Srinagar,Jammu & Kashmir,2020-01-01,4989,292,4697,33,9
Heat Stroke,Srinagar,Jammu & Kashmir,2020-02-01,1769,105,1664,200,3
Heat Stroke,Srinagar,Jammu & Kashmir,2020-03-01,538,0,538,37,3
Heat Stroke,Srinagar,Jammu & Kashmir,2020-04-01,78,0,78,193,8
Heat Stroke,Srinagar,Jammu & Kashmir,2020-05-01,3554,115,3439,63,4
Heat Stroke,Srinagar,Jammu & Kashmir,2020-06-01,78,0,78,146,4
Heat Stroke,Srinagar,Jammu & Kashmir,2020-07-01,2098,31,2067,130,6
Heat Stroke,Srinagar,Jammu & Kashmir,2020-08-01,3184,228,2956,140,4
Heat Stroke,Srinagar,Jammu & Kashmir,2020-09-01,2846,142,2704,144,4
Heat Stroke,Srinagar,Jammu & Kashmir,2020-10-01,3168,138,3030,24,3
Heat Stroke,Srinagar,Jammu & Kashmir,2020-11-01,2896,39,2857,72,9
Heat Stroke,Srinagar,Jammu & Kashmir,2020-12-01,4313,210,4103,37,4
Heat Stroke,Srinagar,Jammu & Kashmir,2021-01-01,1320,0,1320,116,3
Heat Stroke,Srinagar,Jammu & Kashmir,2021-02-01,1689,76,1613,39,4
Heat Stroke,Srinagar,Jammu & Kashmir,2021-03-01,1561,81,1480,11,6
Heat Stroke,Srinagar,Jammu & Kashmir,2021-04-01,3711,211,3500,94,9
Heat Stroke,Srinagar,Jammu & Kashmir,2021-05-01,3805,17,3788,11,4
Heat Stroke,Srinagar,Jammu & Kashmir,2021-06-01,3203,181,3022,119,2
Heat Stroke,Srinagar,Jammu & Kashmir,2021-07-01,4185,82,4103,42,10
Heat Stroke,Srinagar,Jammu & Kashmir,2021-08-01,1017,26,991,63,5
Heat Stroke,Srinagar,Jammu & Kashmir,2021-09-01,4834,343,4491,11,5
Heat Stroke,Srinagar,Jammu & Kashmir,2021-10-01,4641,442,4199,190,5
Heat Stroke,Srinagar,Jammu & Kashmir,2021-11-01,3584,184,3400,32,1
Heat Stroke,Srinagar,Jammu & Kashmir,2021-12-01,4988,131,4857,88,5
Heat Stroke,Srinagar,Jammu & Kashmir,2022-01-01,375,20,355,15,7
Heat Stroke,Srinagar,Jammu & Kashmir,2022-02-01,1894,146,1748,64,8
Heat Stroke,Srinagar,Jammu & Kashmir,2022-03-01,1611,109,1502,195,4
Heat Stroke,Srinagar,Jammu & Kashmir,2022-04-01,3565,442,3123,121,5
Heat Stroke,Srinagar,Jammu & Kashmir,2022-05-01,1189,34,1155,69,8
Heat Stroke,Srinagar,Jammu & Kashmir,2022-06-01,3614,207,3407,104,5
Heat Stroke,Srinagar,Jammu & Kashmir,2022-07-01,4436,422,4014,78,7
Heat Stroke,Srinagar,Jammu & Kashmir,2022-08-01,3530,329,3201,102,6
Heat Stroke,Srinagar,Jammu & Kashmir,2022-09-01,2978,0,2978,144,3
Heat Stroke,Srinagar,Jammu & Kashmir,2022-10-01,1272,63,1209,89,2
Heat Stroke,Srinagar,Jammu & Kashmir,2022-11-01,1461,136,1325,117,8
Heat Stroke,Srinagar,Jammu & Kashmir,2022-12-01,4274,442,3832,118,1
Heat Stroke,Srinagar,Jammu & Kashmir,2023-01-01,3643,257,3386,90,3
Heat Stroke,Srinagar,Jammu & Kashmir,2023-02-01,2545,100,2445,69,1
Heat Stroke,Srinagar,Jammu & Kashmir,2023-03-01,2037,42,1995,79,8
Heat Stroke,Srinagar,Jammu & Kashmir,2023-04-01,78,0,78,142,9
Heat Stroke,Srinagar,Jammu & Kashmir,2023-05-01,1161,82,1079,146,3
Heat Stroke,Srinagar,Jammu & Kashmir,2023-06-01,4989,126,4863,48,10
Heat Stroke,Srinagar,Jammu & Kashmir,2023-07-01,880,38,842,93,9
Heat Stroke,Srinagar,Jammu & Kashmir,2023-08-01,2852,168,2684,68,5
Heat Stroke,Srinagar,Jammu & Kashmir,2023-09-01,3949,260,3689,147,9
Heat Stroke,Srinagar,Jammu & Kashmir,2023-10-01,914,21,893,82,3
Heat Stroke,Srinagar,Jammu & Kashmir,2023-11-01,2845,91,2754,200,4
Heat Stroke,Srinagar,Jammu & Kashmir,2023-12-01,3856,7,3849,117,6
Heat Stroke,Srinagar,Jammu & Kashmir,2024-01-01,2614,209,2405,166,3
Heat Stroke,Srinagar,Jammu & Kashmir,2024-02-01,4989,200,4789,55,1
Heat Stroke,Srinagar,Jammu & Kashmir,2024-03-01,359,22,337,107,2
Heat Stroke,Srinagar,Jammu & Kashmir,2024-04-01,4018,367,3651,138,4
Heat Stroke,Srinagar,Jammu & Kashmir,2024-05-01,2366,133,2233,54,6
Heat Stroke,Srinagar,Jammu & Kashmir,2024-06-01,3633,169,3464,107,4
Heat Stroke,Srinagar,Jammu & Kashmir,2024-07-01,3189,177,3012,160,1
Heat Stroke,Srinagar,Jammu & Kashmir,2024-08-01,1614,83,1531,90,6
Heat Stroke,Srinagar,Jammu & Kashmir,2024-09-01,2905,250,2655,63,9
Heat Stroke,Srinagar,Jammu & Kashmir,2024-10-01,105,6,99,198,3
Heat Stroke,Srinagar,Jammu & Kashmir,2024-11-01,3407,116,3291,47,10
Heat Stroke,Srinagar,Jammu & Kashmir,2024-12-01,2997,241,2756,114,7
Heat Stroke,Srinagar,Jammu & Kashmir,2025-01-01,3454,296,3158,70,2
Heat Stroke,Srinagar,Jammu & Kashmir,2025-02-01,4017,44,3973,58,3
Heat Stroke,Srinagar,Jammu & Kashmir,2025-03-01,3091,292,2799,144,4
Heat Stroke,Srinagar,Jammu & Kashmir,2025-04-01,2796,169,2627,96,4
Heat Stroke,Srinagar,Jammu & Kashmir,2025-05-01,1415,82,1333,127,1
Heat Stroke,Srinagar,Jammu & Kashmir,2025-06-01,1642,130,1512,11,3
Heat Stroke,Srinagar,Jammu & Kashmir,2025-07-01,4189,140,4049,132,3
Heat Stroke,Srinagar,Jammu & Kashmir,2025-08-01,4524,352,4172,69,10
Heat Stroke,Srinagar,Jammu & Kashmir,2025-09-01,2278,89,2189,11,5
Heat Stroke,Srinagar,Jammu & Kashmir,2025-10-01,2659,18,2641,200,3
Heat Stroke,Srinagar,Jammu & Kashmir,2025-11-01,1384,29,1355,137,4
Heat Stroke,Srinagar,Jammu & Kashmir,2025-12-01,4171,277,3894,118,6
Heat Stroke,Srinagar,Haryana,2018-01-01,3490,78,3412,170,4
Heat Stroke,Srinagar,Haryana,2018-02-01,4989,442,4547,119,3
Heat Stroke,Srinagar,Haryana,2018-03-01,1419,120,1299,66,3
Heat Stroke,Srinagar,Haryana,2018-04-01,2090,185,1905,97,6
Heat Stroke,Srinagar,Haryana,2018-05-01,2908,156,2752,72,1
Heat Stroke,Srinagar,Haryana,2018-06-01,3465,199,3266,81,2
Heat Stroke,Srinagar,Haryana,2018-07-01,2308,35,2273,42,2
Heat Stroke,Srinagar,Haryana,2018-08-01,1426,112,1314,57,2
Heat Stroke,Srinagar,Haryana,2018-09-01,3780,231,3549,152,2
Heat Stroke,Srinagar,Haryana,2018-10-01,3565,237,3328,123,7
Heat Stroke,Srinagar,Haryana,2018-11-01,1368,135,1233,81,8
Heat Stroke,Srinagar,Haryana,2018-12-01,4416,143,4273,54,6
Heat Stroke,Srinagar,Haryana,2019-01-01,4167,193,3974,86,5
Heat Stroke,Srinagar,Haryana,2019-02-01,2778,165,2613,20,3
Heat Stroke,Srinagar,Haryana,2019-03-01,2704,61,2643,113,1
Heat Stroke,Srinagar,Haryana,2019-04-01,3341,149,3192,154,5
Heat Stroke,Srinagar,Haryana,2019-05-01,1441,92,1349,200,6
Heat Stroke,Srinagar,Haryana,2019-06-01,2638,107,2531,50,3
Heat Stroke,Srinagar,Haryana,2019-07-01,78,0,78,152,2
Heat Stroke,Srinagar,Haryana,2019-08-01,3773,23,3750,70,1
Heat Stroke,Srinagar,Haryana,2019-09-01,503,41,462,49,5
Heat Stroke,Srinagar,Haryana,2019-10-01,4614,319,4295,49,5
Heat Stroke,Srinagar,Haryana,2019-11-01,2155,72,2083,113,8
Heat Stroke,Srinagar,Haryana,2019-12-01,2313,53,2260,59,2
Heat Stroke,Srinagar,Haryana,2020-01-01,1755,0,1755,75,4
Heat Stroke,Srinagar,Haryana,2020-02-01,2211,59,2152,84,5
Heat Stroke,Srinagar,Haryana,2020-03-01,4500,362,4138,69,3
Heat Stroke,Srinagar,Haryana,2020-04-01,78,0,78,65,7
Heat Stroke,Srinagar,Haryana,2020-05-01,4310,361,3949,11,8
Heat Stroke,Srinagar,Haryana,2020-06-01,3051,97,2954,111,2
Heat Stroke,Srinagar,Haryana,2020-07-01,978,69,909,110,3
Heat Stroke,Srinagar,Haryana,2020-08-01,1155,33,1122,66,9
Heat Stroke,Srinagar,Haryana,2020-09-01,4846,106,4740,125,6
Heat Stroke,Srinagar,Haryana,2020-10-01,1329,62,1267,177,5
Heat Stroke,Srinagar,Haryana,2020-11-01,1050,32,1018,107,6
Heat Stroke,Srinagar,Haryana,2020-12-01,4123,21,4102,174,7
Heat Stroke,Srinagar,Haryana,2021-01-01,3052,136,2916,200,6
Heat Stroke,Srinagar,Haryana,2021-02-01,1339,71,1268,200,5
Heat Stroke,Srinagar,Haryana,2021-03-01,2888,251,2637,46,5
Heat Stroke,Srinagar,Haryana,2021-04-01,1221,94,1127,46,9
Heat Stroke,Srinagar,Haryana,2021-05-01,4074,348,3726,84,4
Heat Stroke,Srinagar,Haryana,2021-06-01,4021,285,3736,113,5
Heat Stroke,Srinagar,Haryana,2021-07-01,3311,197,3114,187,9
Heat Stroke,Srinagar,Haryana,2021-08-01,3083,44,3039,138,6
Heat Stroke,Srinagar,Haryana,2021-09-01,4960,269,4691,45,5
Heat Stroke,Srinagar,Haryana,2021-10-01,2597,175,2422,75,7
Heat Stroke,Srinagar,Haryana,2021-11-01,1012,93,919,104,5
Heat Stroke,Srinagar,Haryana,2021-12-01,3200,224,2976,30,3
Heat Stroke,Srinagar,Haryana,2022-01-01,4989,429,4560,107,6
Heat Stroke,Srinagar,Haryana,2022-02-01,1236,24,1212,46,2
Heat Stroke,Srinagar,Haryana,2022-03-01,2113,85,2028,22,10
Heat Stroke,Srinagar,Haryana,2022-04-01,3156,197,2959,58,6
Heat Stroke,Srinagar,Haryana,2022-05-01,2525,211,2314,127,2
Heat Stroke,Srinagar,Haryana,2022-06-01,1280,58,1222,127,4
Heat Stroke,Srinagar,Haryana,2022-07-01,4102,195,3907,111,7
Heat Stroke,Srinagar,Haryana,2022-08-01,4989,349,4640,157,2
Heat Stroke,Srinagar,Haryana,2022-09-01,2861,49,2812,151,10
Heat Stroke,Srinagar,Haryana,2022-10-01,1385,134,1251,117,1
Heat Stroke,Srinagar,Haryana,2022-11-01,519,12,507,110,8
Heat Stroke,Srinagar,Haryana,2022-12-01,2943,0,2943,113,3
Heat Stroke,Srinagar,Haryana,2023-01-01,4078,205,3873,99,2
Heat Stroke,Srinagar,Haryana,2023-02-01,3235,321,2914,11,6
Heat Stroke,Srinagar,Haryana,2023-03-01,2594,174,2420,164,4
Heat Stroke,Srinagar,Haryana,2023-04-01,1807,129,1678,126,9
Heat Stroke,Srinagar,Haryana,2023-05-01,1132,58,1074,44,1
Heat Stroke,Srinagar,Haryana,2023-06-01,3717,169,3548,179,6
Heat Stroke,Srinagar,Haryana,2023-07-01,3823,19,3804,76,4
Heat Stroke,Srinagar,Haryana,2023-08-01,524,0,524,101,6
Heat Stroke,Srinagar,Haryana,2023-09-01,4730,263,4467,158,6
Heat Stroke,Srinagar,Haryana,2023-10-01,3368,297,3071,117,1
Heat Stroke,Srinagar,Haryana,2023-11-01,4475,268,4207,174,5
Heat Stroke,Srinagar,Haryana,2023-12-01,797,54,743,88,8
Heat Stroke,Srinagar,Haryana,2024-01-01,765,73,692,192,6
Heat Stroke,Srinagar,Haryana,2024-02-01,2398,143,2255,67,4
Heat Stroke,Srinagar,Haryana,2024-03-01,3272,152,3120,173,1
Heat Stroke,Srinagar,Haryana,2024-04-01,4989,130,4859,11,6
Heat Stroke,Srinagar,Haryana,2024-05-01,3545,386,3159,50,10
Heat Stroke,Srinagar,Haryana,2024-06-01,2272,148,2124,121,7
Heat Stroke,Srinagar,Haryana,2024-07-01,1221,27,1194,86,8
Heat Stroke,Srinagar,Haryana,2024-08-01,4247,67,4180,102,8
Heat Stroke,Srinagar,Haryana,2024-09-01,1303,112,1191,108,4
Heat Stroke,Srinagar,Haryana,2024-10-01,4782,95,4687,46,5
Heat Stroke,Srinagar,Haryana,2024-11-01,2216,230,1986,49,7
Heat Stroke,Srinagar,Haryana,2024-12-01,4731,0,4731,118,1
Heat Stroke,Srinagar,Haryana,2025-01-01,3508,320,3188,72,7
Heat Stroke,Srinagar,Haryana,2025-02-01,2414,155,2259,175,8
Heat Stroke,Srinagar,Haryana,2025-03-01,1901,101,1800,96,5
Heat Stroke,Srinagar,Haryana,2025-04-01,2140,96,2044,143,7
Heat Stroke,Srinagar,Haryana,2025-05-01,3172,333,2839,129,3
Heat Stroke,Srinagar,Haryana,2025-06-01,2701,190,2511,76,5
Heat Stroke,Srinagar,Haryana,2025-07-01,1801,42,1759,11,4
Heat Stroke,Srinagar,Haryana,2025-08-01,2375,0,2375,167,6
Heat Stroke,Srinagar,Haryana,2025-09-01,2703,149,2554,56,5
Heat Stroke,Srinagar,Haryana,2025-10-01,78,0,78,86,1
Heat Stroke,Srinagar,Haryana,2025-11-01,3212,18,3194,99,3
Heat Stroke,Srinagar,Haryana,2025-12-01,1283,62,1221,104,10
Heat Stroke,Gurugram,Punjab,2018-01-01,1050,35,1015,155,6
Heat Stroke,Gurugram,Punjab,2018-02-01,334,16,318,107,1
Heat Stroke,Gurugram,Punjab,2018-03-01,191,13,178,100,8
Heat Stroke,Gurugram,Punjab,2018-04-01,779,72,707,158,1
Heat Stroke,Gurugram,Punjab,2018-05-01,1646,125,1521,137,7
Heat Stroke,Gurugram,Punjab,2018-06-01,4989,145,4844,69,9
Heat Stroke,Gurugram,Punjab,2018-07-01,1892,115,1777,48,5
Heat Stroke,Gurugram,Punjab,2018-08-01,2836,147,2689,64,2
Heat Stroke,Gurugram,Punjab,2018-09-01,3135,35,3100,104,3
Heat Stroke,Gurugram,Punjab,2018-10-01,2773,170,2603,43,7
Heat Stroke,Gurugram,Punjab,2018-11-01,2494,259,2235,111,2
Heat Stroke,Gurugram,Punjab,2018-12-01,994,50,944,100,3
Heat Stroke,Gurugram,Punjab,2019-01-01,4544,16,4528,11,6
Heat Stroke,Gurugram,Punjab,2019-02-01,4989,254,4735,35,3
Heat Stroke,Gurugram,Punjab,2019-03-01,340,5,335,11,9
Heat Stroke,Gurugram,Punjab,2019-04-01,1224,92,1132,89,2
Heat Stroke,Gurugram,Punjab,2019-05-01,2222,145,2077,161,1
Heat Stroke,Gurugram,Punjab,2019-06-01,1303,58,1245,11,3
Heat Stroke,Gurugram,Punjab,2019-07-01,3276,132,3144,39,6
Heat Stroke,Gurugram,Punjab,2019-08-01,1620,71,1549,98,7
Heat Stroke,Gurugram,Punjab,2019-09-01,4989,251,4738,52,4
Heat Stroke,Gurugram,Punjab,2019-10-01,4195,115,4080,52,4
Heat Stroke,Gurugram,Punjab,2019-11-01,2883,27,2856,134,5
Heat Stroke,Gurugram,Punjab,2019-12-01,3975,330,3645,81,10
Heat Stroke,Gurugram,Punjab,2020-01-01,4081,158,3923,30,6
Heat Stroke,Gurugram,Punjab,2020-02-01,1841,101,1740,11,3
Heat Stroke,Gurugram,Punjab,2020-03-01,1502,87,1415,200,10
Heat Stroke,Gurugram,Punjab,2020-04-01,2702,160,2542,164,5
Heat Stroke,Gurugram,Punjab,2020-05-01,3753,59,3694,83,1
Heat Stroke,Gurugram,Punjab,2020-06-01,2784,3,2781,111,1
Heat Stroke,Gurugram,Punjab,2020-07-01,482,15,467,81,6
Heat Stroke,Gurugram,Punjab,2020-08-01,1520,93,1427,132,1
Heat Stroke,Gurugram,Punjab,2020-09-01,2498,72,2426,63,6
Heat Stroke,Gurugram,Punjab,2020-10-01,2496,99,2397,79,3
Heat Stroke,Gurugram,Punjab,2020-11-01,4989,442,4547,129,8
Heat Stroke,Gurugram,Punjab,2020-12-01,738,0,738,180,5
Heat Stroke,Gurugram,Punjab,2021-01-01,3276,92,3184,144,1
Heat Stroke,Gurugram,Punjab,2021-02-01,4595,442,4153,169,7
Heat Stroke,Gurugram,Punjab,2021-03-01,4989,243,4746,90,9
Heat Stroke,Gurugram,Punjab,2021-04-01,2055,60,1995,74,1
Heat Stroke,Gurugram,Punjab,2021-05-01,3257,273,2984,11,2
Heat Stroke,Gurugram,Punjab,2021-06-01,3362,173,3189,110,6
Heat Stroke,Gurugram,Punjab,2021-07-01,2860,114,2746,126,7
Heat Stroke,Gurugram,Punjab,2021-08-01,2465,137,2328,91,10
Heat Stroke,Gurugram,Punjab,2021-09-01,3182,98,3084,67,7
Heat Stroke,Gurugram,Punjab,2021-10-01,78,0,78,170,10
Heat Stroke,Gurugram,Punjab,2021-11-01,3512,164,3348,138,5
Heat Stroke,Gurugram,Punjab,2021-12-01,2767,57,2710,173,6
Heat Stroke,Gurugram,Punjab,2022-01-01,2299,115,2184,58,3
Heat Stroke,Gurugram,Punjab,2022-02-01,4989,301,4688,70,3
Heat Stroke,Gurugram,Punjab,2022-03-01,1692,126,1566,168,5
Heat Stroke,Gurugram,Punjab,2022-04-01,2057,170,1887,104,3
Heat Stroke,Gurugram,Punjab,2022-05-01,4989,190,4799,77,1
Heat Stroke,Gurugram,Punjab,2022-06-01,1481,95,1386,81,3
Heat Stroke,Gurugram,Punjab,2022-07-01,1859,119,1740,106,8
Heat Stroke,Gurugram,Punjab,2022-08-01,2400,143,2257,157,5
Heat Stroke,Gurugram,Punjab,2022-09-01,3725,134,3591,98,5
Heat Stroke,Gurugram,Punjab,2022-10-01,2876,57,2819,146,3
Heat Stroke,Gurugram,Punjab,2022-11-01,863,55,808,130,6
Heat Stroke,Gurugram,Punjab,2022-12-01,1883,0,1883,61,10
Heat Stroke,Gurugram,Punjab,2023-01-01,1783,75,1708,61,9
Heat Stroke,Gurugram,Punjab,2023-02-01,2494,0,2494,83,6
Heat Stroke,Gurugram,Punjab,2023-03-01,3169,35,3134,38,2
Heat Stroke,Gurugram,Punjab,2023-04-01,3158,77,3081,80,10
Heat Stroke,Gurugram,Punjab,2023-05-01,215,17,198,183,8
Heat Stroke,Gurugram,Punjab,2023-06-01,4025,282,3743,105,1
Heat Stroke,Gurugram,Punjab,2023-07-01,2936,99,2837,67,1
Heat Stroke,Gurugram,Punjab,2023-08-01,4455,317,4138,200,1
Heat Stroke,Gurugram,Punjab,2023-09-01,3193,242,2951,59,3
Heat Stroke,Gurugram,Punjab,2023-10-01,4075,184,3891,57,7
Heat Stroke,Gurugram,Punjab,2023-11-01,3223,31,3192,169,7
Heat Stroke,Gurugram,Punjab,2023-12-01,4403,193,4210,140,6
Heat Stroke,Gurugram,Punjab,2024-01-01,3298,155,3143,100,4
Heat Stroke,Gurugram,Punjab,2024-02-01,2466,35,2431,149,10
Heat Stroke,Gurugram,Punjab,2024-03-01,4989,303,4686,122,5
Heat Stroke,Gurugram,Punjab,2024-04-01,3790,220,3570,46,5
Heat Stroke,Gurugram,Punjab,2024-05-01,3367,212,3155,11,3
Heat Stroke,Gurugram,Punjab,2024-06-01,885,51,834,77,10
Heat Stroke,Gurugram,Punjab,2024-07-01,869,61,808,161,7
Heat Stroke,Gurugram,Punjab,2024-08-01,2990,134,2856,84,2
Heat Stroke,Gurugram,Punjab,2024-09-01,2793,156,2637,130,1
Heat Stroke,Gurugram,Punjab,2024-10-01,1774,68,1706,116,1
Heat Stroke,Gurugram,Punjab,2024-11-01,2787,92,2695,20,5
Heat Stroke,Gurugram,Punjab,2024-12-01,4729,420,4309,86,1
Heat Stroke,Gurugram,Punjab,2025-01-01,3530,0,3530,124,1
Heat Stroke,Gurugram,Punjab,2025-02-01,1067,80,987,66,8
Heat Stroke,Gurugram,Punjab,2025-03-01,2448,78,2370,88,7
Heat Stroke,Gurugram,Punjab,2025-04-01,1518,42,1476,126,9
Heat Stroke,Gurugram,Punjab,2025-05-01,2077,119,1958,110,1
Heat Stroke,Gurugram,Punjab,2025-06-01,2043,13,2030,160,2
Heat Stroke,Gurugram,Punjab,2025-07-01,1957,51,1906,126,3
Heat Stroke,Gurugram,Punjab,2025-08-01,914,23,891,58,10
Heat Stroke,Gurugram,Punjab,2025-09-01,2426,105,2321,82,5
Heat Stroke,Gurugram,Punjab,2025-10-01,1845,49,1796,107,10
Heat Stroke,Gurugram,Punjab,2025-11-01,78,0,78,174,7
Heat Stroke,Gurugram,Punjab,2025-12-01,4989,442,4547,82,4
Heat Stroke,Gurugram,Chandigarh,2018-01-01,4058,0,4058,18,6
Heat Stroke,Gurugram,Chandigarh,2018-02-01,2093,137,1956,129,1
Heat Stroke,Gurugram,Chandigarh,2018-03-01,2623,196,2427,68,1
Heat Stroke,Gurugram,Chandigarh,2018-04-01,1026,67,959,41,6
Heat Stroke,Gurugram,Chandigarh,2018-05-01,4872,150,4722,107,5
Heat Stroke,Gurugram,Chandigarh,2018-06-01,4989,214,4775,156,10
Heat Stroke,Gurugram,Chandigarh,2018-07-01,2808,79,2729,77,1
Heat Stroke,Gurugram,Chandigarh,2018-08-01,3970,150,3820,132,6
Heat Stroke,Gurugram,Chandigarh,2018-09-01,2833,42,2791,141,7
Heat Stroke,Gurugram,Chandigarh,2018-10-01,804,37,767,147,6
Heat Stroke,Gurugram,Chandigarh,2018-11-01,2045,12,2033,69,8
Heat Stroke,Gurugram,Chandigarh,2018-12-01,2774,122,2652,49,3
Heat Stroke,Gurugram,Chandigarh,2019-01-01,1988,27,1961,56,7
Heat Stroke,Gurugram,Chandigarh,2019-02-01,2304,129,2175,147,6
Heat Stroke,Gurugram,Chandigarh,2019-03-01,2475,74,2401,140,8
Heat Stroke,Gurugram,Chandigarh,2019-04-01,2489,145,2344,57,3
Heat Stroke,Gurugram,Chandigarh,2019-05-01,2668,217,2451,200,1
Heat Stroke,Gurugram,Chandigarh,2019-06-01,1175,113,1062,51,3
Heat Stroke,Gurugram,Chandigarh,2019-07-01,1636,0,1636,157,2
Heat Stroke,Gurugram,Chandigarh,2019-08-01,874,22,852,184,3
Heat Stroke,Gurugram,Chandigarh,2019-09-01,3909,161,3748,112,4
Heat Stroke,Gurugram,Chandigarh,2019-10-01,78,0,78,67,2
Heat Stroke,Gurugram,Chandigarh,2019-11-01,4145,8,4137,68,5
Heat Stroke,Gurugram,Chandigarh,2019-12-01,4457,95,4362,93,1
Heat Stroke,Gurugram,Chandigarh,2020-01-01,2192,118,2074,161,5
Heat Stroke,Gurugram,Chandigarh,2020-02-01,78,0,78,45,3
Heat Stroke,Gurugram,Chandigarh,2020-03-01,2113,129,1984,13,4
Heat Stroke,Gurugram,Chandigarh,2020-04-01,2511,158,2353,125,6
Heat Stroke,Gurugram,Chandigarh,2020-05-01,1242,74,1168,136,4
Heat Stroke,Gurugram,Chandigarh,2020-06-01,1906,106,1800,200,3
Heat Stroke,Gurugram,Chandigarh,2020-07-01,4650,240,4410,36,3
Heat Stroke,Gurugram,Chandigarh,2020-08-01,3489,242,3247,99,8
Heat Stroke,Gurugram,Chandigarh,2020-09-01,1357,0,1357,165,9
Heat Stroke,Gurugram,Chandigarh,2020-10-01,454,43,411,112,3
Heat Stroke,Gurugram,Chandigarh,2020-11-01,2159,0,2159,96,4
Heat Stroke,Gurugram,Chandigarh,2020-12-01,2311,43,2268,146,1
Heat Stroke,Gurugram,Chandigarh,2021-01-01,3263,141,3122,76,4
Heat Stroke,Gurugram,Chandigarh,2021-02-01,1879,130,1749,150,1
Heat Stroke,Gurugram,Chandigarh,2021-03-01,3284,0,3284,42,3
Heat Stroke,Gurugram,Chandigarh,2021-04-01,4989,245,4744,29,8
Heat Stroke,Gurugram,Chandigarh,2021-05-01,3691,269,3422,92,1
Heat Stroke,Gurugram,Chandigarh,2021-06-01,2533,200,2333,11,2
Heat Stroke,Gurugram,Chandigarh,2021-07-01,2352,70,2282,111,2
Heat Stroke,Gurugram,Chandigarh,2021-08-01,2119,87,2032,18,1
Heat Stroke,Gurugram,Chandigarh,2021-09-01,4181,134,4047,121,7
Heat Stroke,Gurugram,Chandigarh,2021-10-01,1756,67,1689,116,6
Heat Stroke,Gurugram,Chandigarh,2021-11-01,2658,53,2605,103,10
Heat Stroke,Gurugram,Chandigarh,2021-12-01,2666,64,2602,128,2
Heat Stroke,Gurugram,Chandigarh,2022-01-01,1924,120,1804,117,1
Heat Stroke,Gurugram,Chandigarh,2022-02-01,756,40,716,91,8
Heat Stroke,Gurugram,Chandigarh,2022-03-01,3031,195,2836,199,4
Heat Stroke,Gurugram,Chandigarh,2022-04-01,2516,141,2375,126,3
Heat Stroke,Gurugram,Chandigarh,2022-05-01,3268,230,3038,146,9
Heat Stroke,Gurugram,Chandigarh,2022-06-01,1882,142,1740,161,5
Heat Stroke,Gurugram,Chandigarh,2022-07-01,4235,0,4235,140,7
Heat Stroke,Gurugram,Chandigarh,2022-08-01,1421,35,1386,200,3
Heat Stroke,Gurugram,Chandigarh,2022-09-01,4894,212,4682,115,3
Heat Stroke,Gurugram,Chandigarh,2022-10-01,253,12,241,106,4
Heat Stroke,Gurugram,Chandigarh,2022-11-01,3181,97,3084,73,7
Heat Stroke,Gurugram,Chandigarh,2022-12-01,3235,247,2988,93,5
Heat Stroke,Gurugram,Chandigarh,2023-01-01,1530,164,1366,69,6
Heat Stroke,Gurugram,Chandigarh,2023-02-01,3167,175,2992,141,1
Heat Stroke,Gurugram,Chandigarh,2023-03-01,4314,226,4088,60,1
Heat Stroke,Gurugram,Chandigarh,2023-04-01,78,0,78,110,1
Heat Stroke,Gurugram,Chandigarh,2023-05-01,3272,0,3272,135,4
Heat Stroke,Gurugram,Chandigarh,2023-06-01,78,0,78,114,1
Heat Stroke,Gurugram,Chandigarh,2023-07-01,1302,102,1200,61,10
Heat Stroke,Gurugram,Chandigarh,2023-08-01,4783,149,4634,142,5
Heat Stroke,Gurugram,Chandigarh,2023-09-01,1817,26,1791,102,5
Heat Stroke,Gurugram,Chandigarh,2023-10-01,1023,45,978,11,2
Heat Stroke,Gurugram,Chandigarh,2023-11-01,2332,112,2220,56,2
Heat Stroke,Gurugram,Chandigarh,2023-12-01,4989,117,4872,178,9
Heat Stroke,Gurugram,Chandigarh,2024-01-01,140,15,125,182,10
Heat Stroke,Gurugram,Chandigarh,2024-02-01,1187,42,1145,133,6
Heat Stroke,Gurugram,Chandigarh,2024-03-01,4606,75,4531,146,1
Heat Stroke,Gurugram,Chandigarh,2024-04-01,4989,236,4753,67,4
Heat Stroke,Gurugram,Chandigarh,2024-05-01,2459,188,2271,93,6
Heat Stroke,Gurugram,Chandigarh,2024-06-01,935,47,888,169,4
Heat Stroke,Gurugram,Chandigarh,2024-07-01,4989,320,4669,128,1
Heat Stroke,Gurugram,Chandigarh,2024-08-01,4736,117,4619,110,10
Heat Stroke,Gurugram,Chandigarh,2024-09-01,3508,327,3181,97,2
Heat Stroke,Gurugram,Chandigarh,2024-10-01,1508,100,1408,166,1
Heat Stroke,Gurugram,Chandigarh,2024-11-01,2532,203,2329,163,5
Heat Stroke,Gurugram,Chandigarh,2024-12-01,2382,144,2238,139,8
Heat Stroke,Gurugram,Chandigarh,2025-01-01,3041,225,2816,110,6
Heat Stroke,Gurugram,Chandigarh,2025-02-01,4544,112,4432,88,1
Heat Stroke,Gurugram,Chandigarh,2025-03-01,3777,135,3642,142,1
Heat Stroke,Gurugram,Chandigarh,2025-04-01,1152,102,1050,50,1
Heat Stroke,Gurugram,Chandigarh,2025-05-01,4444,424,4020,61,4
Heat Stroke,Gurugram,Chandigarh,2025-06-01,3017,50,2967,32,3
Heat Stroke,Gurugram,Chandigarh,2025-07-01,3519,201,3318,169,6
Heat Stroke,Gurugram,Chandigarh,2025-08-01,4565,171,4394,69,3
Heat Stroke,Gurugram,Chandigarh,2025-09-01,1106,32,1074,127,8
Heat Stroke,Gurugram,Chandigarh,2025-10-01,2549,148,2401,100,7
Heat Stroke,Gurugram,Chandigarh,2025-11-01,1884,156,1728,200,3
Heat Stroke,Gurugram,Chandigarh,2025-12-01,494,31,463,129,6
Heat Stroke,Gurugram,Himachal Pradesh,2018-01-01,3063,124,2939,11,9
Heat Stroke,Gurugram,Himachal Pradesh,2018-02-01,4989,324,4665,166,2
Heat Stroke,Gurugram,Himachal Pradesh,2018-03-01,129,5,124,86,4
Heat Stroke,Gurugram,Himachal Pradesh,2018-04-01,2554,158,2396,96,4
Heat Stroke,Gurugram,Himachal Pradesh,2018-05-01,3457,313,3144,72,4
Heat Stroke,Gurugram,Himachal Pradesh,2018-06-01,2763,0,2763,116,7
Heat Stroke,Gurugram,Himachal Pradesh,2018-07-01,2446,179,2267,116,7
Heat Stroke,Gurugram,Himachal Pradesh,2018-08-01,854,4,850,73,6
Heat Stroke,Gurugram,Himachal Pradesh,2018-09-01,2910,249,2661,80,6
Heat Stroke,Gurugram,Himachal Pradesh,2018-10-01,1582,49,1533,111,3
Heat Stroke,Gurugram,Himachal Pradesh,2018-11-01,78,0,78,11,6
Heat Stroke,Gurugram,Himachal Pradesh,2018-12-01,4200,295,3905,33,1
Heat Stroke,Gurugram,Himachal Pradesh,2019-01-01,3883,235,3648,191,10
Heat Stroke,Gurugram,Himachal Pradesh,2019-02-01,2667,55,2612,123,9
Heat Stroke,Gurugram,Himachal Pradesh,2019-03-01,2905,39,2866,79,8
Heat Stroke,Gurugram,Himachal Pradesh,2019-04-01,4039,180,3859,20,6
Heat Stroke,Gurugram,Himachal Pradesh,2019-05-01,2898,43,2855,103,6
Heat Stroke,Gurugram,Himachal Pradesh,2019-06-01,3810,73,3737,156,1
Heat Stroke,Gurugram,Himachal Pradesh,2019-07-01,2198,117,2081,200,1
Heat Stroke,Gurugram,Himachal Pradesh,2019-08-01,4357,95,4262,200,2
Heat Stroke,Gurugram,Himachal Pradesh,2019-09-01,3028,189,2839,61,5
Heat Stroke,Gurugram,Himachal Pradesh,2019-10-01,2858,267,2591,81,4
Heat Stroke,Gurugram,Himachal Pradesh,2019-11-01,894,40,854,31,7
Heat Stroke,Gurugram,Himachal Pradesh,2019-12-01,2982,160,2822,63,2
Heat Stroke,Gurugram,Himachal Pradesh,2020-01-01,1481,161,1320,95,8
Heat Stroke,Gurugram,Himachal Pradesh,2020-02-01,1741,26,1715,88,2
Heat Stroke,Gurugram,Himachal Pradesh,2020-03-01,1504,127,1377,200,4
Heat Stroke,Gurugram,Himachal Pradesh,2020-04-01,1167,94,1073,39,7
Heat Stroke,Gurugram,Himachal Pradesh,2020-05-01,4989,373,4616,104,6
Heat Stroke,Gurugram,Himachal Pradesh,2020-06-01,4383,384,3999,11,1
Heat Stroke,Gurugram,Himachal Pradesh,2020-07-01,4989,290,4699,123,8
Heat Stroke,Gurugram,Himachal Pradesh,2020-08-01,957,31,926,38,5
Heat Stroke,Gurugram,Himachal Pradesh,2020-09-01,2693,220,2473,162,1
Heat Stroke,Gurugram,Himachal Pradesh,2020-10-01,862,71,791,91,2
Heat Stroke,Gurugram,Himachal Pradesh,2020-11-01,1664,136,1528,35,4
Heat Stroke,Gurugram,Himachal Pradesh,2020-12-01,1366,70,1296,11,1
Heat Stroke,Gurugram,Himachal Pradesh,2021-01-01,4260,124,4136,56,9
Heat Stroke,Gurugram,Himachal Pradesh,2021-02-01,2066,114,1952,118,4
Heat Stroke,Gurugram,Himachal Pradesh,2021-03-01,4031,312,3719,128,6
Heat Stroke,Gurugram,Himachal Pradesh,2021-04-01,3408,272,3136,81,5
Heat Stroke,Gurugram,Himachal Pradesh,2021-05-01,4989,187,4802,153,7
Heat Stroke,Gurugram,Himachal Pradesh,2021-06-01,613,36,577,48,10
Heat Stroke,Gurugram,Himachal Pradesh,2021-07-01,4287,51,4236,11,7
Heat Stroke,Gurugram,Himachal Pradesh,2021-08-01,4135,325,3810,121,10
Heat Stroke,Gurugram,Himachal Pradesh,2021-09-01,1292,35,1257,172,7
Heat Stroke,Gurugram,Himachal Pradesh,2021-10-01,3948,287,3661,172,5
Heat Stroke,Gurugram,Himachal Pradesh,2021-11-01,3048,50,2998,40,6
Heat Stroke,Gurugram,Himachal Pradesh,2021-12-01,2292,183,2109,78,1
Heat Stroke,Gurugram,Himachal Pradesh,2022-01-01,1492,88,1404,143,3
Heat Stroke,Gurugram,Himachal Pradesh,2022-02-01,1633,44,1589,74,4
Heat Stroke,Gurugram,Himachal Pradesh,2022-03-01,4989,350,4639,112,6
Heat Stroke,Gurugram,Himachal Pradesh,2022-04-01,2598,85,2513,70,5
Heat Stroke,Gurugram,Himachal Pradesh,2022-05-01,3647,262,3385,51,6
Heat Stroke,Gurugram,Himachal Pradesh,2022-06-01,1536,64,1472,61,1
Heat Stroke,Gurugram,Himachal Pradesh,2022-07-01,1551,0,1551,155,1
Heat Stroke,Gurugram,Himachal Pradesh,2022-08-01,4049,86,3963,107,1
Heat Stroke,Gurugram,Himachal Pradesh,2022-09-01,787,29,758,171,9
Heat Stroke,Gurugram,Himachal Pradesh,2022-10-01,2040,183,1857,133,1
Heat Stroke,Gurugram,Himachal Pradesh,2022-11-01,2643,201,2442,188,3
Heat Stroke,Gurugram,Himachal Pradesh,2022-12-01,2747,267,2480,148,5
Heat Stroke,Gurugram,Himachal Pradesh,2023-01-01,2357,231,2126,145,1
Heat Stroke,Gurugram,Himachal Pradesh,2023-02-01,3128,107,3021,100,2
Heat Stroke,Gurugram,Himachal Pradesh,2023-03-01,3527,157,3370,200,7
Heat Stroke,Gurugram,Himachal Pradesh,2023-04-01,3583,136,3447,112,4
Heat Stroke,Gurugram,Himachal Pradesh,2023-05-01,1275,38,1237,11,10
Heat Stroke,Gurugram,Himachal Pradesh,2023-06-01,2216,0,2216,120,1
Heat Stroke,Gurugram,Himachal Pradesh,2023-07-01,4200,208,3992,56,4
Heat Stroke,Gurugram,Himachal Pradesh,2023-08-01,3798,48,3750,158,4
Heat Stroke,Gurugram,Himachal Pradesh,2023-09-01,756,37,719,143,5
Heat Stroke,Gurugram,Himachal Pradesh,2023-10-01,3069,342,2727,96,1
Heat Stroke,Gurugram,Himachal Pradesh,2023-11-01,78,0,78,61,3
Heat Stroke,Gurugram,Himachal Pradesh,2023-12-01,2660,148,2512,114,7
Heat Stroke,Gurugram,Himachal Pradesh,2024-01-01,4989,381,4608,74,4
Heat Stroke,Gurugram,Himachal Pradesh,2024-02-01,1326,77,1249,146,2
Heat Stroke,Gurugram,Himachal Pradesh,2024-03-01,1478,86,1392,135,10
Heat Stroke,Gurugram,Himachal Pradesh,2024-04-01,3622,143,3479,200,5
Heat Stroke,Gurugram,Himachal Pradesh,2024-05-01,528,22,506,84,7
Heat Stroke,Gurugram,Himachal Pradesh,2024-06-01,1749,38,1711,91,7
Heat Stroke,Gurugram,Himachal Pradesh,2024-07-01,3398,253,3145,98,5
Heat Stroke,Gurugram,Himachal Pradesh,2024-08-01,1747,0,1747,101,3
Heat Stroke,Gurugram,Himachal Pradesh,2024-09-01,2281,178,2103,159,5
Heat Stroke,Gurugram,Himachal Pradesh,2024-10-01,3596,33,3563,92,3
Heat Stroke,Gurugram,Himachal Pradesh,2024-11-01,3163,246,2917,200,6
Heat Stroke,Gurugram,Himachal Pradesh,2024-12-01,2955,117,2838,136,4
Heat Stroke,Gurugram,Himachal Pradesh,2025-01-01,2142,30,2112,81,8
Heat Stroke,Gurugram,Himachal Pradesh,2025-02-01,3094,207,2887,68,2
Heat Stroke,Gurugram,Himachal Pradesh,2025-03-01,2431,187,2244,159,7
Heat Stroke,Gurugram,Himachal Pradesh,2025-04-01,3212,119,3093,108,7
Heat Stroke,Gurugram,Himachal Pradesh,2025-05-01,1931,137,1794,107,4
Heat Stroke,Gurugram,Himachal Pradesh,2025-06-01,2352,0,2352,76,7
Heat Stroke,Gurugram,Himachal Pradesh,2025-07-01,1269,14,1255,103,6
Heat Stroke,Gurugram,Himachal Pradesh,2025-08-01,2550,223,2327,74,7
Heat Stroke,Gurugram,Himachal Pradesh,2025-09-01,1509,65,1444,176,7
Heat Stroke,Gurugram,Himachal Pradesh,2025-10-01,1103,0,1103,143,5
Heat Stroke,Gurugram,Himachal Pradesh,2025-11-01,2944,87,2857,97,3
Heat Stroke,Gurugram,Himachal Pradesh,2025-12-01,2883,66,2817,97,3
Heat Stroke,Gurugram,Jammu & Kashmir,2018-01-01,3648,165,3483,111,4
Heat Stroke,Gurugram,Jammu & Kashmir,2018-02-01,2019,79,1940,106,7
Heat Stroke,Gurugram,Jammu & Kashmir,2018-03-01,3145,173,2972,57,7
Heat Stroke,Gurugram,Jammu & Kashmir,2018-04-01,3336,160,3176,11,8
Heat Stroke,Gurugram,Jammu & Kashmir,2018-05-01,3194,286,2908,66,8
Heat Stroke,Gurugram,Jammu & Kashmir,2018-06-01,1490,93,1397,100,4
Heat Stroke,Gurugram,Jammu & Kashmir,2018-07-01,2798,177,2621,69,10
Heat Stroke,Gurugram,Jammu & Kashmir,2018-08-01,3086,259,2827,148,5
Heat Stroke,Gurugram,Jammu & Kashmir,2018-09-01,2607,101,2506,95,3
Heat Stroke,Gurugram,Jammu & Kashmir,2018-10-01,78,0,78,200,6
Heat Stroke,Gurugram,Jammu & Kashmir,2018-11-01,2813,239,2574,78,6
Heat Stroke,Gurugram,Jammu & Kashmir,2018-12-01,4989,269,4720,113,3
Heat Stroke,Gurugram,Jammu & Kashmir,2019-01-01,2114,114,2000,91,4
Heat Stroke,Gurugram,Jammu & Kashmir,2019-02-01,1621,51,1570,129,4
Heat Stroke,Gurugram,Jammu & Kashmir,2019-03-01,3098,99,2999,161,5
Heat Stroke,Gurugram,Jammu & Kashmir,2019-04-01,3016,225,2791,137,7
Heat Stroke,Gurugram,Jammu & Kashmir,2019-05-01,4197,330,3867,11,4
Heat Stroke,Gurugram,Jammu & Kashmir,2019-06-01,910,66,844,132,6
Heat Stroke,Gurugram,Jammu & Kashmir,2019-07-01,3579,261,3318,55,1
Heat Stroke,Gurugram,Jammu & Kashmir,2019-08-01,3389,225,3164,90,7
Heat Stroke,Gurugram,Jammu & Kashmir,2019-09-01,2407,129,2278,141,4
Heat Stroke,Gurugram,Jammu & Kashmir,2019-10-01,3052,137,2915,49,3
Heat Stroke,Gurugram,Jammu & Kashmir,2019-11-01,3978,339,3639,165,6
Heat Stroke,Gurugram,Jammu & Kashmir,2019-12-01,3768,147,3621,88,6
Heat Stroke,Gurugram,Jammu & Kashmir,2020-01-01,1064,64,1000,200,4
Heat Stroke,Gurugram,Jammu & Kashmir,2020-02-01,3698,98,3600,110,2
Heat Stroke,Gurugram,Jammu & Kashmir,2020-03-01,2511,77,2434,193,3
Heat Stroke,Gurugram,Jammu & Kashmir,2020-04-01,2695,116,2579,167,5
Heat Stroke,Gurugram,Jammu & Kashmir,2020-05-01,2696,71,2625,75,6
Heat Stroke,Gurugram,Jammu & Kashmir,2020-06-01,2396,175,2221,40,2
Heat Stroke,Gurugram,Jammu & Kashmir,2020-07-01,4196,45,4151,112,3
Heat Stroke,Gurugram,Jammu & Kashmir,2020-08-01,2485,131,2354,77,6
Heat Stroke,Gurugram,Jammu & Kashmir,2020-09-01,1096,59,1037,187,5
Heat Stroke,Gurugram,Jammu & Kashmir,2020-10-01,2069,0,2069,94,5
Heat Stroke,Gurugram,Jammu & Kashmir,2020-11-01,2837,105,2732,91,1
Heat Stroke,Gurugram,Jammu & Kashmir,2020-12-01,4246,244,4002,35,4
Heat Stroke,Gurugram,Jammu & Kashmir,2021-01-01,3406,213,3193,128,7
Heat Stroke,Gurugram,Jammu & Kashmir,2021-02-01,1456,64,1392,46,3
Heat Stroke,Gurugram,Jammu & Kashmir,2021-03-01,4989,348,4641,129,6
Heat Stroke,Gurugram,Jammu & Kashmir,2021-04-01,2953,138,2815,136,1
Heat Stroke,Gurugram,Jammu & Kashmir,2021-05-01,4308,217,4091,68,1
Heat Stroke,Gurugram,Jammu & Kashmir,2021-06-01,2394,137,2257,155,6
Heat Stroke,Gurugram,Jammu & Kashmir,2021-07-01,3313,255,3058,92,5
Heat Stroke,Gurugram,Jammu & Kashmir,2021-08-01,3724,113,3611,31,4
Heat Stroke,Gurugram,Jammu & Kashmir,2021-09-01,4232,151,4081,185,7
Heat Stroke,Gurugram,Jammu & Kashmir,2021-10-01,4016,122,3894,59,4
Heat Stroke,Gurugram,Jammu & Kashmir,2021-11-01,3767,152,3615,132,3
Heat Stroke,Gurugram,Jammu & Kashmir,2021-12-01,2175,199,1976,128,3
Heat Stroke,Gurugram,Jammu & Kashmir,2022-01-01,1830,122,1708,126,2
Heat Stroke,Gurugram,Jammu & Kashmir,2022-02-01,3044,52,2992,125,6
Heat Stroke,Gurugram,Jammu & Kashmir,2022-03-01,3849,125,3724,57,4
Heat Stroke,Gurugram,Jammu & Kashmir,2022-04-01,2299,140,2159,192,8
Heat Stroke,Gurugram,Jammu & Kashmir,2022-05-01,4026,95,3931,155,1
Heat Stroke,Gurugram,Jammu & Kashmir,2022-06-01,4546,131,4415,130,8
Heat Stroke,Gurugram,Jammu & Kashmir,2022-07-01,1368,122,1246,38,6
Heat Stroke,Gurugram,Jammu & Kashmir,2022-08-01,1475,47,1428,56,5
Heat Stroke,Gurugram,Jammu & Kashmir,2022-09-01,2409,187,2222,140,1
Heat Stroke,Gurugram,Jammu & Kashmir,2022-10-01,3010,260,2750,11,1
Heat Stroke,Gurugram,Jammu & Kashmir,2022-11-01,1894,54,1840,123,7
Heat Stroke,Gurugram,Jammu & Kashmir,2022-12-01,4411,106,4305,38,6
Heat Stroke,Gurugram,Jammu & Kashmir,2023-01-01,3166,133,3033,62,5
Heat Stroke,Gurugram,Jammu & Kashmir,2023-02-01,2650,48,2602,34,5
Heat Stroke,Gurugram,Jammu & Kashmir,2023-03-01,671,35,636,119,7
Heat Stroke,Gurugram,Jammu & Kashmir,2023-04-01,832,36,796,163,3
Heat Stroke,Gurugram,Jammu & Kashmir,2023-05-01,2974,180,2794,124,4
Heat Stroke,Gurugram,Jammu & Kashmir,2023-06-01,78,0,78,130,4
Heat Stroke,Gurugram,Jammu & Kashmir,2023-07-01,3956,292,3664,115,4
Heat Stroke,Gurugram,Jammu & Kashmir,2023-08-01,2385,153,2232,141,9
Heat Stroke,Gurugram,Jammu & Kashmir,2023-09-01,4989,20,4969,130,1
Heat Stroke,Gurugram,Jammu & Kashmir,2023-10-01,4989,314,4675,11,1
Heat Stroke,Gurugram,Jammu & Kashmir,2023-11-01,2354,235,2119,152,1
Heat Stroke,Gurugram,Jammu & Kashmir,2023-12-01,2455,0,2455,147,7
Heat Stroke,Gurugram,Jammu & Kashmir,2024-01-01,3933,275,3658,88,5
Heat Stroke,Gurugram,Jammu & Kashmir,2024-02-01,4882,221,4661,11,1
Heat Stroke,Gurugram,Jammu & Kashmir,2024-03-01,400,10,390,119,5
Heat Stroke,Gurugram,Jammu & Kashmir,2024-04-01,201,14,187,123,4
Heat Stroke,Gurugram,Jammu & Kashmir,2024-05-01,1763,176,1587,84,6
Heat Stroke,Gurugram,Jammu & Kashmir,2024-06-01,3379,245,3134,116,7
Heat Stroke,Gurugram,Jammu & Kashmir,2024-07-01,3264,128,3136,161,10
Heat Stroke,Gurugram,Jammu & Kashmir,2024-08-01,4033,91,3942,200,1
Heat Stroke,Gurugram,Jammu & Kashmir,2024-09-01,988,53,935,114,1
Heat Stroke,Gurugram,Jammu & Kashmir,2024-10-01,78,0,78,123,7
Heat Stroke,Gurugram,Jammu & Kashmir,2024-11-01,3748,145,3603,64,8
Heat Stroke,Gurugram,Jammu & Kashmir,2024-12-01,1486,61,1425,81,1
Heat Stroke,Gurugram,Jammu & Kashmir,2025-01-01,78,0,78,99,1
Heat Stroke,Gurugram,Jammu & Kashmir,2025-02-01,2792,227,2565,166,6
Heat Stroke,Gurugram,Jammu & Kashmir,2025-03-01,3661,305,3356,148,10
Heat Stroke,Gurugram,Jammu & Kashmir,2025-04-01,2434,18,2416,200,2
Heat Stroke,Gurugram,Jammu & Kashmir,2025-05-01,1983,58,1925,30,5
Heat Stroke,Gurugram,Jammu & Kashmir,2025-06-01,2384,124,2260,39,1
Heat Stroke,Gurugram,Jammu & Kashmir,2025-07-01,2100,43,2057,162,4
Heat Stroke,Gurugram,Jammu & Kashmir,2025-08-01,789,76,713,180,4
Heat Stroke,Gurugram,Jammu & Kashmir,2025-09-01,1639,149,1490,108,9
Heat Stroke,Gurugram,Jammu & Kashmir,2025-10-01,3297,113,3184,11,3
Heat Stroke,Gurugram,Jammu & Kashmir,2025-11-01,3029,308,2721,68,7
Heat Stroke,Gurugram,Jammu & Kashmir,2025-12-01,2823,141,2682,123,3
Heat Stroke,Gurugram,Haryana,2018-01-01,1262,158,1104,60,5
Heat Stroke,Gurugram,Haryana,2018-02-01,2354,127,2227,116,10
Heat Stroke,Gurugram,Haryana,2018-03-01,78,0,78,200,10
Heat Stroke,Gurugram,Haryana,2018-04-01,2837,257,2580,179,10
Heat Stroke,Gurugram,Haryana,2018-05-01,4514,393,4121,147,6
Heat Stroke,Gurugram,Haryana,2018-06-01,620,40,580,103,4
Heat Stroke,Gurugram,Haryana,2018-07-01,1811,83,1728,81,6
Heat Stroke,Gurugram,Haryana,2018-08-01,3039,197,2842,145,6
Heat Stroke,Gurugram,Haryana,2018-09-01,4278,112,4166,108,6
Heat Stroke,Gurugram,Haryana,2018-10-01,1996,108,1888,109,3
Heat Stroke,Gurugram,Haryana,2018-11-01,1669,29,1640,27,3
Heat Stroke,Gurugram,Haryana,2018-12-01,78,0,78,70,3
Heat Stroke,Gurugram,Haryana,2019-01-01,2736,141,2595,145,8
Heat Stroke,Gurugram,Haryana,2019-02-01,4989,433,4556,50,8
Heat Stroke,Gurugram,Haryana,2019-03-01,2969,228,2741,120,10
Heat Stroke,Gurugram,Haryana,2019-04-01,2568,122,2446,127,6
Heat Stroke,Gurugram,Haryana,2019-05-01,3029,305,2724,130,3
Heat Stroke,Gurugram,Haryana,2019-06-01,2583,86,2497,135,3
Heat Stroke,Gurugram,Haryana,2019-07-01,1507,0,1507,138,4
Heat Stroke,Gurugram,Haryana,2019-08-01,3702,0,3702,74,9
Heat Stroke,Gurugram,Haryana,2019-09-01,2900,45,2855,31,7
Heat Stroke,Gurugram,Haryana,2019-10-01,2621,193,2428,62,1
Heat Stroke,Gurugram,Haryana,2019-11-01,1289,40,1249,143,5
Heat Stroke,Gurugram,Haryana,2019-12-01,4346,275,4071,45,1
Heat Stroke,Gurugram,Haryana,2020-01-01,3489,341,3148,53,7
Heat Stroke,Gurugram,Haryana,2020-02-01,1856,33,1823,53,3
Heat Stroke,Gurugram,Haryana,2020-03-01,3941,252,3689,12,3
Heat Stroke,Gurugram,Haryana,2020-04-01,1930,126,1804,48,1
Heat Stroke,Gurugram,Haryana,2020-05-01,1548,38,1510,157,7
Heat Stroke,Gurugram,Haryana,2020-06-01,1578,141,1437,70,8
Heat Stroke,Gurugram,Haryana,2020-07-01,222,9,213,17,3
Heat Stroke,Gurugram,Haryana,2020-08-01,3230,125,3105,80,4
Heat Stroke,Gurugram,Haryana,2020-09-01,141,15,126,132,3
Heat Stroke,Gurugram,Haryana,2020-10-01,949,61,888,13,4
Heat Stroke,Gurugram,Haryana,2020-11-01,78,0,78,155,2
Heat Stroke,Gurugram,Haryana,2020-12-01,2482,222,2260,33,2
Heat Stroke,Gurugram,Haryana,2021-01-01,2396,74,2322,86,9
Heat Stroke,Gurugram,Haryana,2021-02-01,2159,186,1973,85,1
Heat Stroke,Gurugram,Haryana,2021-03-01,1199,42,1157,78,6
Heat Stroke,Gurugram,Haryana,2021-04-01,1025,35,990,103,6
Heat Stroke,Gurugram,Haryana,2021-05-01,3220,135,3085,146,10
Heat Stroke,Gurugram,Haryana,2021-06-01,1859,59,1800,104,4
Heat Stroke,Gurugram,Haryana,2021-07-01,3022,223,2799,75,4
Heat Stroke,Gurugram,Haryana,2021-08-01,1410,81,1329,130,2
Heat Stroke,Gurugram,Haryana,2021-09-01,2840,101,2739,117,6
Heat Stroke,Gurugram,Haryana,2021-10-01,4346,302,4044,72,3
Heat Stroke,Gurugram,Haryana,2021-11-01,3384,142,3242,108,2
Heat Stroke,Gurugram,Haryana,2021-12-01,2044,82,1962,68,3
Heat Stroke,Gurugram,Haryana,2022-01-01,2942,151,2791,62,2
Heat Stroke,Gurugram,Haryana,2022-02-01,2275,144,2131,147,2
Heat Stroke,Gurugram,Haryana,2022-03-01,2608,160,2448,129,5
Heat Stroke,Gurugram,Haryana,2022-04-01,2161,85,2076,145,4
Heat Stroke,Gurugram,Haryana,2022-05-01,2377,177,2200,139,6
Heat Stroke,Gurugram,Haryana,2022-06-01,2882,125,2757,61,5
Heat Stroke,Gurugram,Haryana,2022-07-01,1265,39,1226,157,1
Heat Stroke,Gurugram,Haryana,2022-08-01,1235,9,1226,91,1
Heat Stroke,Gurugram,Haryana,2022-09-01,735,57,678,154,2
Heat Stroke,Gurugram,Haryana,2022-10-01,451,22,429,100,7
Heat Stroke,Gurugram,Haryana,2022-11-01,964,54,910,122,7
Heat Stroke,Gurugram,Haryana,2022-12-01,2811,226,2585,124,8
Heat Stroke,Gurugram,Haryana,2023-01-01,1400,50,1350,148,7
Heat Stroke,Gurugram,Haryana,2023-02-01,3286,33,3253,23,8
Heat Stroke,Gurugram,Haryana,2023-03-01,2644,137,2507,26,6
Heat Stroke,Gurugram,Haryana,2023-04-01,78,0,78,140,10
Heat Stroke,Gurugram,Haryana,2023-05-01,3476,147,3329,124,6
Heat Stroke,Gurugram,Haryana,2023-06-01,3685,342,3343,67,10
Heat Stroke,Gurugram,Haryana,2023-07-01,1264,0,1264,125,3
Heat Stroke,Gurugram,Haryana,2023-08-01,3161,261,2900,34,3
Heat Stroke,Gurugram,Haryana,2023-09-01,1448,105,1343,200,4
Heat Stroke,Gurugram,Haryana,2023-10-01,2728,172,2556,173,5
Heat Stroke,Gurugram,Haryana,2023-11-01,901,0,901,138,4
Heat Stroke,Gurugram,Haryana,2023-12-01,192,16,176,110,6
Heat Stroke,Gurugram,Haryana,2024-01-01,2084,42,2042,75,5
Heat Stroke,Gurugram,Haryana,2024-02-01,2431,85,2346,39,3
Heat Stroke,Gurugram,Haryana,2024-03-01,2064,93,1971,100,4
Heat Stroke,Gurugram,Haryana,2024-04-01,1009,62,947,62,8
Heat Stroke,Gurugram,Haryana,2024-05-01,2061,141,1920,65,6
Heat Stroke,Gurugram,Haryana,2024-06-01,2959,225,2734,34,1
Heat Stroke,Gurugram,Haryana,2024-07-01,2537,187,2350,119,9
Heat Stroke,Gurugram,Haryana,2024-08-01,2842,163,2679,87,6
Heat Stroke,Gurugram,Haryana,2024-09-01,1698,105,1593,133,7
Heat Stroke,Gurugram,Haryana,2024-10-01,4169,76,4093,129,8
Heat Stroke,Gurugram,Haryana,2024-11-01,1020,28,992,118,8
Heat Stroke,Gurugram,Haryana,2024-12-01,3251,247,3004,200,2
Heat Stroke,Gurugram,Haryana,2025-01-01,4183,311,3872,148,2
Heat Stroke,Gurugram,Haryana,2025-02-01,3243,230,3013,42,10
Heat Stroke,Gurugram,Haryana,2025-03-01,2326,81,2245,130,3
Heat Stroke,Gurugram,Haryana,2025-04-01,1889,144,1745,103,6
Heat Stroke,Gurugram,Haryana,2025-05-01,3987,64,3923,38,10
Heat Stroke,Gurugram,Haryana,2025-06-01,688,56,632,34,4
Heat Stroke,Gurugram,Haryana,2025-07-01,1296,55,1241,129,4
Heat Stroke,Gurugram,Haryana,2025-08-01,2064,204,1860,142,8
Heat Stroke,Gurugram,Haryana,2025-09-01,4258,24,4234,53,5
Heat Stroke,Gurugram,Haryana,2025-10-01,3107,315,2792,156,6
Heat Stroke,Gurugram,Haryana,2025-11-01,1299,51,1248,121,5
Heat Stroke,Gurugram,Haryana,2025-12-01,2181,85,2096,167,3
Heat Stroke,Faridabad,Punjab,2018-01-01,1773,98,1675,162,4
Heat Stroke,Faridabad,Punjab,2018-02-01,1645,48,1597,98,8
Heat Stroke,Faridabad,Punjab,2018-03-01,3911,187,3724,190,4
Heat Stroke,Faridabad,Punjab,2018-04-01,757,21,736,49,6
Heat Stroke,Faridabad,Punjab,2018-05-01,4756,141,4615,200,2
Heat Stroke,Faridabad,Punjab,2018-06-01,3708,238,3470,61,10
Heat Stroke,Faridabad,Punjab,2018-07-01,4061,96,3965,104,6
Heat Stroke,Faridabad,Punjab,2018-08-01,1976,54,1922,77,6
Heat Stroke,Faridabad,Punjab,2018-09-01,2396,24,2372,87,8
Heat Stroke,Faridabad,Punjab,2018-10-01,675,23,652,200,3
Heat Stroke,Faridabad,Punjab,2018-11-01,1894,167,1727,83,8
Heat Stroke,Faridabad,Punjab,2018-12-01,3260,82,3178,150,1
Heat Stroke,Faridabad,Punjab,2019-01-01,4336,124,4212,94,3
Heat Stroke,Faridabad,Punjab,2019-02-01,1112,61,1051,154,2
Heat Stroke,Faridabad,Punjab,2019-03-01,2107,82,2025,78,1
Heat Stroke,Faridabad,Punjab,2019-04-01,2394,275,2119,119,3
Heat Stroke,Faridabad,Punjab,2019-05-01,725,32,693,138,5
Heat Stroke,Faridabad,Punjab,2019-06-01,3391,202,3189,69,2
Heat Stroke,Faridabad,Punjab,2019-07-01,1626,126,1500,200,1
Heat Stroke,Faridabad,Punjab,2019-08-01,2335,179,2156,141,5
Heat Stroke,Faridabad,Punjab,2019-09-01,1991,113,1878,95,5
Heat Stroke,Faridabad,Punjab,2019-10-01,1539,69,1470,71,4
Heat Stroke,Faridabad,Punjab,2019-11-01,2588,282,2306,111,1
Heat Stroke,Faridabad,Punjab,2019-12-01,2308,108,2200,44,4
Heat Stroke,Faridabad,Punjab,2020-01-01,2099,78,2021,197,3
Heat Stroke,Faridabad,Punjab,2020-02-01,1620,50,1570,128,5
Heat Stroke,Faridabad,Punjab,2020-03-01,3026,0,3026,102,3
Heat Stroke,Faridabad,Punjab,2020-04-01,4816,356,4460,159,5
Heat Stroke,Faridabad,Punjab,2020-05-01,2785,0,2785,69,1
Heat Stroke,Faridabad,Punjab,2020-06-01,3934,196,3738,47,1
Heat Stroke,Faridabad,Punjab,2020-07-01,732,32,700,100,6
Heat Stroke,Faridabad,Punjab,2020-08-01,2809,323,2486,113,7
Heat Stroke,Faridabad,Punjab,2020-09-01,1125,0,1125,133,4
Heat Stroke,Faridabad,Punjab,2020-10-01,616,14,602,31,5
Heat Stroke,Faridabad,Punjab,2020-11-01,1606,74,1532,83,4
Heat Stroke,Faridabad,Punjab,2020-12-01,4196,185,4011,11,8
Heat Stroke,Faridabad,Punjab,2021-01-01,3872,131,3741,46,4
Heat Stroke,Faridabad,Punjab,2021-02-01,2923,139,2784,143,3
Heat Stroke,Faridabad,Punjab,2021-03-01,541,7,534,155,8
Heat Stroke,Faridabad,Punjab,2021-04-01,2334,141,2193,48,3
Heat Stroke,Faridabad,Punjab,2021-05-01,3002,0,3002,90,5
Heat Stroke,Faridabad,Punjab,2021-06-01,2833,139,2694,108,2
Heat Stroke,Faridabad,Punjab,2021-07-01,124,4,120,161,7
Heat Stroke,Faridabad,Punjab,2021-08-01,1403,111,1292,184,7
Heat Stroke,Faridabad,Punjab,2021-09-01,2511,254,2257,114,1
Heat Stroke,Faridabad,Punjab,2021-10-01,3317,134,3183,93,1
Heat Stroke,Faridabad,Punjab,2021-11-01,78,0,78,33,6
Heat Stroke,Faridabad,Punjab,2021-12-01,2380,97,2283,112,10
Heat Stroke,Faridabad,Punjab,2022-01-01,2789,61,2728,200,7
Heat Stroke,Faridabad,Punjab,2022-02-01,3737,377,3360,172,4
Heat Stroke,Faridabad,Punjab,2022-03-01,3527,230,3297,115,2
Heat Stroke,Faridabad,Punjab,2022-04-01,3379,169,3210,122,1
Heat Stroke,Faridabad,Punjab,2022-05-01,1524,106,1418,71,7
Heat Stroke,Faridabad,Punjab,2022-06-01,78,0,78,88,8
Heat Stroke,Faridabad,Punjab,2022-07-01,2070,99,1971,114,3
Heat Stroke,Faridabad,Punjab,2022-08-01,3941,45,3896,114,4
Heat Stroke,Faridabad,Punjab,2022-09-01,4467,188,4279,158,5
Heat Stroke,Faridabad,Punjab,2022-10-01,3551,242,3309,155,10
Heat Stroke,Faridabad,Punjab,2022-11-01,3173,147,3026,133,5
Heat Stroke,Faridabad,Punjab,2022-12-01,3107,237,2870,55,2
Heat Stroke,Faridabad,Punjab,2023-01-01,1851,113,1738,57,1
Heat Stroke,Faridabad,Punjab,2023-02-01,2423,59,2364,61,2
Heat Stroke,Faridabad,Punjab,2023-03-01,4836,56,4780,118,8
Heat Stroke,Faridabad,Punjab,2023-04-01,1333,60,1273,11,6
Heat Stroke,Faridabad,Punjab,2023-05-01,4764,165,4599,106,4
Heat Stroke,Faridabad,Punjab,2023-06-01,2165,129,2036,178,1
Heat Stroke,Faridabad,Punjab,2023-07-01,4375,127,4248,140,2
Heat Stroke,Faridabad,Punjab,2023-08-01,710,22,688,88,6
Heat Stroke,Faridabad,Punjab,2023-09-01,3383,273,3110,71,6
Heat Stroke,Faridabad,Punjab,2023-10-01,1609,87,1522,147,6
Heat Stroke,Faridabad,Punjab,2023-11-01,699,20,679,122,1
Heat Stroke,Faridabad,Punjab,2023-12-01,2891,146,2745,94,5
Heat Stroke,Faridabad,Punjab,2024-01-01,3952,356,3596,76,2
Heat Stroke,Faridabad,Punjab,2024-02-01,1464,85,1379,110,5
Heat Stroke,Faridabad,Punjab,2024-03-01,586,39,547,91,3
Heat Stroke,Faridabad,Punjab,2024-04-01,2474,69,2405,146,8
Heat Stroke,Faridabad,Punjab,2024-05-01,2480,198,2282,169,6
Heat Stroke,Faridabad,Punjab,2024-06-01,3333,391,2942,37,4
Heat Stroke,Faridabad,Punjab,2024-07-01,3871,104,3767,44,9
Heat Stroke,Faridabad,Punjab,2024-08-01,2518,39,2479,175,4
Heat Stroke,Faridabad,Punjab,2024-09-01,4989,275,4714,115,1
Heat Stroke,Faridabad,Punjab,2024-10-01,2898,218,2680,49,8
Heat Stroke,Faridabad,Punjab,2024-11-01,2133,101,2032,156,6
Heat Stroke,Faridabad,Punjab,2024-12-01,435,8,427,124,4
Heat Stroke,Faridabad,Punjab,2025-01-01,2245,105,2140,200,3
Heat Stroke,Faridabad,Punjab,2025-02-01,2146,144,2002,94,6
Heat Stroke,Faridabad,Punjab,2025-03-01,3886,148,3738,163,7
Heat Stroke,Faridabad,Punjab,2025-04-01,3218,218,3000,32,3
Heat Stroke,Faridabad,Punjab,2025-05-01,1015,85,930,177,6
Heat Stroke,Faridabad,Punjab,2025-06-01,2828,161,2667,154,6
Heat Stroke,Faridabad,Punjab,2025-07-01,3498,172,3326,188,2
Heat Stroke,Faridabad,Punjab,2025-08-01,4647,344,4303,163,5
Heat Stroke,Faridabad,Punjab,2025-09-01,3788,95,3693,101,3
Heat Stroke,Faridabad,Punjab,2025-10-01,3618,80,3538,47,8
Heat Stroke,Faridabad,Punjab,2025-11-01,2678,113,2565,76,3
Heat Stroke,Faridabad,Punjab,2025-12-01,3118,111,3007,16,9
Heat Stroke,Faridabad,Chandigarh,2018-01-01,4274,114,4160,59,5
Heat Stroke,Faridabad,Chandigarh,2018-02-01,809,83,726,128,1
Heat Stroke,Faridabad,Chandigarh,2018-03-01,2129,241,1888,104,1
Heat Stroke,Faridabad,Chandigarh,2018-04-01,1561,62,1499,95,4
Heat Stroke,Faridabad,Chandigarh,2018-05-01,3106,163,2943,66,9
Heat Stroke,Faridabad,Chandigarh,2018-06-01,4248,189,4059,16,8
Heat Stroke,Faridabad,Chandigarh,2018-07-01,1797,147,1650,115,5
Heat Stroke,Faridabad,Chandigarh,2018-08-01,78,0,78,126,3
Heat Stroke,Faridabad,Chandigarh,2018-09-01,2044,0,2044,56,4
Heat Stroke,Faridabad,Chandigarh,2018-10-01,3823,244,3579,79,5
Heat Stroke,Faridabad,Chandigarh,2018-11-01,3319,39,3280,185,8
Heat Stroke,Faridabad,Chandigarh,2018-12-01,3172,321,2851,165,6
Heat Stroke,Faridabad,Chandigarh,2019-01-01,2222,139,2083,31,8
Heat Stroke,Faridabad,Chandigarh,2019-02-01,882,23,859,102,7
Heat Stroke,Faridabad,Chandigarh,2019-03-01,3289,141,3148,180,8
Heat Stroke,Faridabad,Chandigarh,2019-04-01,1478,61,1417,95,1
Heat Stroke,Faridabad,Chandigarh,2019-05-01,4989,326,4663,93,2
Heat Stroke,Faridabad,Chandigarh,2019-06-01,3363,270,3093,162,2
Heat Stroke,Faridabad,Chandigarh,2019-07-01,1818,30,1788,156,1
Heat Stroke,Faridabad,Chandigarh,2019-08-01,1777,184,1593,154,5
Heat Stroke,Faridabad,Chandigarh,2019-09-01,2473,239,2234,93,1
Heat Stroke,Faridabad,Chandigarh,2019-10-01,2276,55,2221,140,2
Heat Stroke,Faridabad,Chandigarh,2019-11-01,4096,213,3883,182,5
Heat Stroke,Faridabad,Chandigarh,2019-12-01,2847,284,2563,104,1
Heat Stroke,Faridabad,Chandigarh,2020-01-01,1616,138,1478,86,3
Heat Stroke,Faridabad,Chandigarh,2020-02-01,4989,200,4789,169,7
Heat Stroke,Faridabad,Chandigarh,2020-03-01,2664,196,2468,200,1
Heat Stroke,Faridabad,Chandigarh,2020-04-01,3629,442,3187,200,7
Heat Stroke,Faridabad,Chandigarh,2020-05-01,1781,94,1687,87,2
Heat Stroke,Faridabad,Chandigarh,2020-06-01,3085,97,2988,92,6
Heat Stroke,Faridabad,Chandigarh,2020-07-01,3015,166,2849,54,2
Heat Stroke,Faridabad,Chandigarh,2020-08-01,78,0,78,112,6
Heat Stroke,Faridabad,Chandigarh,2020-09-01,4989,173,4816,51,4
Heat Stroke,Faridabad,Chandigarh,2020-10-01,4329,272,4057,79,6
Heat Stroke,Faridabad,Chandigarh,2020-11-01,2065,28,2037,142,3
Heat Stroke,Faridabad,Chandigarh,2020-12-01,1119,34,1085,126,6
Heat Stroke,Faridabad,Chandigarh,2021-01-01,3064,221,2843,14,7
Heat Stroke,Faridabad,Chandigarh,2021-02-01,2714,0,2714,186,5
Heat Stroke,Faridabad,Chandigarh,2021-03-01,3075,234,2841,51,3
Heat Stroke,Faridabad,Chandigarh,2021-04-01,2854,0,2854,57,4
Heat Stroke,Faridabad,Chandigarh,2021-05-01,3277,0,3277,43,1
Heat Stroke,Faridabad,Chandigarh,2021-06-01,4539,161,4378,73,5
Heat Stroke,Faridabad,Chandigarh,2021-07-01,3360,196,3164,61,7
Heat Stroke,Faridabad,Chandigarh,2021-08-01,1189,105,1084,62,9
Heat Stroke,Faridabad,Chandigarh,2021-09-01,4425,228,4197,11,9
Heat Stroke,Faridabad,Chandigarh,2021-10-01,4798,205,4593,113,2
Heat Stroke,Faridabad,Chandigarh,2021-11-01,4989,333,4656,118,5
Heat Stroke,Faridabad,Chandigarh,2021-12-01,1090,26,1064,200,4
Heat Stroke,Faridabad,Chandigarh,2022-01-01,2923,158,2765,131,8
Heat Stroke,Faridabad,Chandigarh,2022-02-01,78,0,78,81,3
Heat Stroke,Faridabad,Chandigarh,2022-03-01,3339,175,3164,45,7
Heat Stroke,Faridabad,Chandigarh,2022-04-01,1862,86,1776,101,2
Heat Stroke,Faridabad,Chandigarh,2022-05-01,4989,133,4856,129,5
Heat Stroke,Faridabad,Chandigarh,2022-06-01,1558,85,1473,81,2
Heat Stroke,Faridabad,Chandigarh,2022-07-01,331,18,313,109,1
Heat Stroke,Faridabad,Chandigarh,2022-08-01,1965,165,1800,200,2
Heat Stroke,Faridabad,Chandigarh,2022-09-01,78,0,78,87,4
Heat Stroke,Faridabad,Chandigarh,2022-10-01,3605,172,3433,11,9
Heat Stroke,Faridabad,Chandigarh,2022-11-01,78,0,78,151,2
Heat Stroke,Faridabad,Chandigarh,2022-12-01,2636,198,2438,122,3
Heat Stroke,Faridabad,Chandigarh,2023-01-01,78,0,78,19,1
Heat Stroke,Faridabad,Chandigarh,2023-02-01,2168,140,2028,128,8
Heat Stroke,Faridabad,Chandigarh,2023-03-01,4802,142,4660,55,3
Heat Stroke,Faridabad,Chandigarh,2023-04-01,3081,233,2848,129,4
Heat Stroke,Faridabad,Chandigarh,2023-05-01,1439,7,1432,200,4
Heat Stroke,Faridabad,Chandigarh,2023-06-01,2556,0,2556,97,1
Heat Stroke,Faridabad,Chandigarh,2023-07-01,2622,33,2589,161,1
Heat Stroke,Faridabad,Chandigarh,2023-08-01,3231,158,3073,44,2
Heat Stroke,Faridabad,Chandigarh,2023-09-01,764,53,711,29,7
Heat Stroke,Faridabad,Chandigarh,2023-10-01,3392,0,3392,200,1
Heat Stroke,Faridabad,Chandigarh,2023-11-01,78,0,78,122,6
Heat Stroke,Faridabad,Chandigarh,2023-12-01,1752,94,1658,139,6
Heat Stroke,Faridabad,Chandigarh,2024-01-01,1942,8,1934,165,1
Heat Stroke,Faridabad,Chandigarh,2024-02-01,3447,182,3265,79,4
Heat Stroke,Faridabad,Chandigarh,2024-03-01,2628,215,2413,148,8
Heat Stroke,Faridabad,Chandigarh,2024-04-01,712,48,664,141,2
Heat Stroke,Faridabad,Chandigarh,2024-05-01,1276,104,1172,40,3
Heat Stroke,Faridabad,Chandigarh,2024-06-01,2864,29,2835,183,10
Heat Stroke,Faridabad,Chandigarh,2024-07-01,2491,94,2397,173,6
Heat Stroke,Faridabad,Chandigarh,2024-08-01,1821,42,1779,41,4
Heat Stroke,Faridabad,Chandigarh,2024-09-01,1952,195,1757,116,3
Heat Stroke,Faridabad,Chandigarh,2024-10-01,3531,242,3289,94,6
Heat Stroke,Faridabad,Chandigarh,2024-11-01,1903,252,1651,178,7
Heat Stroke,Faridabad,Chandigarh,2024-12-01,2479,90,2389,34,1
Heat Stroke,Faridabad,Chandigarh,2025-01-01,4989,144,4845,200,1
Heat Stroke,Faridabad,Chandigarh,2025-02-01,688,31,657,97,2
Heat Stroke,Faridabad,Chandigarh,2025-03-01,113,10,103,144,4
Heat Stroke,Faridabad,Chandigarh,2025-04-01,3649,143,3506,177,5
Heat Stroke,Faridabad,Chandigarh,2025-05-01,1687,90,1597,96,1
Heat Stroke,Faridabad,Chandigarh,2025-06-01,2170,114,2056,100,4
Heat Stroke,Faridabad,Chandigarh,2025-07-01,1549,79,1470,81,5
Heat Stroke,Faridabad,Chandigarh,2025-08-01,2249,69,2180,61,2
Heat Stroke,Faridabad,Chandigarh,2025-09-01,4742,218,4524,120,3
Heat Stroke,Faridabad,Chandigarh,2025-10-01,3673,164,3509,99,3
Heat Stroke,Faridabad,Chandigarh,2025-11-01,3754,187,3567,80,6
Heat Stroke,Faridabad,Chandigarh,2025-12-01,698,54,644,83,5
Heat Stroke,Faridabad,Himachal Pradesh,2018-01-01,1053,106,947,136,2
Heat Stroke,Faridabad,Himachal Pradesh,2018-02-01,78,0,78,66,8
Heat Stroke,Faridabad,Himachal Pradesh,2018-03-01,1512,58,1454,94,1
Heat Stroke,Faridabad,Himachal Pradesh,2018-04-01,3881,101,3780,152,1
Heat Stroke,Faridabad,Himachal Pradesh,2018-05-01,3291,182,3109,119,4
Heat Stroke,Faridabad,Himachal Pradesh,2018-06-01,2300,79,2221,53,4
Heat Stroke,Faridabad,Himachal Pradesh,2018-07-01,2567,146,2421,105,5
Heat Stroke,Faridabad,Himachal Pradesh,2018-08-01,1673,137,1536,128,1
Heat Stroke,Faridabad,Himachal Pradesh,2018-09-01,2872,0,2872,157,7
Heat Stroke,Faridabad,Himachal Pradesh,2018-10-01,3625,233,3392,68,10
Heat Stroke,Faridabad,Himachal Pradesh,2018-11-01,430,15,415,78,5
Heat Stroke,Faridabad,Himachal Pradesh,2018-12-01,2999,190,2809,71,6
Heat Stroke,Faridabad,Himachal Pradesh,2019-01-01,3848,92,3756,73,1
Heat Stroke,Faridabad,Himachal Pradesh,2019-02-01,2041,173,1868,127,4
Heat Stroke,Faridabad,Himachal Pradesh,2019-03-01,3537,271,3266,136,3
Heat Stroke,Faridabad,Himachal Pradesh,2019-04-01,4989,332,4657,160,2
Heat Stroke,Faridabad,Himachal Pradesh,2019-05-01,2457,179,2278,102,3
Heat Stroke,Faridabad,Himachal Pradesh,2019-06-01,3125,88,3037,35,3
Heat Stroke,Faridabad,Himachal Pradesh,2019-07-01,1607,51,1556,140,1
Heat Stroke,Faridabad,Himachal Pradesh,2019-08-01,2841,204,2637,114,3
Heat Stroke,Faridabad,Himachal Pradesh,2019-09-01,3215,89,3126,109,2
Heat Stroke,Faridabad,Himachal Pradesh,2019-10-01,2859,263,2596,41,7
Heat Stroke,Faridabad,Himachal Pradesh,2019-11-01,1229,49,1180,96,6
Heat Stroke,Faridabad,Himachal Pradesh,2019-12-01,2874,185,2689,45,6
Heat Stroke,Faridabad,Himachal Pradesh,2020-01-01,4559,442,4117,131,8
Heat Stroke,Faridabad,Himachal Pradesh,2020-02-01,3199,94,3105,84,2
Heat Stroke,Faridabad,Himachal Pradesh,2020-03-01,3888,202,3686,80,6
Heat Stroke,Faridabad,Himachal Pradesh,2020-04-01,2279,184,2095,28,8
Heat Stroke,Faridabad,Himachal Pradesh,2020-05-01,3603,280,3323,159,2
Heat Stroke,Faridabad,Himachal Pradesh,2020-06-01,2972,120,2852,93,1
Heat Stroke,Faridabad,Himachal Pradesh,2020-07-01,1322,46,1276,111,3
Heat Stroke,Faridabad,Himachal Pradesh,2020-08-01,3025,130,2895,69,8
Heat Stroke,Faridabad,Himachal Pradesh,2020-09-01,1267,116,1151,22,2
Heat Stroke,Faridabad,Himachal Pradesh,2020-10-01,1748,73,1675,79,3
Heat Stroke,Faridabad,Himachal Pradesh,2020-11-01,2851,149,2702,87,3
Heat Stroke,Faridabad,Himachal Pradesh,2020-12-01,2996,112,2884,121,4
Heat Stroke,Faridabad,Himachal Pradesh,2021-01-01,1002,70,932,88,2
Heat Stroke,Faridabad,Himachal Pradesh,2021-02-01,4011,218,3793,70,1
Heat Stroke,Faridabad,Himachal Pradesh,2021-03-01,3365,70,3295,30,4
Heat Stroke,Faridabad,Himachal Pradesh,2021-04-01,1652,36,1616,109,4
Heat Stroke,Faridabad,Himachal Pradesh,2021-05-01,535,0,535,66,8
Heat Stroke,Faridabad,Himachal Pradesh,2021-06-01,2403,62,2341,174,5
Heat Stroke,Faridabad,Himachal Pradesh,2021-07-01,1999,146,1853,114,1
Heat Stroke,Faridabad,Himachal Pradesh,2021-08-01,2749,243,2506,135,3
Heat Stroke,Faridabad,Himachal Pradesh,2021-09-01,2110,147,1963,94,7
Heat Stroke,Faridabad,Himachal Pradesh,2021-10-01,78,0,78,116,4
Heat Stroke,Faridabad,Himachal Pradesh,2021-11-01,2076,96,1980,61,2
Heat Stroke,Faridabad,Himachal Pradesh,2021-12-01,2187,158,2029,46,5
Heat Stroke,Faridabad,Himachal Pradesh,2022-01-01,3447,201,3246,107,3
Heat Stroke,Faridabad,Himachal Pradesh,2022-02-01,1661,170,1491,135,6
Heat Stroke,Faridabad,Himachal Pradesh,2022-03-01,4849,228,4621,11,6
Heat Stroke,Faridabad,Himachal Pradesh,2022-04-01,78,0,78,81,1
Heat Stroke,Faridabad,Himachal Pradesh,2022-05-01,4356,328,4028,200,10
Heat Stroke,Faridabad,Himachal Pradesh,2022-06-01,2296,164,2132,131,4
Heat Stroke,Faridabad,Himachal Pradesh,2022-07-01,3751,0,3751,185,1
Heat Stroke,Faridabad,Himachal Pradesh,2022-08-01,2704,208,2496,74,6
Heat Stroke,Faridabad,Himachal Pradesh,2022-09-01,4126,191,3935,83,1
Heat Stroke,Faridabad,Himachal Pradesh,2022-10-01,2078,77,2001,155,8
Heat Stroke,Faridabad,Himachal Pradesh,2022-11-01,1124,7,1117,138,5
Heat Stroke,Faridabad,Himachal Pradesh,2022-12-01,4503,224,4279,101,4
Heat Stroke,Faridabad,Himachal Pradesh,2023-01-01,2445,124,2321,42,5
Heat Stroke,Faridabad,Himachal Pradesh,2023-02-01,2895,35,2860,165,6
Heat Stroke,Faridabad,Himachal Pradesh,2023-03-01,4254,30,4224,200,3
Heat Stroke,Faridabad,Himachal Pradesh,2023-04-01,1213,77,1136,26,5
Heat Stroke,Faridabad,Himachal Pradesh,2023-05-01,3396,256,3140,178,5
Heat Stroke,Faridabad,Himachal Pradesh,2023-06-01,1806,100,1706,82,1
Heat Stroke,Faridabad,Himachal Pradesh,2023-07-01,2420,202,2218,89,6
Heat Stroke,Faridabad,Himachal Pradesh,2023-08-01,2694,128,2566,120,7
Heat Stroke,Faridabad,Himachal Pradesh,2023-09-01,585,28,557,45,6
Heat Stroke,Faridabad,Himachal Pradesh,2023-10-01,1553,36,1517,104,6
Heat Stroke,Faridabad,Himachal Pradesh,2023-11-01,4410,20,4390,24,9
Heat Stroke,Faridabad,Himachal Pradesh,2023-12-01,3786,393,3393,130,4
Heat Stroke,Faridabad,Himachal Pradesh,2024-01-01,2513,208,2305,200,5
Heat Stroke,Faridabad,Himachal Pradesh,2024-02-01,2924,27,2897,74,3
Heat Stroke,Faridabad,Himachal Pradesh,2024-03-01,2203,120,2083,98,1
Heat Stroke,Faridabad,Himachal Pradesh,2024-04-01,4417,208,4209,100,6
Heat Stroke,Faridabad,Himachal Pradesh,2024-05-01,2329,98,2231,156,3
Heat Stroke,Faridabad,Himachal Pradesh,2024-06-01,2908,110,2798,127,1
Heat Stroke,Faridabad,Himachal Pradesh,2024-07-01,4135,252,3883,153,4
Heat Stroke,Faridabad,Himachal Pradesh,2024-08-01,1555,114,1441,80,4
Heat Stroke,Faridabad,Himachal Pradesh,2024-09-01,4689,289,4400,128,4
Heat Stroke,Faridabad,Himachal Pradesh,2024-10-01,544,25,519,11,5
Heat Stroke,Faridabad,Himachal Pradesh,2024-11-01,4784,217,4567,140,1
Heat Stroke,Faridabad,Himachal Pradesh,2024-12-01,2097,162,1935,44,7
Heat Stroke,Faridabad,Himachal Pradesh,2025-01-01,2272,144,2128,90,6
Heat Stroke,Faridabad,Himachal Pradesh,2025-02-01,78,0,78,144,8
Heat Stroke,Faridabad,Himachal Pradesh,2025-03-01,1987,97,1890,28,3
Heat Stroke,Faridabad,Himachal Pradesh,2025-04-01,1202,72,1130,162,6
Heat Stroke,Faridabad,Himachal Pradesh,2025-05-01,1782,64,1718,100,1
Heat Stroke,Faridabad,Himachal Pradesh,2025-06-01,2413,178,2235,180,2
Heat Stroke,Faridabad,Himachal Pradesh,2025-07-01,3882,72,3810,60,1
Heat Stroke,Faridabad,Himachal Pradesh,2025-08-01,2876,109,2767,14,5
Heat Stroke,Faridabad,Himachal Pradesh,2025-09-01,3010,204,2806,105,1
Heat Stroke,Faridabad,Himachal Pradesh,2025-10-01,1128,19,1109,136,3
Heat Stroke,Faridabad,Himachal Pradesh,2025-11-01,1416,6,1410,140,5
Heat Stroke,Faridabad,Himachal Pradesh,2025-12-01,4989,258,4731,48,3
Heat Stroke,Faridabad,Jammu & Kashmir,2018-01-01,1611,1,1610,23,1
Heat Stroke,Faridabad,Jammu & Kashmir,2018-02-01,4819,59,4760,90,9
Heat Stroke,Faridabad,Jammu & Kashmir,2018-03-01,2271,163,2108,133,5
Heat Stroke,Faridabad,Jammu & Kashmir,2018-04-01,2600,114,2486,130,9
Heat Stroke,Faridabad,Jammu & Kashmir,2018-05-01,4033,352,3681,186,2
Heat Stroke,Faridabad,Jammu & Kashmir,2018-06-01,4304,64,4240,87,3
Heat Stroke,Faridabad,Jammu & Kashmir,2018-07-01,2449,115,2334,12,5
Heat Stroke,Faridabad,Jammu & Kashmir,2018-08-01,2077,128,1949,167,9
Heat Stroke,Faridabad,Jammu & Kashmir,2018-09-01,2522,40,2482,116,9
Heat Stroke,Faridabad,Jammu & Kashmir,2018-10-01,3051,244,2807,121,3
Heat Stroke,Faridabad,Jammu & Kashmir,2018-11-01,3793,246,3547,145,2
Heat Stroke,Faridabad,Jammu & Kashmir,2018-12-01,2603,8,2595,171,5
Heat Stroke,Faridabad,Jammu & Kashmir,2019-01-01,3428,167,3261,105,8
Heat Stroke,Faridabad,Jammu & Kashmir,2019-02-01,4795,293,4502,166,5
Heat Stroke,Faridabad,Jammu & Kashmir,2019-03-01,3109,102,3007,134,5
Heat Stroke,Faridabad,Jammu & Kashmir,2019-04-01,3015,21,2994,73,8
Heat Stroke,Faridabad,Jammu & Kashmir,2019-05-01,560,32,528,94,8
Heat Stroke,Faridabad,Jammu & Kashmir,2019-06-01,78,0,78,138,8
Heat Stroke,Faridabad,Jammu & Kashmir,2019-07-01,3118,121,2997,70,7
Heat Stroke,Faridabad,Jammu & Kashmir,2019-08-01,2470,236,2234,151,9
Heat Stroke,Faridabad,Jammu & Kashmir,2019-09-01,1907,53,1854,114,1
Heat Stroke,Faridabad,Jammu & Kashmir,2019-10-01,2924,164,2760,126,10
Heat Stroke,Faridabad,Jammu & Kashmir,2019-11-01,2516,182,2334,180,8
Heat Stroke,Faridabad,Jammu & Kashmir,2019-12-01,4110,204,3906,124,4
Heat Stroke,Faridabad,Jammu & Kashmir,2020-01-01,2713,112,2601,110,8
Heat Stroke,Faridabad,Jammu & Kashmir,2020-02-01,1595,113,1482,102,4
Heat Stroke,Faridabad,Jammu & Kashmir,2020-03-01,3926,412,3514,99,6
Heat Stroke,Faridabad,Jammu & Kashmir,2020-04-01,2306,135,2171,122,7
Heat Stroke,Faridabad,Jammu & Kashmir,2020-05-01,3304,115,3189,176,7
Heat Stroke,Faridabad,Jammu & Kashmir,2020-06-01,1957,87,1870,75,3
Heat Stroke,Faridabad,Jammu & Kashmir,2020-07-01,1726,212,1514,71,7
Heat Stroke,Faridabad,Jammu & Kashmir,2020-08-01,2710,146,2564,172,4
Heat Stroke,Faridabad,Jammu & Kashmir,2020-09-01,2615,85,2530,77,7
Heat Stroke,Faridabad,Jammu & Kashmir,2020-10-01,3241,54,3187,117,5
Heat Stroke,Faridabad,Jammu & Kashmir,2020-11-01,2237,0,2237,76,1
Heat Stroke,Faridabad,Jammu & Kashmir,2020-12-01,134,8,126,21,3
Heat Stroke,Faridabad,Jammu & Kashmir,2021-01-01,2017,139,1878,116,7
Heat Stroke,Faridabad,Jammu & Kashmir,2021-02-01,3662,141,3521,163,4
Heat Stroke,Faridabad,Jammu & Kashmir,2021-03-01,2198,109,2089,103,8
Heat Stroke,Faridabad,Jammu & Kashmir,2021-04-01,2267,36,2231,31,1
Heat Stroke,Faridabad,Jammu & Kashmir,2021-05-01,3921,211,3710,112,7
Heat Stroke,Faridabad,Jammu & Kashmir,2021-06-01,1642,105,1537,68,5
Heat Stroke,Faridabad,Jammu & Kashmir,2021-07-01,528,18,510,11,4
Heat Stroke,Faridabad,Jammu & Kashmir,2021-08-01,2382,236,2146,102,1
Heat Stroke,Faridabad,Jammu & Kashmir,2021-09-01,1948,50,1898,133,5
Heat Stroke,Faridabad,Jammu & Kashmir,2021-10-01,1301,75,1226,166,2
Heat Stroke,Faridabad,Jammu & Kashmir,2021-11-01,2362,176,2186,196,3
Heat Stroke,Faridabad,Jammu & Kashmir,2021-12-01,3257,155,3102,139,4
Heat Stroke,Faridabad,Jammu & Kashmir,2022-01-01,2585,115,2470,154,4
Heat Stroke,Faridabad,Jammu & Kashmir,2022-02-01,3009,25,2984,41,8
Heat Stroke,Faridabad,Jammu & Kashmir,2022-03-01,4989,442,4547,189,1
Heat Stroke,Faridabad,Jammu & Kashmir,2022-04-01,2137,96,2041,171,4
Heat Stroke,Faridabad,Jammu & Kashmir,2022-05-01,2971,195,2776,88,4
Heat Stroke,Faridabad,Jammu & Kashmir,2022-06-01,1914,133,1781,141,5
Heat Stroke,Faridabad,Jammu & Kashmir,2022-07-01,1462,46,1416,136,3
Heat Stroke,Faridabad,Jammu & Kashmir,2022-08-01,1813,80,1733,181,8
Heat Stroke,Faridabad,Jammu & Kashmir,2022-09-01,1955,173,1782,99,4
Heat Stroke,Faridabad,Jammu & Kashmir,2022-10-01,3080,54,3026,68,5
Heat Stroke,Faridabad,Jammu & Kashmir,2022-11-01,4989,442,4547,81,7
Heat Stroke,Faridabad,Jammu & Kashmir,2022-12-01,1637,46,1591,152,5
Heat Stroke,Faridabad,Jammu & Kashmir,2023-01-01,2038,32,2006,11,1
Heat Stroke,Faridabad,Jammu & Kashmir,2023-02-01,2513,135,2378,11,4
Heat Stroke,Faridabad,Jammu & Kashmir,2023-03-01,3128,357,2771,152,4
Heat Stroke,Faridabad,Jammu & Kashmir,2023-04-01,2951,0,2951,120,1
Heat Stroke,Faridabad,Jammu & Kashmir,2023-05-01,4320,198,4122,107,3
Heat Stroke,Faridabad,Jammu & Kashmir,2023-06-01,78,0,78,40,5
Heat Stroke,Faridabad,Jammu & Kashmir,2023-07-01,78,0,78,19,10
Heat Stroke,Faridabad,Jammu & Kashmir,2023-08-01,1932,118,1814,74,6
Heat Stroke,Faridabad,Jammu & Kashmir,2023-09-01,4069,118,3951,125,5
Heat Stroke,Faridabad,Jammu & Kashmir,2023-10-01,497,16,481,76,10
Heat Stroke,Faridabad,Jammu & Kashmir,2023-11-01,78,0,78,152,7
Heat Stroke,Faridabad,Jammu & Kashmir,2023-12-01,3364,57,3307,58,7
Heat Stroke,Faridabad,Jammu & Kashmir,2024-01-01,2924,142,2782,80,4
Heat Stroke,Faridabad,Jammu & Kashmir,2024-02-01,1135,43,1092,142,1
Heat Stroke,Faridabad,Jammu & Kashmir,2024-03-01,1275,46,1229,87,6
Heat Stroke,Faridabad,Jammu & Kashmir,2024-04-01,1296,76,1220,90,10
Heat Stroke,Faridabad,Jammu & Kashmir,2024-05-01,2746,0,2746,73,9
Heat Stroke,Faridabad,Jammu & Kashmir,2024-06-01,1757,76,1681,64,7
Heat Stroke,Faridabad,Jammu & Kashmir,2024-07-01,3260,383,2877,124,3
Heat Stroke,Faridabad,Jammu & Kashmir,2024-08-01,78,0,78,131,1
Heat Stroke,Faridabad,Jammu & Kashmir,2024-09-01,1448,126,1322,118,2
Heat Stroke,Faridabad,Jammu & Kashmir,2024-10-01,1087,56,1031,75,5
Heat Stroke,Faridabad,Jammu & Kashmir,2024-11-01,2254,73,2181,96,3
Heat Stroke,Faridabad,Jammu & Kashmir,2024-12-01,1876,21,1855,188,8
Heat Stroke,Faridabad,Jammu & Kashmir,2025-01-01,3668,198,3470,34,1
Heat Stroke,Faridabad,Jammu & Kashmir,2025-02-01,103,9,94,200,4
Heat Stroke,Faridabad,Jammu & Kashmir,2025-03-01,2658,102,2556,111,3
Heat Stroke,Faridabad,Jammu & Kashmir,2025-04-01,3346,159,3187,97,8
Heat Stroke,Faridabad,Jammu & Kashmir,2025-05-01,4989,396,4593,155,6
Heat Stroke,Faridabad,Jammu & Kashmir,2025-06-01,1951,117,1834,11,2
Heat Stroke,Faridabad,Jammu & Kashmir,2025-07-01,3033,13,3020,177,7
Heat Stroke,Faridabad,Jammu & Kashmir,2025-08-01,178,9,169,200,1
Heat Stroke,Faridabad,Jammu & Kashmir,2025-09-01,78,0,78,162,1
Heat Stroke,Faridabad,Jammu & Kashmir,2025-10-01,3731,182,3549,11,2
Heat Stroke,Faridabad,Jammu & Kashmir,2025-11-01,2590,0,2590,145,1
Heat Stroke,Faridabad,Jammu & Kashmir,2025-12-01,4178,256,3922,190,4
Heat Stroke,Faridabad,Haryana,2018-01-01,755,33,722,185,5
Heat Stroke,Faridabad,Haryana,2018-02-01,3295,0,3295,34,4
Heat Stroke,Faridabad,Haryana,2018-03-01,4989,20,4969,158,6
Heat Stroke,Faridabad,Haryana,2018-04-01,3160,247,2913,198,3
Heat Stroke,Faridabad,Haryana,2018-05-01,2968,85,2883,108,1
Heat Stroke,Faridabad,Haryana,2018-06-01,2609,61,2548,32,3
Heat Stroke,Faridabad,Haryana,2018-07-01,490,24,466,148,1
Heat Stroke,Faridabad,Haryana,2018-08-01,4416,138,4278,160,3
Heat Stroke,Faridabad,Haryana,2018-09-01,1778,94,1684,99,7
Heat Stroke,Faridabad,Haryana,2018-10-01,3274,144,3130,46,1
Heat Stroke,Faridabad,Haryana,2018-11-01,501,7,494,156,4
Heat Stroke,Faridabad,Haryana,2018-12-01,1015,35,980,67,8
Heat Stroke,Faridabad,Haryana,2019-01-01,4523,284,4239,126,8
Heat Stroke,Faridabad,Haryana,2019-02-01,2131,109,2022,186,3
Heat Stroke,Faridabad,Haryana,2019-03-01,4547,216,4331,22,10
Heat Stroke,Faridabad,Haryana,2019-04-01,2492,265,2227,152,2
Heat Stroke,Faridabad,Haryana,2019-05-01,126,8,118,96,4
Heat Stroke,Faridabad,Haryana,2019-06-01,3794,284,3510,97,1
Heat Stroke,Faridabad,Haryana,2019-07-01,1806,81,1725,132,6
Heat Stroke,Faridabad,Haryana,2019-08-01,3535,199,3336,67,10
Heat Stroke,Faridabad,Haryana,2019-09-01,2631,98,2533,46,10
Heat Stroke,Faridabad,Haryana,2019-10-01,527,38,489,15,7
Heat Stroke,Faridabad,Haryana,2019-11-01,2818,132,2686,169,3
Heat Stroke,Faridabad,Haryana,2019-12-01,4989,282,4707,87,4
Heat Stroke,Faridabad,Haryana,2020-01-01,3259,178,3081,135,8
Heat Stroke,Faridabad,Haryana,2020-02-01,2520,124,2396,81,7
Heat Stroke,Faridabad,Haryana,2020-03-01,4040,442,3598,47,5
Heat Stroke,Faridabad,Haryana,2020-04-01,2880,88,2792,139,5
Heat Stroke,Faridabad,Haryana,2020-05-01,2878,87,2791,123,8
Heat Stroke,Faridabad,Haryana,2020-06-01,1133,79,1054,94,9
Heat Stroke,Faridabad,Haryana,2020-07-01,2911,95,2816,122,1
Heat Stroke,Faridabad,Haryana,2020-08-01,3986,165,3821,57,5
Heat Stroke,Faridabad,Haryana,2020-09-01,1476,27,1449,160,6
Heat Stroke,Faridabad,Haryana,2020-10-01,4508,290,4218,172,3
Heat Stroke,Faridabad,Haryana,2020-11-01,2474,160,2314,145,9
Heat Stroke,Faridabad,Haryana,2020-12-01,1406,57,1349,87,4
Heat Stroke,Faridabad,Haryana,2021-01-01,3936,278,3658,109,9
Heat Stroke,Faridabad,Haryana,2021-02-01,2213,0,2213,186,4
Heat Stroke,Faridabad,Haryana,2021-03-01,3616,106,3510,171,6
Heat Stroke,Faridabad,Haryana,2021-04-01,2206,99,2107,200,6
Heat Stroke,Faridabad,Haryana,2021-05-01,2517,40,2477,66,10
Heat Stroke,Faridabad,Haryana,2021-06-01,3260,0,3260,62,7
Heat Stroke,Faridabad,Haryana,2021-07-01,2988,122,2866,113,3
Heat Stroke,Faridabad,Haryana,2021-08-01,78,0,78,127,4
Heat Stroke,Faridabad,Haryana,2021-09-01,1093,95,998,99,4
Heat Stroke,Faridabad,Haryana,2021-10-01,3844,131,3713,86,5
Heat Stroke,Faridabad,Haryana,2021-11-01,2420,172,2248,171,2
Heat Stroke,Faridabad,Haryana,2021-12-01,1895,129,1766,102,5
Heat Stroke,Faridabad,Haryana,2022-01-01,775,66,709,44,9
Heat Stroke,Faridabad,Haryana,2022-02-01,1149,45,1104,50,9
Heat Stroke,Faridabad,Haryana,2022-03-01,78,0,78,119,1
Heat Stroke,Faridabad,Haryana,2022-04-01,2462,128,2334,200,1
Heat Stroke,Faridabad,Haryana,2022-05-01,1795,36,1759,56,3
Heat Stroke,Faridabad,Haryana,2022-06-01,1301,37,1264,90,1
Heat Stroke,Faridabad,Haryana,2022-07-01,2506,103,2403,200,1
Heat Stroke,Faridabad,Haryana,2022-08-01,3086,124,2962,82,6
Heat Stroke,Faridabad,Haryana,2022-09-01,4989,270,4719,129,5
Heat Stroke,Faridabad,Haryana,2022-10-01,569,40,529,200,1
Heat Stroke,Faridabad,Haryana,2022-11-01,4153,163,3990,58,8
Heat Stroke,Faridabad,Haryana,2022-12-01,3903,240,3663,90,4
Heat Stroke,Faridabad,Haryana,2023-01-01,1552,78,1474,82,3
Heat Stroke,Faridabad,Haryana,2023-02-01,2870,221,2649,29,8
Heat Stroke,Faridabad,Haryana,2023-03-01,1983,88,1895,186,6
Heat Stroke,Faridabad,Haryana,2023-04-01,2847,136,2711,76,5
Heat Stroke,Faridabad,Haryana,2023-05-01,4622,181,4441,62,3
Heat Stroke,Faridabad,Haryana,2023-06-01,3410,154,3256,84,6
Heat Stroke,Faridabad,Haryana,2023-07-01,3280,89,3191,154,4
Heat Stroke,Faridabad,Haryana,2023-08-01,2020,49,1971,112,4
Heat Stroke,Faridabad,Haryana,2023-09-01,607,44,563,66,1
Heat Stroke,Faridabad,Haryana,2023-10-01,2318,42,2276,127,8
Heat Stroke,Faridabad,Haryana,2023-11-01,4216,171,4045,148,9
Heat Stroke,Faridabad,Haryana,2023-12-01,549,43,506,105,5
Heat Stroke,Faridabad,Haryana,2024-01-01,1182,47,1135,94,3
Heat Stroke,Faridabad,Haryana,2024-02-01,2767,205,2562,158,8
Heat Stroke,Faridabad,Haryana,2024-03-01,1276,41,1235,97,7
Heat Stroke,Faridabad,Haryana,2024-04-01,1534,29,1505,188,4
Heat Stroke,Faridabad,Haryana,2024-05-01,2029,7,2022,68,8
Heat Stroke,Faridabad,Haryana,2024-06-01,765,67,698,66,4
Heat Stroke,Faridabad,Haryana,2024-07-01,1291,21,1270,60,1
Heat Stroke,Faridabad,Haryana,2024-08-01,3541,254,3287,94,5
Heat Stroke,Faridabad,Haryana,2024-09-01,844,17,827,106,8
Heat Stroke,Faridabad,Haryana,2024-10-01,454,40,414,39,5
Heat Stroke,Faridabad,Haryana,2024-11-01,1752,200,1552,111,1
Heat Stroke,Faridabad,Haryana,2024-12-01,3579,3,3576,135,4
Heat Stroke,Faridabad,Haryana,2025-01-01,2333,43,2290,32,8
Heat Stroke,Faridabad,Haryana,2025-02-01,1974,143,1831,80,6
Heat Stroke,Faridabad,Haryana,2025-03-01,2657,172,2485,135,5
Heat Stroke,Faridabad,Haryana,2025-04-01,256,18,238,51,4
Heat Stroke,Faridabad,Haryana,2025-05-01,3261,108,3153,90,8
Heat Stroke,Faridabad,Haryana,2025-06-01,3112,335,2777,162,8
Heat Stroke,Faridabad,Haryana,2025-07-01,2048,109,1939,198,1
Heat Stroke,Faridabad,Haryana,2025-08-01,3947,57,3890,129,8
Heat Stroke,Faridabad,Haryana,2025-09-01,1085,46,1039,98,6
Heat Stroke,Faridabad,Haryana,2025-10-01,4111,61,4050,81,9
Heat Stroke,Faridabad,Haryana,2025-11-01,2805,270,2535,153,5
Heat Stroke,Faridabad,Haryana,2025-12-01,2146,66,2080,164,8
Heat Stroke,Panchkula,Punjab,2018-01-01,2571,165,2406,47,6
Heat Stroke,Panchkula,Punjab,2018-02-01,2454,89,2365,153,2
Heat Stroke,Panchkula,Punjab,2018-03-01,4234,136,4098,75,8
Heat Stroke,Panchkula,Punjab,2018-04-01,1153,0,1153,62,7
Heat Stroke,Panchkula,Punjab,2018-05-01,1574,106,1468,98,3
Heat Stroke,Panchkula,Punjab,2018-06-01,3988,350,3638,157,6
Heat Stroke,Panchkula,Punjab,2018-07-01,1798,42,1756,122,10
Heat Stroke,Panchkula,Punjab,2018-08-01,3805,19,3786,121,3
Heat Stroke,Panchkula,Punjab,2018-09-01,4877,358,4519,124,7
Heat Stroke,Panchkula,Punjab,2018-10-01,2058,4,2054,130,2
Heat Stroke,Panchkula,Punjab,2018-11-01,3511,300,3211,100,3
Heat Stroke,Panchkula,Punjab,2018-12-01,1050,24,1026,138,7
Heat Stroke,Panchkula,Punjab,2019-01-01,3610,64,3546,73,6
Heat Stroke,Panchkula,Punjab,2019-02-01,2865,164,2701,139,4
Heat Stroke,Panchkula,Punjab,2019-03-01,3232,64,3168,150,10
Heat Stroke,Panchkula,Punjab,2019-04-01,1731,51,1680,142,2
Heat Stroke,Panchkula,Punjab,2019-05-01,369,22,347,144,4
Heat Stroke,Panchkula,Punjab,2019-06-01,3273,0,3273,130,6
Heat Stroke,Panchkula,Punjab,2019-07-01,78,0,78,166,2
Heat Stroke,Panchkula,Punjab,2019-08-01,2172,111,2061,11,6
Heat Stroke,Panchkula,Punjab,2019-09-01,3860,48,3812,150,8
Heat Stroke,Panchkula,Punjab,2019-10-01,2855,58,2797,200,4
Heat Stroke,Panchkula,Punjab,2019-11-01,4989,393,4596,75,3
Heat Stroke,Panchkula,Punjab,2019-12-01,3973,268,3705,69,4
Heat Stroke,Panchkula,Punjab,2020-01-01,1720,155,1565,172,1
Heat Stroke,Panchkula,Punjab,2020-02-01,2634,79,2555,59,8
Heat Stroke,Panchkula,Punjab,2020-03-01,2534,148,2386,72,6
Heat Stroke,Panchkula,Punjab,2020-04-01,475,29,446,115,4
Heat Stroke,Panchkula,Punjab,2020-05-01,1336,93,1243,66,1
Heat Stroke,Panchkula,Punjab,2020-06-01,1845,152,1693,151,8
Heat Stroke,Panchkula,Punjab,2020-07-01,78,0,78,66,4
Heat Stroke,Panchkula,Punjab,2020-08-01,2661,124,2537,125,6
Heat Stroke,Panchkula,Punjab,2020-09-01,2263,73,2190,121,5
Heat Stroke,Panchkula,Punjab,2020-10-01,353,17,336,191,1
Heat Stroke,Panchkula,Punjab,2020-11-01,3140,221,2919,166,9
Heat Stroke,Panchkula,Punjab,2020-12-01,3558,6,3552,79,8
Heat Stroke,Panchkula,Punjab,2021-01-01,2902,239,2663,42,7
Heat Stroke,Panchkula,Punjab,2021-02-01,2163,36,2127,149,6
Heat Stroke,Panchkula,Punjab,2021-03-01,3391,139,3252,73,1
Heat Stroke,Panchkula,Punjab,2021-04-01,3510,302,3208,89,7
Heat Stroke,Panchkula,Punjab,2021-05-01,3010,179,2831,52,10
Heat Stroke,Panchkula,Punjab,2021-06-01,1491,89,1402,141,5
Heat Stroke,Panchkula,Punjab,2021-07-01,2968,46,2922,73,5
Heat Stroke,Panchkula,Punjab,2021-08-01,4201,82,4119,104,2
Heat Stroke,Panchkula,Punjab,2021-09-01,1797,139,1658,105,1
Heat Stroke,Panchkula,Punjab,2021-10-01,4989,164,4825,116,4
Heat Stroke,Panchkula,Punjab,2021-11-01,1892,67,1825,140,9
Heat Stroke,Panchkula,Punjab,2021-12-01,2641,206,2435,94,9
Heat Stroke,Panchkula,Punjab,2022-01-01,1695,33,1662,68,5
Heat Stroke,Panchkula,Punjab,2022-02-01,2897,167,2730,11,6
Heat Stroke,Panchkula,Punjab,2022-03-01,260,13,247,111,1
Heat Stroke,Panchkula,Punjab,2022-04-01,1865,93,1772,98,5
Heat Stroke,Panchkula,Punjab,2022-05-01,1132,39,1093,70,3
Heat Stroke,Panchkula,Punjab,2022-06-01,2779,92,2687,109,5
Heat Stroke,Panchkula,Punjab,2022-07-01,3931,73,3858,150,4
Heat Stroke,Panchkula,Punjab,2022-08-01,3464,222,3242,163,4
Heat Stroke,Panchkula,Punjab,2022-09-01,78,0,78,28,8
Heat Stroke,Panchkula,Punjab,2022-10-01,4989,390,4599,88,10
Heat Stroke,Panchkula,Punjab,2022-11-01,2994,130,2864,155,4
Heat Stroke,Panchkula,Punjab,2022-12-01,1556,29,1527,188,9
Heat Stroke,Panchkula,Punjab,2023-01-01,2808,121,2687,65,1
Heat Stroke,Panchkula,Punjab,2023-02-01,2834,108,2726,176,5
Heat Stroke,Panchkula,Punjab,2023-03-01,1703,135,1568,37,1
Heat Stroke,Panchkula,Punjab,2023-04-01,2863,112,2751,165,4
Heat Stroke,Panchkula,Punjab,2023-05-01,1782,74,1708,92,7
Heat Stroke,Panchkula,Punjab,2023-06-01,2055,187,1868,186,8
Heat Stroke,Panchkula,Punjab,2023-07-01,1677,108,1569,83,3
Heat Stroke,Panchkula,Punjab,2023-08-01,675,66,609,90,6
Heat Stroke,Panchkula,Punjab,2023-09-01,2793,242,2551,99,8
Heat Stroke,Panchkula,Punjab,2023-10-01,3383,82,3301,28,8
Heat Stroke,Panchkula,Punjab,2023-11-01,3288,259,3029,16,6
Heat Stroke,Panchkula,Punjab,2023-12-01,3697,349,3348,132,3
Heat Stroke,Panchkula,Punjab,2024-01-01,3033,287,2746,157,3
Heat Stroke,Panchkula,Punjab,2024-02-01,1883,148,1735,137,2
Heat Stroke,Panchkula,Punjab,2024-03-01,3724,291,3433,42,5
Heat Stroke,Panchkula,Punjab,2024-04-01,776,32,744,131,2
Heat Stroke,Panchkula,Punjab,2024-05-01,1389,35,1354,56,7
Heat Stroke,Panchkula,Punjab,2024-06-01,1304,51,1253,127,5
Heat Stroke,Panchkula,Punjab,2024-07-01,4046,6,4040,164,5
Heat Stroke,Panchkula,Punjab,2024-08-01,3862,344,3518,125,1
Heat Stroke,Panchkula,Punjab,2024-09-01,3251,135,3116,181,5
Heat Stroke,Panchkula,Punjab,2024-10-01,4035,353,3682,99,3
Heat Stroke,Panchkula,Punjab,2024-11-01,1418,20,1398,95,10
Heat Stroke,Panchkula,Punjab,2024-12-01,3065,250,2815,110,1
Heat Stroke,Panchkula,Punjab,2025-01-01,2429,86,2343,38,4
Heat Stroke,Panchkula,Punjab,2025-02-01,3734,47,3687,86,6
Heat Stroke,Panchkula,Punjab,2025-03-01,2443,238,2205,90,2
Heat Stroke,Panchkula,Punjab,2025-04-01,2081,171,1910,92,10
Heat Stroke,Panchkula,Punjab,2025-05-01,3323,186,3137,120,10
Heat Stroke,Panchkula,Punjab,2025-06-01,3773,192,3581,31,2
Heat Stroke,Panchkula,Punjab,2025-07-01,1701,106,1595,48,3
Heat Stroke,Panchkula,Punjab,2025-08-01,2515,140,2375,164,10
Heat Stroke,Panchkula,Punjab,2025-09-01,1178,31,1147,11,9
Heat Stroke,Panchkula,Punjab,2025-10-01,78,0,78,138,4
Heat Stroke,Panchkula,Punjab,2025-11-01,2866,307,2559,87,6
Heat Stroke,Panchkula,Punjab,2025-12-01,3414,436,2978,114,1
Heat Stroke,Panchkula,Chandigarh,2018-01-01,2949,281,2668,186,10
Heat Stroke,Panchkula,Chandigarh,2018-02-01,78,0,78,100,5
Heat Stroke,Panchkula,Chandigarh,2018-03-01,2127,85,2042,138,7
Heat Stroke,Panchkula,Chandigarh,2018-04-01,78,0,78,109,2
Heat Stroke,Panchkula,Chandigarh,2018-05-01,4435,127,4308,101,2
Heat Stroke,Panchkula,Chandigarh,2018-06-01,1140,38,1102,94,6
Heat Stroke,Panchkula,Chandigarh,2018-07-01,4282,442,3840,142,10
Heat Stroke,Panchkula,Chandigarh,2018-08-01,3866,396,3470,69,3
Heat Stroke,Panchkula,Chandigarh,2018-09-01,1389,99,1290,49,2
Heat Stroke,Panchkula,Chandigarh,2018-10-01,1078,23,1055,110,6
Heat Stroke,Panchkula,Chandigarh,2018-11-01,3067,233,2834,116,10
Heat Stroke,Panchkula,Chandigarh,2018-12-01,1465,63,1402,13,3
Heat Stroke,Panchkula,Chandigarh,2019-01-01,2735,0,2735,106,4
Heat Stroke,Panchkula,Chandigarh,2019-02-01,1950,113,1837,44,7
Heat Stroke,Panchkula,Chandigarh,2019-03-01,208,5,203,138,8
Heat Stroke,Panchkula,Chandigarh,2019-04-01,78,0,78,14,4
Heat Stroke,Panchkula,Chandigarh,2019-05-01,2902,124,2778,200,8
Heat Stroke,Panchkula,Chandigarh,2019-06-01,1844,65,1779,89,6
Heat Stroke,Panchkula,Chandigarh,2019-07-01,1855,91,1764,62,5
Heat Stroke,Panchkula,Chandigarh,2019-08-01,3531,168,3363,92,7
Heat Stroke,Panchkula,Chandigarh,2019-09-01,4172,0,4172,135,7
Heat Stroke,Panchkula,Chandigarh,2019-10-01,2232,210,2022,152,2
Heat Stroke,Panchkula,Chandigarh,2019-11-01,2140,45,2095,92,9
Heat Stroke,Panchkula,Chandigarh,2019-12-01,3268,73,3195,33,6
Heat Stroke,Panchkula,Chandigarh,2020-01-01,777,31,746,44,9
Heat Stroke,Panchkula,Chandigarh,2020-02-01,2897,135,2762,121,5
Heat Stroke,Panchkula,Chandigarh,2020-03-01,3338,308,3030,157,6
Heat Stroke,Panchkula,Chandigarh,2020-04-01,3510,203,3307,163,6
Heat Stroke,Panchkula,Chandigarh,2020-05-01,78,0,78,115,6
Heat Stroke,Panchkula,Chandigarh,2020-06-01,1576,91,1485,155,9
Heat Stroke,Panchkula,Chandigarh,2020-07-01,1419,80,1339,200,6
Heat Stroke,Panchkula,Chandigarh,2020-08-01,2731,161,2570,167,5
Heat Stroke,Panchkula,Chandigarh,2020-09-01,3242,0,3242,153,8
Heat Stroke,Panchkula,Chandigarh,2020-10-01,4605,197,4408,65,6
Heat Stroke,Panchkula,Chandigarh,2020-11-01,1933,162,1771,155,10
Heat Stroke,Panchkula,Chandigarh,2020-12-01,1930,318,1612,130,6
Heat Stroke,Panchkula,Chandigarh,2021-01-01,4140,62,4078,139,8
Heat Stroke,Panchkula,Chandigarh,2021-02-01,2995,186,2809,170,7
Heat Stroke,Panchkula,Chandigarh,2021-03-01,4298,143,4155,124,1
Heat Stroke,Panchkula,Chandigarh,2021-04-01,2985,327,2658,101,3
Heat Stroke,Panchkula,Chandigarh,2021-05-01,1045,11,1034,52,4
Heat Stroke,Panchkula,Chandigarh,2021-06-01,809,55,754,91,1
Heat Stroke,Panchkula,Chandigarh,2021-07-01,516,4,512,117,4
Heat Stroke,Panchkula,Chandigarh,2021-08-01,3486,142,3344,120,1
Heat Stroke,Panchkula,Chandigarh,2021-09-01,4192,205,3987,119,2
Heat Stroke,Panchkula,Chandigarh,2021-10-01,4989,405,4584,155,6
Heat Stroke,Panchkula,Chandigarh,2021-11-01,3728,69,3659,150,10
Heat Stroke,Panchkula,Chandigarh,2021-12-01,4157,288,3869,103,1
Heat Stroke,Panchkula,Chandigarh,2022-01-01,1819,92,1727,63,1
Heat Stroke,Panchkula,Chandigarh,2022-02-01,1046,60,986,126,3
Heat Stroke,Panchkula,Chandigarh,2022-03-01,3738,291,3447,200,4
Heat Stroke,Panchkula,Chandigarh,2022-04-01,3158,40,3118,123,1
Heat Stroke,Panchkula,Chandigarh,2022-05-01,2742,201,2541,91,3
Heat Stroke,Panchkula,Chandigarh,2022-06-01,3117,104,3013,134,3
Heat Stroke,Panchkula,Chandigarh,2022-07-01,3031,248,2783,137,6
Heat Stroke,Panchkula,Chandigarh,2022-08-01,4320,258,4062,136,6
Heat Stroke,Panchkula,Chandigarh,2022-09-01,4335,190,4145,176,4
Heat Stroke,Panchkula,Chandigarh,2022-10-01,3327,109,3218,126,4
Heat Stroke,Panchkula,Chandigarh,2022-11-01,3732,276,3456,174,3
Heat Stroke,Panchkula,Chandigarh,2022-12-01,3287,285,3002,118,5
Heat Stroke,Panchkula,Chandigarh,2023-01-01,1979,68,1911,183,2
Heat Stroke,Panchkula,Chandigarh,2023-02-01,3612,61,3551,168,9
Heat Stroke,Panchkula,Chandigarh,2023-03-01,727,51,676,153,1
Heat Stroke,Panchkula,Chandigarh,2023-04-01,4011,31,3980,146,3
Heat Stroke,Panchkula,Chandigarh,2023-05-01,995,12,983,200,7
Heat Stroke,Panchkula,Chandigarh,2023-06-01,2981,57,2924,161,4
Heat Stroke,Panchkula,Chandigarh,2023-07-01,1464,55,1409,63,7
Heat Stroke,Panchkula,Chandigarh,2023-08-01,3340,37,3303,119,10
Heat Stroke,Panchkula,Chandigarh,2023-09-01,2552,0,2552,93,7
Heat Stroke,Panchkula,Chandigarh,2023-10-01,458,7,451,200,1
Heat Stroke,Panchkula,Chandigarh,2023-11-01,3162,217,2945,170,1
Heat Stroke,Panchkula,Chandigarh,2023-12-01,1822,23,1799,200,4
Heat Stroke,Panchkula,Chandigarh,2024-01-01,3779,151,3628,67,6
Heat Stroke,Panchkula,Chandigarh,2024-02-01,2599,277,2322,162,8
Heat Stroke,Panchkula,Chandigarh,2024-03-01,3128,152,2976,37,3
Heat Stroke,Panchkula,Chandigarh,2024-04-01,1313,78,1235,25,3
Heat Stroke,Panchkula,Chandigarh,2024-05-01,1807,40,1767,86,4
Heat Stroke,Panchkula,Chandigarh,2024-06-01,1982,224,1758,183,4
Heat Stroke,Panchkula,Chandigarh,2024-07-01,3747,128,3619,56,9
Heat Stroke,Panchkula,Chandigarh,2024-08-01,4848,210,4638,105,5
Heat Stroke,Panchkula,Chandigarh,2024-09-01,1517,134,1383,167,5
Heat Stroke,Panchkula,Chandigarh,2024-10-01,4042,181,3861,149,7
Heat Stroke,Panchkula,Chandigarh,2024-11-01,78,0,78,200,9
Heat Stroke,Panchkula,Chandigarh,2024-12-01,995,41,954,106,5
Heat Stroke,Panchkula,Chandigarh,2025-01-01,1311,55,1256,84,8
Heat Stroke,Panchkula,Chandigarh,2025-02-01,783,47,736,50,10
Heat Stroke,Panchkula,Chandigarh,2025-03-01,473,31,442,87,4
Heat Stroke,Panchkula,Chandigarh,2025-04-01,3151,98,3053,50,3
Heat Stroke,Panchkula,Chandigarh,2025-05-01,2310,64,2246,15,10
Heat Stroke,Panchkula,Chandigarh,2025-06-01,3106,100,3006,200,8
Heat Stroke,Panchkula,Chandigarh,2025-07-01,3524,32,3492,109,5
Heat Stroke,Panchkula,Chandigarh,2025-08-01,2954,11,2943,200,7
Heat Stroke,Panchkula,Chandigarh,2025-09-01,3480,204,3276,63,2
Heat Stroke,Panchkula,Chandigarh,2025-10-01,2504,193,2311,84,8
Heat Stroke,Panchkula,Chandigarh,2025-11-01,1005,75,930,67,1
Heat Stroke,Panchkula,Chandigarh,2025-12-01,4016,0,4016,74,8
Heat Stroke,Panchkula,Himachal Pradesh,2018-01-01,1807,77,1730,151,3
Heat Stroke,Panchkula,Himachal Pradesh,2018-02-01,1342,24,1318,135,1
Heat Stroke,Panchkula,Himachal Pradesh,2018-03-01,2359,127,2232,151,1
Heat Stroke,Panchkula,Himachal Pradesh,2018-04-01,1373,52,1321,175,3
Heat Stroke,Panchkula,Himachal Pradesh,2018-05-01,2037,137,1900,163,7
Heat Stroke,Panchkula,Himachal Pradesh,2018-06-01,3059,151,2908,55,1
Heat Stroke,Panchkula,Himachal Pradesh,2018-07-01,3065,0,3065,80,1
Heat Stroke,Panchkula,Himachal Pradesh,2018-08-01,1393,30,1363,112,3
Heat Stroke,Panchkula,Himachal Pradesh,2018-09-01,1943,97,1846,200,7
Heat Stroke,Panchkula,Himachal Pradesh,2018-10-01,4039,212,3827,146,8
Heat Stroke,Panchkula,Himachal Pradesh,2018-11-01,3263,29,3234,112,5
Heat Stroke,Panchkula,Himachal Pradesh,2018-12-01,4989,26,4963,141,8
Heat Stroke,Panchkula,Himachal Pradesh,2019-01-01,4181,216,3965,75,7
Heat Stroke,Panchkula,Himachal Pradesh,2019-02-01,4132,38,4094,120,4
Heat Stroke,Panchkula,Himachal Pradesh,2019-03-01,736,1,735,155,7
Heat Stroke,Panchkula,Himachal Pradesh,2019-04-01,3622,134,3488,105,1
Heat Stroke,Panchkula,Himachal Pradesh,2019-05-01,2526,90,2436,68,6
Heat Stroke,Panchkula,Himachal Pradesh,2019-06-01,1858,45,1813,102,1
Heat Stroke,Panchkula,Himachal Pradesh,2019-07-01,2823,83,2740,90,5
Heat Stroke,Panchkula,Himachal Pradesh,2019-08-01,3865,195,3670,37,8
Heat Stroke,Panchkula,Himachal Pradesh,2019-09-01,3269,95,3174,77,5
Heat Stroke,Panchkula,Himachal Pradesh,2019-10-01,1419,73,1346,35,5
Heat Stroke,Panchkula,Himachal Pradesh,2019-11-01,3593,140,3453,43,5
Heat Stroke,Panchkula,Himachal Pradesh,2019-12-01,1742,95,1647,48,7
Heat Stroke,Panchkula,Himachal Pradesh,2020-01-01,2888,218,2670,155,10
Heat Stroke,Panchkula,Himachal Pradesh,2020-02-01,2190,163,2027,182,7
Heat Stroke,Panchkula,Himachal Pradesh,2020-03-01,2304,201,2103,28,3
Heat Stroke,Panchkula,Himachal Pradesh,2020-04-01,3625,269,3356,187,4
Heat Stroke,Panchkula,Himachal Pradesh,2020-05-01,1202,68,1134,49,2
Heat Stroke,Panchkula,Himachal Pradesh,2020-06-01,4989,186,4803,144,1
Heat Stroke,Panchkula,Himachal Pradesh,2020-07-01,154,5,149,119,1
Heat Stroke,Panchkula,Himachal Pradesh,2020-08-01,1796,44,1752,139,3
Heat Stroke,Panchkula,Himachal Pradesh,2020-09-01,3094,155,2939,47,1
Heat Stroke,Panchkula,Himachal Pradesh,2020-10-01,3381,237,3144,14,5
Heat Stroke,Panchkula,Himachal Pradesh,2020-11-01,2463,71,2392,65,3
Heat Stroke,Panchkula,Himachal Pradesh,2020-12-01,2520,123,2397,128,2
Heat Stroke,Panchkula,Himachal Pradesh,2021-01-01,3148,95,3053,200,1
Heat Stroke,Panchkula,Himachal Pradesh,2021-02-01,2287,128,2159,54,4
Heat Stroke,Panchkula,Himachal Pradesh,2021-03-01,4466,152,4314,101,1
Heat Stroke,Panchkula,Himachal Pradesh,2021-04-01,3723,106,3617,68,7
Heat Stroke,Panchkula,Himachal Pradesh,2021-05-01,3768,114,3654,105,6
Heat Stroke,Panchkula,Himachal Pradesh,2021-06-01,1301,84,1217,11,4
Heat Stroke,Panchkula,Himachal Pradesh,2021-07-01,2491,117,2374,183,9
Heat Stroke,Panchkula,Himachal Pradesh,2021-08-01,2194,82,2112,107,5
Heat Stroke,Panchkula,Himachal Pradesh,2021-09-01,1248,71,1177,153,6
Heat Stroke,Panchkula,Himachal Pradesh,2021-10-01,3081,117,2964,94,7
Heat Stroke,Panchkula,Himachal Pradesh,2021-11-01,1876,155,1721,116,3
Heat Stroke,Panchkula,Himachal Pradesh,2021-12-01,3477,75,3402,164,3
Heat Stroke,Panchkula,Himachal Pradesh,2022-01-01,1162,51,1111,113,5
Heat Stroke,Panchkula,Himachal Pradesh,2022-02-01,4904,45,4859,115,1
Heat Stroke,Panchkula,Himachal Pradesh,2022-03-01,1395,55,1340,66,10
Heat Stroke,Panchkula,Himachal Pradesh,2022-04-01,2892,3,2889,79,5
Heat Stroke,Panchkula,Himachal Pradesh,2022-05-01,3660,262,3398,55,4
Heat Stroke,Panchkula,Himachal Pradesh,2022-06-01,1832,132,1700,69,10
Heat Stroke,Panchkula,Himachal Pradesh,2022-07-01,3741,272,3469,170,2
Heat Stroke,Panchkula,Himachal Pradesh,2022-08-01,948,48,900,198,9
Heat Stroke,Panchkula,Himachal Pradesh,2022-09-01,4545,111,4434,43,7
Heat Stroke,Panchkula,Himachal Pradesh,2022-10-01,2616,70,2546,126,8
Heat Stroke,Panchkula,Himachal Pradesh,2022-11-01,1797,170,1627,90,4
Heat Stroke,Panchkula,Himachal Pradesh,2022-12-01,2196,201,1995,177,5
Heat Stroke,Panchkula,Himachal Pradesh,2023-01-01,3683,197,3486,113,4
Heat Stroke,Panchkula,Himachal Pradesh,2023-02-01,1813,63,1750,106,8
Heat Stroke,Panchkula,Himachal Pradesh,2023-03-01,1592,143,1449,68,6
Heat Stroke,Panchkula,Himachal Pradesh,2023-04-01,2300,68,2232,28,3
Heat Stroke,Panchkula,Himachal Pradesh,2023-05-01,1019,57,962,145,3
Heat Stroke,Panchkula,Himachal Pradesh,2023-06-01,4989,442,4547,124,5
Heat Stroke,Panchkula,Himachal Pradesh,2023-07-01,1838,47,1791,125,4
Heat Stroke,Panchkula,Himachal Pradesh,2023-08-01,3713,275,3438,76,9
Heat Stroke,Panchkula,Himachal Pradesh,2023-09-01,2878,187,2691,99,7
Heat Stroke,Panchkula,Himachal Pradesh,2023-10-01,1277,62,1215,147,7
Heat Stroke,Panchkula,Himachal Pradesh,2023-11-01,2589,54,2535,156,5
Heat Stroke,Panchkula,Himachal Pradesh,2023-12-01,3649,105,3544,46,2
Heat Stroke,Panchkula,Himachal Pradesh,2024-01-01,2345,137,2208,74,7
Heat Stroke,Panchkula,Himachal Pradesh,2024-02-01,4198,36,4162,35,1
Heat Stroke,Panchkula,Himachal Pradesh,2024-03-01,3968,213,3755,116,5
Heat Stroke,Panchkula,Himachal Pradesh,2024-04-01,3830,252,3578,151,2
Heat Stroke,Panchkula,Himachal Pradesh,2024-05-01,1981,155,1826,92,2
Heat Stroke,Panchkula,Himachal Pradesh,2024-06-01,1149,10,1139,72,3
Heat Stroke,Panchkula,Himachal Pradesh,2024-07-01,1774,156,1618,89,5
Heat Stroke,Panchkula,Himachal Pradesh,2024-08-01,2861,284,2577,200,5
Heat Stroke,Panchkula,Himachal Pradesh,2024-09-01,3330,206,3124,167,7
Heat Stroke,Panchkula,Himachal Pradesh,2024-10-01,78,0,78,143,4
Heat Stroke,Panchkula,Himachal Pradesh,2024-11-01,2587,104,2483,123,5
Heat Stroke,Panchkula,Himachal Pradesh,2024-12-01,2809,136,2673,106,1
Heat Stroke,Panchkula,Himachal Pradesh,2025-01-01,2225,128,2097,60,1
Heat Stroke,Panchkula,Himachal Pradesh,2025-02-01,4330,219,4111,52,6
Heat Stroke,Panchkula,Himachal Pradesh,2025-03-01,3163,184,2979,77,7
Heat Stroke,Panchkula,Himachal Pradesh,2025-04-01,4355,206,4149,58,4
Heat Stroke,Panchkula,Himachal Pradesh,2025-05-01,2308,133,2175,75,8
Heat Stroke,Panchkula,Himachal Pradesh,2025-06-01,3855,141,3714,101,1
Heat Stroke,Panchkula,Himachal Pradesh,2025-07-01,4791,192,4599,105,6
Heat Stroke,Panchkula,Himachal Pradesh,2025-08-01,4357,145,4212,75,2
Heat Stroke,Panchkula,Himachal Pradesh,2025-09-01,1132,119,1013,131,2
Heat Stroke,Panchkula,Himachal Pradesh,2025-10-01,2257,209,2048,97,3
Heat Stroke,Panchkula,Himachal Pradesh,2025-11-01,2134,141,1993,117,5
Heat Stroke,Panchkula,Himachal Pradesh,2025-12-01,3254,288,2966,68,6
Heat Stroke,Panchkula,Jammu & Kashmir,2018-01-01,3518,257,3261,142,6
Heat Stroke,Panchkula,Jammu & Kashmir,2018-02-01,1472,81,1391,79,4
Heat Stroke,Panchkula,Jammu & Kashmir,2018-03-01,2688,16,2672,188,7
Heat Stroke,Panchkula,Jammu & Kashmir,2018-04-01,78,0,78,95,10
Heat Stroke,Panchkula,Jammu & Kashmir,2018-05-01,4532,182,4350,101,4
Heat Stroke,Panchkula,Jammu & Kashmir,2018-06-01,1910,32,1878,136,5
Heat Stroke,Panchkula,Jammu & Kashmir,2018-07-01,2672,18,2654,148,3
Heat Stroke,Panchkula,Jammu & Kashmir,2018-08-01,2182,140,2042,153,4
Heat Stroke,Panchkula,Jammu & Kashmir,2018-09-01,4135,246,3889,197,8
Heat Stroke,Panchkula,Jammu & Kashmir,2018-10-01,78,0,78,140,8
Heat Stroke,Panchkula,Jammu & Kashmir,2018-11-01,2575,73,2502,103,4
Heat Stroke,Panchkula,Jammu & Kashmir,2018-12-01,2455,205,2250,79,6
Heat Stroke,Panchkula,Jammu & Kashmir,2019-01-01,1989,48,1941,99,7
Heat Stroke,Panchkula,Jammu & Kashmir,2019-02-01,4913,270,4643,182,4
Heat Stroke,Panchkula,Jammu & Kashmir,2019-03-01,1407,62,1345,36,1
Heat Stroke,Panchkula,Jammu & Kashmir,2019-04-01,3633,235,3398,64,7
Heat Stroke,Panchkula,Jammu & Kashmir,2019-05-01,3075,77,2998,95,7
Heat Stroke,Panchkula,Jammu & Kashmir,2019-06-01,4290,226,4064,64,7
Heat Stroke,Panchkula,Jammu & Kashmir,2019-07-01,1702,93,1609,85,4
Heat Stroke,Panchkula,Jammu & Kashmir,2019-08-01,1614,91,1523,198,9
Heat Stroke,Panchkula,Jammu & Kashmir,2019-09-01,4068,213,3855,91,6
Heat Stroke,Panchkula,Jammu & Kashmir,2019-10-01,3168,190,2978,127,1
Heat Stroke,Panchkula,Jammu & Kashmir,2019-11-01,525,59,466,22,1
Heat Stroke,Panchkula,Jammu & Kashmir,2019-12-01,1874,233,1641,50,4
Heat Stroke,Panchkula,Jammu & Kashmir,2020-01-01,3116,98,3018,154,5
Heat Stroke,Panchkula,Jammu & Kashmir,2020-02-01,3721,0,3721,191,4
Heat Stroke,Panchkula,Jammu & Kashmir,2020-03-01,1686,113,1573,117,10
Heat Stroke,Panchkula,Jammu & Kashmir,2020-04-01,78,0,78,91,6
Heat Stroke,Panchkula,Jammu & Kashmir,2020-05-01,3299,267,3032,131,2
Heat Stroke,Panchkula,Jammu & Kashmir,2020-06-01,960,56,904,11,1
Heat Stroke,Panchkula,Jammu & Kashmir,2020-07-01,78,0,78,118,6
Heat Stroke,Panchkula,Jammu & Kashmir,2020-08-01,78,0,78,53,8
Heat Stroke,Panchkula,Jammu & Kashmir,2020-09-01,3689,320,3369,147,10
Heat Stroke,Panchkula,Jammu & Kashmir,2020-10-01,2770,26,2744,11,4
Heat Stroke,Panchkula,Jammu & Kashmir,2020-11-01,2295,60,2235,74,10
Heat Stroke,Panchkula,Jammu & Kashmir,2020-12-01,4461,209,4252,104,1
Heat Stroke,Panchkula,Jammu & Kashmir,2021-01-01,3452,182,3270,67,4
Heat Stroke,Panchkula,Jammu & Kashmir,2021-02-01,4766,207,4559,87,2
Heat Stroke,Panchkula,Jammu & Kashmir,2021-03-01,729,45,684,152,7
Heat Stroke,Panchkula,Jammu & Kashmir,2021-04-01,2551,201,2350,105,1
Heat Stroke,Panchkula,Jammu & Kashmir,2021-05-01,429,42,387,59,6
Heat Stroke,Panchkula,Jammu & Kashmir,2021-06-01,2290,153,2137,154,1
Heat Stroke,Panchkula,Jammu & Kashmir,2021-07-01,2264,57,2207,119,10
Heat Stroke,Panchkula,Jammu & Kashmir,2021-08-01,3438,157,3281,121,4
Heat Stroke,Panchkula,Jammu & Kashmir,2021-09-01,2659,127,2532,61,6
Heat Stroke,Panchkula,Jammu & Kashmir,2021-10-01,3434,223,3211,11,1
Heat Stroke,Panchkula,Jammu & Kashmir,2021-11-01,3541,217,3324,60,1
Heat Stroke,Panchkula,Jammu & Kashmir,2021-12-01,4989,442,4547,55,3
Heat Stroke,Panchkula,Jammu & Kashmir,2022-01-01,2174,79,2095,75,7
Heat Stroke,Panchkula,Jammu & Kashmir,2022-02-01,1335,81,1254,63,7
Heat Stroke,Panchkula,Jammu & Kashmir,2022-03-01,2928,347,2581,112,8
Heat Stroke,Panchkula,Jammu & Kashmir,2022-04-01,1521,50,1471,151,1
Heat Stroke,Panchkula,Jammu & Kashmir,2022-05-01,4585,248,4337,161,6
Heat Stroke,Panchkula,Jammu & Kashmir,2022-06-01,2217,50,2167,149,3
Heat Stroke,Panchkula,Jammu & Kashmir,2022-07-01,1839,96,1743,60,2
Heat Stroke,Panchkula,Jammu & Kashmir,2022-08-01,1965,53,1912,109,3
Heat Stroke,Panchkula,Jammu & Kashmir,2022-09-01,3561,286,3275,186,4
Heat Stroke,Panchkula,Jammu & Kashmir,2022-10-01,2386,129,2257,25,7
Heat Stroke,Panchkula,Jammu & Kashmir,2022-11-01,1737,39,1698,175,8
Heat Stroke,Panchkula,Jammu & Kashmir,2022-12-01,4831,360,4471,55,6
Heat Stroke,Panchkula,Jammu & Kashmir,2023-01-01,1449,80,1369,121,7
Heat Stroke,Panchkula,Jammu & Kashmir,2023-02-01,2645,205,2440,127,10
Heat Stroke,Panchkula,Jammu & Kashmir,2023-03-01,3472,57,3415,116,7
Heat Stroke,Panchkula,Jammu & Kashmir,2023-04-01,409,24,385,200,4
Heat Stroke,Panchkula,Jammu & Kashmir,2023-05-01,3242,235,3007,91,7
Heat Stroke,Panchkula,Jammu & Kashmir,2023-06-01,1182,44,1138,23,10
Heat Stroke,Panchkula,Jammu & Kashmir,2023-07-01,3701,49,3652,124,2
Heat Stroke,Panchkula,Jammu & Kashmir,2023-08-01,1306,63,1243,98,4
Heat Stroke,Panchkula,Jammu & Kashmir,2023-09-01,3527,302,3225,134,9
Heat Stroke,Panchkula,Jammu & Kashmir,2023-10-01,4081,338,3743,151,4
Heat Stroke,Panchkula,Jammu & Kashmir,2023-11-01,3753,141,3612,104,7
Heat Stroke,Panchkula,Jammu & Kashmir,2023-12-01,2935,37,2898,128,9
Heat Stroke,Panchkula,Jammu & Kashmir,2024-01-01,2287,85,2202,114,1
Heat Stroke,Panchkula,Jammu & Kashmir,2024-02-01,1824,66,1758,198,4
Heat Stroke,Panchkula,Jammu & Kashmir,2024-03-01,4571,288,4283,87,8
Heat Stroke,Panchkula,Jammu & Kashmir,2024-04-01,1659,77,1582,71,4
Heat Stroke,Panchkula,Jammu & Kashmir,2024-05-01,1206,33,1173,151,1
Heat Stroke,Panchkula,Jammu & Kashmir,2024-06-01,3490,286,3204,59,3
Heat Stroke,Panchkula,Jammu & Kashmir,2024-07-01,1529,82,1447,126,7
Heat Stroke,Panchkula,Jammu & Kashmir,2024-08-01,1323,83,1240,98,9
Heat Stroke,Panchkula,Jammu & Kashmir,2024-09-01,661,0,661,101,5
Heat Stroke,Panchkula,Jammu & Kashmir,2024-10-01,1950,0,1950,200,6
Heat Stroke,Panchkula,Jammu & Kashmir,2024-11-01,2486,20,2466,169,4
Heat Stroke,Panchkula,Jammu & Kashmir,2024-12-01,2924,105,2819,158,7
Heat Stroke,Panchkula,Jammu & Kashmir,2025-01-01,3874,258,3616,133,9
Heat Stroke,Panchkula,Jammu & Kashmir,2025-02-01,3304,0,3304,71,7
Heat Stroke,Panchkula,Jammu & Kashmir,2025-03-01,2341,225,2116,120,4
Heat Stroke,Panchkula,Jammu & Kashmir,2025-04-01,2332,128,2204,136,6
Heat Stroke,Panchkula,Jammu & Kashmir,2025-05-01,3282,294,2988,116,8
Heat Stroke,Panchkula,Jammu & Kashmir,2025-06-01,4305,104,4201,111,5
Heat Stroke,Panchkula,Jammu & Kashmir,2025-07-01,2767,179,2588,86,7
Heat Stroke,Panchkula,Jammu & Kashmir,2025-08-01,1968,103,1865,120,6
Heat Stroke,Panchkula,Jammu & Kashmir,2025-09-01,1265,93,1172,79,9
Heat Stroke,Panchkula,Jammu & Kashmir,2025-10-01,659,28,631,142,7
Heat Stroke,Panchkula,Jammu & Kashmir,2025-11-01,3491,222,3269,11,3
Heat Stroke,Panchkula,Jammu & Kashmir,2025-12-01,3373,277,3096,175,9
Heat Stroke,Panchkula,Haryana,2018-01-01,3372,104,3268,39,6
Heat Stroke,Panchkula,Haryana,2018-02-01,2425,138,2287,52,4
Heat Stroke,Panchkula,Haryana,2018-03-01,4485,0,4485,127,1
Heat Stroke,Panchkula,Haryana,2018-04-01,1948,137,1811,134,5
Heat Stroke,Panchkula,Haryana,2018-05-01,3879,414,3465,200,10
Heat Stroke,Panchkula,Haryana,2018-06-01,2545,35,2510,121,1
Heat Stroke,Panchkula,Haryana,2018-07-01,1781,84,1697,104,1
Heat Stroke,Panchkula,Haryana,2018-08-01,3392,256,3136,116,7
Heat Stroke,Panchkula,Haryana,2018-09-01,3147,160,2987,187,6
Heat Stroke,Panchkula,Haryana,2018-10-01,3076,168,2908,200,7
Heat Stroke,Panchkula,Haryana,2018-11-01,2706,104,2602,97,3
Heat Stroke,Panchkula,Haryana,2018-12-01,2547,95,2452,134,1
Heat Stroke,Panchkula,Haryana,2019-01-01,4989,237,4752,102,2
Heat Stroke,Panchkula,Haryana,2019-02-01,4186,214,3972,101,9
Heat Stroke,Panchkula,Haryana,2019-03-01,3567,55,3512,200,4
Heat Stroke,Panchkula,Haryana,2019-04-01,2747,132,2615,59,4
Heat Stroke,Panchkula,Haryana,2019-05-01,3949,378,3571,11,1
Heat Stroke,Panchkula,Haryana,2019-06-01,3292,124,3168,122,1
Heat Stroke,Panchkula,Haryana,2019-07-01,2633,37,2596,167,8
Heat Stroke,Panchkula,Haryana,2019-08-01,2190,100,2090,117,4
Heat Stroke,Panchkula,Haryana,2019-09-01,2489,72,2417,132,8
Heat Stroke,Panchkula,Haryana,2019-10-01,78,0,78,145,3
Heat Stroke,Panchkula,Haryana,2019-11-01,2880,155,2725,112,1
Heat Stroke,Panchkula,Haryana,2019-12-01,1942,57,1885,135,4
Heat Stroke,Panchkula,Haryana,2020-01-01,4734,150,4584,134,3
Heat Stroke,Panchkula,Haryana,2020-02-01,2623,143,2480,11,2
Heat Stroke,Panchkula,Haryana,2020-03-01,1002,5,997,112,2
Heat Stroke,Panchkula,Haryana,2020-04-01,2530,0,2530,26,4
Heat Stroke,Panchkula,Haryana,2020-05-01,1194,83,1111,104,3
Heat Stroke,Panchkula,Haryana,2020-06-01,3232,0,3232,81,2
Heat Stroke,Panchkula,Haryana,2020-07-01,2988,64,2924,159,10
Heat Stroke,Panchkula,Haryana,2020-08-01,3882,0,3882,119,6
Heat Stroke,Panchkula,Haryana,2020-09-01,1536,55,1481,130,5
Heat Stroke,Panchkula,Haryana,2020-10-01,2643,165,2478,96,5
Heat Stroke,Panchkula,Haryana,2020-11-01,766,40,726,160,7
Heat Stroke,Panchkula,Haryana,2020-12-01,3538,423,3115,25,6
Heat Stroke,Panchkula,Haryana,2021-01-01,3293,269,3024,61,2
Heat Stroke,Panchkula,Haryana,2021-02-01,3263,74,3189,172,1
Heat Stroke,Panchkula,Haryana,2021-03-01,2600,39,2561,84,1
Heat Stroke,Panchkula,Haryana,2021-04-01,3154,406,2748,11,10
Heat Stroke,Panchkula,Haryana,2021-05-01,4750,384,4366,180,4
Heat Stroke,Panchkula,Haryana,2021-06-01,2215,148,2067,161,7
Heat Stroke,Panchkula,Haryana,2021-07-01,2783,145,2638,142,5
Heat Stroke,Panchkula,Haryana,2021-08-01,1140,66,1074,111,7
Heat Stroke,Panchkula,Haryana,2021-09-01,1433,9,1424,191,5
Heat Stroke,Panchkula,Haryana,2021-10-01,2729,149,2580,170,1
Heat Stroke,Panchkula,Haryana,2021-11-01,4078,212,3866,185,2
Heat Stroke,Panchkula,Haryana,2021-12-01,2254,53,2201,142,4
Heat Stroke,Panchkula,Haryana,2022-01-01,2281,78,2203,112,1
Heat Stroke,Panchkula,Haryana,2022-02-01,2052,193,1859,86,2
Heat Stroke,Panchkula,Haryana,2022-03-01,1880,87,1793,42,1
Heat Stroke,Panchkula,Haryana,2022-04-01,2993,330,2663,132,4
Heat Stroke,Panchkula,Haryana,2022-05-01,589,0,589,136,3
Heat Stroke,Panchkula,Haryana,2022-06-01,4316,150,4166,88,5
Heat Stroke,Panchkula,Haryana,2022-07-01,1705,8,1697,137,7
Heat Stroke,Panchkula,Haryana,2022-08-01,3566,53,3513,89,4
Heat Stroke,Panchkula,Haryana,2022-09-01,894,23,871,150,1
Heat Stroke,Panchkula,Haryana,2022-10-01,3495,207,3288,61,1
Heat Stroke,Panchkula,Haryana,2022-11-01,3499,202,3297,52,5
Heat Stroke,Panchkula,Haryana,2022-12-01,3113,94,3019,94,3
Heat Stroke,Panchkula,Haryana,2023-01-01,1263,0,1263,148,4
Heat Stroke,Panchkula,Haryana,2023-02-01,2932,272,2660,47,6
Heat Stroke,Panchkula,Haryana,2023-03-01,1010,42,968,160,9
Heat Stroke,Panchkula,Haryana,2023-04-01,2258,39,2219,23,1
Heat Stroke,Panchkula,Haryana,2023-05-01,3978,231,3747,94,2
Heat Stroke,Panchkula,Haryana,2023-06-01,3666,205,3461,34,5
Heat Stroke,Panchkula,Haryana,2023-07-01,2618,106,2512,11,2
Heat Stroke,Panchkula,Haryana,2023-08-01,1290,70,1220,125,1
Heat Stroke,Panchkula,Haryana,2023-09-01,3463,56,3407,97,9
Heat Stroke,Panchkula,Haryana,2023-10-01,2623,189,2434,35,2
Heat Stroke,Panchkula,Haryana,2023-11-01,78,0,78,80,1
Heat Stroke,Panchkula,Haryana,2023-12-01,3647,118,3529,129,1
Heat Stroke,Panchkula,Haryana,2024-01-01,2565,176,2389,87,8
Heat Stroke,Panchkula,Haryana,2024-02-01,4211,358,3853,96,3
Heat Stroke,Panchkula,Haryana,2024-03-01,1128,108,1020,86,1
Heat Stroke,Panchkula,Haryana,2024-04-01,78,0,78,77,2
Heat Stroke,Panchkula,Haryana,2024-05-01,2972,120,2852,76,5
Heat Stroke,Panchkula,Haryana,2024-06-01,2989,15,2974,74,7
Heat Stroke,Panchkula,Haryana,2024-07-01,329,29,300,68,7
Heat Stroke,Panchkula,Haryana,2024-08-01,1285,115,1170,54,3
Heat Stroke,Panchkula,Haryana,2024-09-01,4989,152,4837,87,3
Heat Stroke,Panchkula,Haryana,2024-10-01,2187,168,2019,74,10
Heat Stroke,Panchkula,Haryana,2024-11-01,3578,144,3434,52,8
Heat Stroke,Panchkula,Haryana,2024-12-01,1725,161,1564,145,4
Heat Stroke,Panchkula,Haryana,2025-01-01,78,0,78,169,1
Heat Stroke,Panchkula,Haryana,2025-02-01,2369,255,2114,106,3
Heat Stroke,Panchkula,Haryana,2025-03-01,2241,163,2078,110,1
Heat Stroke,Panchkula,Haryana,2025-04-01,2061,211,1850,71,2
Heat Stroke,Panchkula,Haryana,2025-05-01,2444,89,2355,161,2
Heat Stroke,Panchkula,Haryana,2025-06-01,2952,182,2770,195,4
Heat Stroke,Panchkula,Haryana,2025-07-01,2396,52,2344,98,5
Heat Stroke,Panchkula,Haryana,2025-08-01,902,67,835,80,3
Heat Stroke,Panchkula,Haryana,2025-09-01,3250,247,3003,124,1
Heat Stroke,Panchkula,Haryana,2025-10-01,78,0,78,113,4
Heat Stroke,Panchkula,Haryana,2025-11-01,78,0,78,81,3
Heat Stroke,Panchkula,Haryana,2025-12-01,3589,255,3334,130,1
Asthma,Amritsar,Punjab,2018-01-01,3278,119,3159,154,7
Asthma,Amritsar,Punjab,2018-02-01,2520,165,2355,66,3
Asthma,Amritsar,Punjab,2018-03-01,725,28,697,200,4
Asthma,Amritsar,Punjab,2018-04-01,1648,88,1560,28,4
Asthma,Amritsar,Punjab,2018-05-01,2245,123,2122,63,5
Asthma,Amritsar,Punjab,2018-06-01,457,18,439,118,5
Asthma,Amritsar,Punjab,2018-07-01,1606,83,1523,200,1
Asthma,Amritsar,Punjab,2018-08-01,3473,135,3338,78,6
Asthma,Amritsar,Punjab,2018-09-01,4512,176,4336,52,4
Asthma,Amritsar,Punjab,2018-10-01,2035,165,1870,134,8
Asthma,Amritsar,Punjab,2018-11-01,3612,199,3413,94,7
Asthma,Amritsar,Punjab,2018-12-01,78,0,78,140,9
Asthma,Amritsar,Punjab,2019-01-01,3482,26,3456,103,2
Asthma,Amritsar,Punjab,2019-02-01,1519,94,1425,63,9
Asthma,Amritsar,Punjab,2019-03-01,3010,197,2813,200,5
Asthma,Amritsar,Punjab,2019-04-01,2265,87,2178,11,7
Asthma,Amritsar,Punjab,2019-05-01,4369,442,3927,199,7
Asthma,Amritsar,Punjab,2019-06-01,1424,0,1424,154,6
Asthma,Amritsar,Punjab,2019-07-01,3439,250,3189,68,2
Asthma,Amritsar,Punjab,2019-08-01,2222,157,2065,200,8
Asthma,Amritsar,Punjab,2019-09-01,2385,157,2228,36,6
Asthma,Amritsar,Punjab,2019-10-01,2351,129,2222,158,1
Asthma,Amritsar,Punjab,2019-11-01,1463,96,1367,11,3
Asthma,Amritsar,Punjab,2019-12-01,2578,194,2384,48,1
Asthma,Amritsar,Punjab,2020-01-01,2513,72,2441,48,1
Asthma,Amritsar,Punjab,2020-02-01,2921,171,2750,68,7
Asthma,Amritsar,Punjab,2020-03-01,2711,121,2590,107,1
Asthma,Amritsar,Punjab,2020-04-01,3668,66,3602,64,1
Asthma,Amritsar,Punjab,2020-05-01,3836,272,3564,11,10
Asthma,Amritsar,Punjab,2020-06-01,1188,39,1149,130,4
Asthma,Amritsar,Punjab,2020-07-01,3763,24,3739,109,7
Asthma,Amritsar,Punjab,2020-08-01,1006,34,972,127,8
Asthma,Amritsar,Punjab,2020-09-01,3386,90,3296,115,7
Asthma,Amritsar,Punjab,2020-10-01,3429,274,3155,155,5
Asthma,Amritsar,Punjab,2020-11-01,78,0,78,102,5
Asthma,Amritsar,Punjab,2020-12-01,2722,245,2477,158,6
Asthma,Amritsar,Punjab,2021-01-01,1969,60,1909,67,4
Asthma,Amritsar,Punjab,2021-02-01,1580,119,1461,70,7
Asthma,Amritsar,Punjab,2021-03-01,4410,442,3968,176,4
Asthma,Amritsar,Punjab,2021-04-01,1720,103,1617,175,4
Asthma,Amritsar,Punjab,2021-05-01,1516,113,1403,135,10
Asthma,Amritsar,Punjab,2021-06-01,2699,189,2510,61,3
Asthma,Amritsar,Punjab,2021-07-01,3517,30,3487,57,5
Asthma,Amritsar,Punjab,2021-08-01,2407,161,2246,174,6
Asthma,Amritsar,Punjab,2021-09-01,4162,245,3917,171,6
Asthma,Amritsar,Punjab,2021-10-01,3310,140,3170,103,6
Asthma,Amritsar,Punjab,2021-11-01,78,0,78,200,1
Asthma,Amritsar,Punjab,2021-12-01,1887,132,1755,130,5
Asthma,Amritsar,Punjab,2022-01-01,1844,40,1804,50,6
Asthma,Amritsar,Punjab,2022-02-01,3240,363,2877,92,8
Asthma,Amritsar,Punjab,2022-03-01,78,0,78,106,7
Asthma,Amritsar,Punjab,2022-04-01,4989,72,4917,111,8
Asthma,Amritsar,Punjab,2022-05-01,3310,116,3194,170,2
Asthma,Amritsar,Punjab,2022-06-01,2797,117,2680,57,2
Asthma,Amritsar,Punjab,2022-07-01,4182,442,3740,38,6
Asthma,Amritsar,Punjab,2022-08-01,4989,121,4868,137,8
Asthma,Amritsar,Punjab,2022-09-01,3766,175,3591,80,4
Asthma,Amritsar,Punjab,2022-10-01,3870,133,3737,200,3
Asthma,Amritsar,Punjab,2022-11-01,2773,179,2594,154,1
Asthma,Amritsar,Punjab,2022-12-01,2408,83,2325,79,6
Asthma,Amritsar,Punjab,2023-01-01,1959,33,1926,168,4
Asthma,Amritsar,Punjab,2023-02-01,1489,66,1423,143,4
Asthma,Amritsar,Punjab,2023-03-01,1676,69,1607,138,7
Asthma,Amritsar,Punjab,2023-04-01,786,25,761,100,5
Asthma,Amritsar,Punjab,2023-05-01,2496,85,2411,128,5
Asthma,Amritsar,Punjab,2023-06-01,337,28,309,11,7
Asthma,Amritsar,Punjab,2023-07-01,2854,116,2738,173,10
Asthma,Amritsar,Punjab,2023-08-01,2549,43,2506,11,4
Asthma,Amritsar,Punjab,2023-09-01,2795,102,2693,84,2
Asthma,Amritsar,Punjab,2023-10-01,1897,97,1800,25,2
Asthma,Amritsar,Punjab,2023-11-01,4989,55,4934,81,6
Asthma,Amritsar,Punjab,2023-12-01,4422,430,3992,102,2
Asthma,Amritsar,Punjab,2024-01-01,928,69,859,45,4
Asthma,Amritsar,Punjab,2024-02-01,2910,266,2644,11,4
Asthma,Amritsar,Punjab,2024-03-01,1782,109,1673,117,9
Asthma,Amritsar,Punjab,2024-04-01,1236,0,1236,200,8
Asthma,Amritsar,Punjab,2024-05-01,800,75,725,88,1
Asthma,Amritsar,Punjab,2024-06-01,3177,79,3098,155,9
Asthma,Amritsar,Punjab,2024-07-01,1683,45,1638,183,1
Asthma,Amritsar,Punjab,2024-08-01,3896,212,3684,11,5
Asthma,Amritsar,Punjab,2024-09-01,3931,354,3577,83,2
Asthma,Amritsar,Punjab,2024-10-01,4441,358,4083,41,4
Asthma,Amritsar,Punjab,2024-11-01,1454,111,1343,65,2
Asthma,Amritsar,Punjab,2024-12-01,3235,132,3103,193,10
Asthma,Amritsar,Punjab,2025-01-01,3446,139,3307,118,4
Asthma,Amritsar,Punjab,2025-02-01,1961,117,1844,146,5
Asthma,Amritsar,Punjab,2025-03-01,1562,72,1490,104,2
Asthma,Amritsar,Punjab,2025-04-01,4757,361,4396,45,1
Asthma,Amritsar,Punjab,2025-05-01,2903,215,2688,141,4
Asthma,Amritsar,Punjab,2025-06-01,3451,232,3219,170,6
Asthma,Amritsar,Punjab,2025-07-01,1495,0,1495,122,4
Asthma,Amritsar,Punjab,2025-08-01,962,51,911,131,8
Asthma,Amritsar,Punjab,2025-09-01,1833,85,1748,43,5
Asthma,Amritsar,Punjab,2025-10-01,2431,133,2298,142,5
Asthma,Amritsar,Punjab,2025-11-01,1170,32,1138,175,6
Asthma,Amritsar,Punjab,2025-12-01,2584,29,2555,127,5
Asthma,Amritsar,Chandigarh,2018-01-01,332,21,311,15,8
Asthma,Amritsar,Chandigarh,2018-02-01,1095,43,1052,190,6
Asthma,Amritsar,Chandigarh,2018-03-01,3497,233,3264,58,7
Asthma,Amritsar,Chandigarh,2018-04-01,3407,104,3303,126,7
Asthma,Amritsar,Chandigarh,2018-05-01,2072,189,1883,155,9
Asthma,Amritsar,Chandigarh,2018-06-01,1232,97,1135,161,7
Asthma,Amritsar,Chandigarh,2018-07-01,1219,71,1148,15,10
Asthma,Amritsar,Chandigarh,2018-08-01,2097,91,2006,112,3
Asthma,Amritsar,Chandigarh,2018-09-01,3462,259,3203,109,7
Asthma,Amritsar,Chandigarh,2018-10-01,3843,236,3607,180,1
Asthma,Amritsar,Chandigarh,2018-11-01,1931,110,1821,130,8
Asthma,Amritsar,Chandigarh,2018-12-01,1050,84,966,180,5
Asthma,Amritsar,Chandigarh,2019-01-01,2957,270,2687,134,8
Asthma,Amritsar,Chandigarh,2019-02-01,1493,20,1473,102,10
Asthma,Amritsar,Chandigarh,2019-03-01,1902,37,1865,116,7
Asthma,Amritsar,Chandigarh,2019-04-01,4375,119,4256,184,4
Asthma,Amritsar,Chandigarh,2019-05-01,3707,23,3684,40,2
Asthma,Amritsar,Chandigarh,2019-06-01,2809,135,2674,152,6
Asthma,Amritsar,Chandigarh,2019-07-01,891,60,831,74,4
Asthma,Amritsar,Chandigarh,2019-08-01,2881,142,2739,63,7
Asthma,Amritsar,Chandigarh,2019-09-01,4023,138,3885,158,3
Asthma,Amritsar,Chandigarh,2019-10-01,2093,173,1920,61,2
Asthma,Amritsar,Chandigarh,2019-11-01,4410,238,4172,125,4
Asthma,Amritsar,Chandigarh,2019-12-01,4332,260,4072,81,6
Asthma,Amritsar,Chandigarh,2020-01-01,4829,404,4425,11,5
Asthma,Amritsar,Chandigarh,2020-02-01,3007,139,2868,131,2
Asthma,Amritsar,Chandigarh,2020-03-01,3385,372,3013,113,10
Asthma,Amritsar,Chandigarh,2020-04-01,4495,166,4329,11,4
Asthma,Amritsar,Chandigarh,2020-05-01,3198,346,2852,71,1
Asthma,Amritsar,Chandigarh,2020-06-01,1925,41,1884,14,8
Asthma,Amritsar,Chandigarh,2020-07-01,1996,130,1866,143,5
Asthma,Amritsar,Chandigarh,2020-08-01,2917,91,2826,177,4
Asthma,Amritsar,Chandigarh,2020-09-01,866,71,795,149,4
Asthma,Amritsar,Chandigarh,2020-10-01,2405,86,2319,157,4
Asthma,Amritsar,Chandigarh,2020-11-01,4068,238,3830,80,10
Asthma,Amritsar,Chandigarh,2020-12-01,78,0,78,134,6
Asthma,Amritsar,Chandigarh,2021-01-01,4656,360,4296,106,6
Asthma,Amritsar,Chandigarh,2021-02-01,4103,127,3976,116,4
Asthma,Amritsar,Chandigarh,2021-03-01,1981,196,1785,155,10
Asthma,Amritsar,Chandigarh,2021-04-01,3326,70,3256,166,7
Asthma,Amritsar,Chandigarh,2021-05-01,2602,28,2574,86,8
Asthma,Amritsar,Chandigarh,2021-06-01,4247,330,3917,34,6
Asthma,Amritsar,Chandigarh,2021-07-01,3916,128,3788,97,8
Asthma,Amritsar,Chandigarh,2021-08-01,719,35,684,95,6
Asthma,Amritsar,Chandigarh,2021-09-01,3385,137,3248,121,4
Asthma,Amritsar,Chandigarh,2021-10-01,2322,27,2295,149,6
Asthma,Amritsar,Chandigarh,2021-11-01,2709,129,2580,11,10
Asthma,Amritsar,Chandigarh,2021-12-01,1621,140,1481,72,5
Asthma,Amritsar,Chandigarh,2022-01-01,4943,391,4552,57,9
Asthma,Amritsar,Chandigarh,2022-02-01,3993,226,3767,170,8
Asthma,Amritsar,Chandigarh,2022-03-01,1605,132,1473,96,6
Asthma,Amritsar,Chandigarh,2022-04-01,807,15,792,80,10
Asthma,Amritsar,Chandigarh,2022-05-01,2080,84,1996,134,1
Asthma,Amritsar,Chandigarh,2022-06-01,3180,195,2985,76,1
Asthma,Amritsar,Chandigarh,2022-07-01,2920,135,2785,105,10
Asthma,Amritsar,Chandigarh,2022-08-01,4278,183,4095,199,3
Asthma,Amritsar,Chandigarh,2022-09-01,3657,55,3602,197,5
Asthma,Amritsar,Chandigarh,2022-10-01,3898,0,3898,85,10
Asthma,Amritsar,Chandigarh,2022-11-01,3036,224,2812,97,5
Asthma,Amritsar,Chandigarh,2022-12-01,734,41,693,75,10
Asthma,Amritsar,Chandigarh,2023-01-01,2335,178,2157,11,4
Asthma,Amritsar,Chandigarh,2023-02-01,4020,150,3870,159,7
Asthma,Amritsar,Chandigarh,2023-03-01,2528,74,2454,200,5
Asthma,Amritsar,Chandigarh,2023-04-01,3272,164,3108,84,9
Asthma,Amritsar,Chandigarh,2023-05-01,2170,162,2008,65,4
Asthma,Amritsar,Chandigarh,2023-06-01,1216,52,1164,92,2
Asthma,Amritsar,Chandigarh,2023-07-01,2432,178,2254,111,3
Asthma,Amritsar,Chandigarh,2023-08-01,3012,62,2950,48,4
Asthma,Amritsar,Chandigarh,2023-09-01,1718,77,1641,83,3
Asthma,Amritsar,Chandigarh,2023-10-01,2281,109,2172,158,3
Asthma,Amritsar,Chandigarh,2023-11-01,1337,114,1223,113,8
Asthma,Amritsar,Chandigarh,2023-12-01,4099,230,3869,171,9
Asthma,Amritsar,Chandigarh,2024-01-01,2202,222,1980,125,6
Asthma,Amritsar,Chandigarh,2024-02-01,4546,49,4497,51,3
Asthma,Amritsar,Chandigarh,2024-03-01,4648,250,4398,77,3
Asthma,Amritsar,Chandigarh,2024-04-01,2489,137,2352,119,1
Asthma,Amritsar,Chandigarh,2024-05-01,1245,84,1161,49,6
Asthma,Amritsar,Chandigarh,2024-06-01,78,0,78,42,3
Asthma,Amritsar,Chandigarh,2024-07-01,623,61,562,45,9
Asthma,Amritsar,Chandigarh,2024-08-01,754,38,716,132,1
Asthma,Amritsar,Chandigarh,2024-09-01,4447,81,4366,88,3
Asthma,Amritsar,Chandigarh,2024-10-01,2753,136,2617,166,5
Asthma,Amritsar,Chandigarh,2024-11-01,3120,127,2993,61,6
Asthma,Amritsar,Chandigarh,2024-12-01,78,0,78,11,10
Asthma,Amritsar,Chandigarh,2025-01-01,990,79,911,100,1
Asthma,Amritsar,Chandigarh,2025-02-01,3787,195,3592,190,4
Asthma,Amritsar,Chandigarh,2025-03-01,2982,139,2843,108,1
Asthma,Amritsar,Chandigarh,2025-04-01,2400,186,2214,36,7
Asthma,Amritsar,Chandigarh,2025-05-01,3355,265,3090,23,3
Asthma,Amritsar,Chandigarh,2025-06-01,4792,0,4792,167,5
Asthma,Amritsar,Chandigarh,2025-07-01,2301,158,2143,65,4
Asthma,Amritsar,Chandigarh,2025-08-01,2690,136,2554,185,5
Asthma,Amritsar,Chandigarh,2025-09-01,2856,34,2822,140,4
Asthma,Amritsar,Chandigarh,2025-10-01,4989,377,4612,67,2
Asthma,Amritsar,Chandigarh,2025-11-01,78,0,78,166,5
Asthma,Amritsar,Chandigarh,2025-12-01,3514,232,3282,59,3
Asthma,Amritsar,Himachal Pradesh,2018-01-01,2443,200,2243,32,7
Asthma,Amritsar,Himachal Pradesh,2018-02-01,3358,344,3014,62,5
Asthma,Amritsar,Himachal Pradesh,2018-03-01,1716,44,1672,145,2
Asthma,Amritsar,Himachal Pradesh,2018-04-01,2532,0,2532,164,10
Asthma,Amritsar,Himachal Pradesh,2018-05-01,3552,245,3307,86,10
Asthma,Amritsar,Himachal Pradesh,2018-06-01,4989,213,4776,11,10
Asthma,Amritsar,Himachal Pradesh,2018-07-01,3681,37,3644,27,4
Asthma,Amritsar,Himachal Pradesh,2018-08-01,1460,69,1391,52,2
Asthma,Amritsar,Himachal Pradesh,2018-09-01,2029,144,1885,40,7
Asthma,Amritsar,Himachal Pradesh,2018-10-01,1989,90,1899,120,8
Asthma,Amritsar,Himachal Pradesh,2018-11-01,189,5,184,200,5
Asthma,Amritsar,Himachal Pradesh,2018-12-01,2155,93,2062,147,1
Asthma,Amritsar,Himachal Pradesh,2019-01-01,3580,177,3403,49,2
Asthma,Amritsar,Himachal Pradesh,2019-02-01,888,0,888,71,6
Asthma,Amritsar,Himachal Pradesh,2019-03-01,4004,183,3821,81,3
Asthma,Amritsar,Himachal Pradesh,2019-04-01,3252,35,3217,126,1
Asthma,Amritsar,Himachal Pradesh,2019-05-01,1612,111,1501,186,4
Asthma,Amritsar,Himachal Pradesh,2019-06-01,2408,11,2397,82,1
Asthma,Amritsar,Himachal Pradesh,2019-07-01,4742,377,4365,185,3
Asthma,Amritsar,Himachal Pradesh,2019-08-01,3581,136,3445,200,4
Asthma,Amritsar,Himachal Pradesh,2019-09-01,2609,89,2520,88,6
Asthma,Amritsar,Himachal Pradesh,2019-10-01,2279,133,2146,87,6
Asthma,Amritsar,Himachal Pradesh,2019-11-01,2700,67,2633,88,6
Asthma,Amritsar,Himachal Pradesh,2019-12-01,1911,111,1800,109,7
Asthma,Amritsar,Himachal Pradesh,2020-01-01,78,0,78,88,4
Asthma,Amritsar,Himachal Pradesh,2020-02-01,4989,168,4821,151,1
Asthma,Amritsar,Himachal Pradesh,2020-03-01,2806,173,2633,27,5
Asthma,Amritsar,Himachal Pradesh,2020-04-01,3132,53,3079,79,2
Asthma,Amritsar,Himachal Pradesh,2020-05-01,2520,33,2487,123,1
Asthma,Amritsar,Himachal Pradesh,2020-06-01,1611,92,1519,151,7
Asthma,Amritsar,Himachal Pradesh,2020-07-01,2348,115,2233,200,1
Asthma,Amritsar,Himachal Pradesh,2020-08-01,452,24,428,41,7
Asthma,Amritsar,Himachal Pradesh,2020-09-01,4989,297,4692,73,1
Asthma,Amritsar,Himachal Pradesh,2020-10-01,941,48,893,11,4
Asthma,Amritsar,Himachal Pradesh,2020-11-01,1213,82,1131,50,3
Asthma,Amritsar,Himachal Pradesh,2020-12-01,2007,106,1901,16,8
Asthma,Amritsar,Himachal Pradesh,2021-01-01,4325,0,4325,80,7
Asthma,Amritsar,Himachal Pradesh,2021-02-01,2617,0,2617,95,2
Asthma,Amritsar,Himachal Pradesh,2021-03-01,939,99,840,130,4
Asthma,Amritsar,Himachal Pradesh,2021-04-01,4280,214,4066,91,9
Asthma,Amritsar,Himachal Pradesh,2021-05-01,3578,278,3300,130,9
Asthma,Amritsar,Himachal Pradesh,2021-06-01,3320,132,3188,112,1
Asthma,Amritsar,Himachal Pradesh,2021-07-01,3558,172,3386,54,9
Asthma,Amritsar,Himachal Pradesh,2021-08-01,4989,183,4806,20,8
Asthma,Amritsar,Himachal Pradesh,2021-09-01,4989,442,4547,136,5
Asthma,Amritsar,Himachal Pradesh,2021-10-01,1676,96,1580,190,5
Asthma,Amritsar,Himachal Pradesh,2021-11-01,4776,164,4612,200,3
Asthma,Amritsar,Himachal Pradesh,2021-12-01,3111,6,3105,154,1
Asthma,Amritsar,Himachal Pradesh,2022-01-01,3267,351,2916,180,6
Asthma,Amritsar,Himachal Pradesh,2022-02-01,327,14,313,130,4
Asthma,Amritsar,Himachal Pradesh,2022-03-01,2369,169,2200,122,6
Asthma,Amritsar,Himachal Pradesh,2022-04-01,1507,113,1394,112,6
Asthma,Amritsar,Himachal Pradesh,2022-05-01,3708,135,3573,101,10
Asthma,Amritsar,Himachal Pradesh,2022-06-01,4034,280,3754,137,8
Asthma,Amritsar,Himachal Pradesh,2022-07-01,78,0,78,80,6
Asthma,Amritsar,Himachal Pradesh,2022-08-01,2568,54,2514,99,1
Asthma,Amritsar,Himachal Pradesh,2022-09-01,4102,344,3758,46,6
Asthma,Amritsar,Himachal Pradesh,2022-10-01,2347,106,2241,130,9
Asthma,Amritsar,Himachal Pradesh,2022-11-01,3575,232,3343,57,4
Asthma,Amritsar,Himachal Pradesh,2022-12-01,3068,190,2878,108,10
Asthma,Amritsar,Himachal Pradesh,2023-01-01,3056,209,2847,132,6
Asthma,Amritsar,Himachal Pradesh,2023-02-01,2233,10,2223,136,6
Asthma,Amritsar,Himachal Pradesh,2023-03-01,965,31,934,146,2
Asthma,Amritsar,Himachal Pradesh,2023-04-01,1093,44,1049,95,9
Asthma,Amritsar,Himachal Pradesh,2023-05-01,3549,91,3458,131,2
Asthma,Amritsar,Himachal Pradesh,2023-06-01,2624,164,2460,81,3
Asthma,Amritsar,Himachal Pradesh,2023-07-01,2412,204,2208,11,1
Asthma,Amritsar,Himachal Pradesh,2023-08-01,2029,181,1848,133,7
Asthma,Amritsar,Himachal Pradesh,2023-09-01,2188,87,2101,121,7
Asthma,Amritsar,Himachal Pradesh,2023-10-01,4002,234,3768,158,5
Asthma,Amritsar,Himachal Pradesh,2023-11-01,2148,135,2013,105,7
Asthma,Amritsar,Himachal Pradesh,2023-12-01,798,54,744,25,7
Asthma,Amritsar,Himachal Pradesh,2024-01-01,3595,88,3507,102,4
Asthma,Amritsar,Himachal Pradesh,2024-02-01,2323,239,2084,151,3
Asthma,Amritsar,Himachal Pradesh,2024-03-01,2640,203,2437,130,1
Asthma,Amritsar,Himachal Pradesh,2024-04-01,4754,369,4385,99,4
Asthma,Amritsar,Himachal Pradesh,2024-05-01,2570,218,2352,21,1
Asthma,Amritsar,Himachal Pradesh,2024-06-01,2985,195,2790,54,5
Asthma,Amritsar,Himachal Pradesh,2024-07-01,1016,20,996,131,4
Asthma,Amritsar,Himachal Pradesh,2024-08-01,2303,105,2198,21,4
Asthma,Amritsar,Himachal Pradesh,2024-09-01,3415,6,3409,90,8
Asthma,Amritsar,Himachal Pradesh,2024-10-01,511,31,480,108,2
Asthma,Amritsar,Himachal Pradesh,2024-11-01,2867,129,2738,165,1
Asthma,Amritsar,Himachal Pradesh,2024-12-01,2733,133,2600,138,4
Asthma,Amritsar,Himachal Pradesh,2025-01-01,2653,225,2428,155,3
Asthma,Amritsar,Himachal Pradesh,2025-02-01,3989,146,3843,122,5
Asthma,Amritsar,Himachal Pradesh,2025-03-01,3046,130,2916,63,2
Asthma,Amritsar,Himachal Pradesh,2025-04-01,4580,232,4348,75,6
Asthma,Amritsar,Himachal Pradesh,2025-05-01,1264,0,1264,59,2
Asthma,Amritsar,Himachal Pradesh,2025-06-01,2780,117,2663,136,2
Asthma,Amritsar,Himachal Pradesh,2025-07-01,2711,0,2711,71,7
Asthma,Amritsar,Himachal Pradesh,2025-08-01,1163,38,1125,86,5
Asthma,Amritsar,Himachal Pradesh,2025-09-01,3880,290,3590,107,1
Asthma,Amritsar,Himachal Pradesh,2025-10-01,4989,314,4675,190,2
Asthma,Amritsar,Himachal Pradesh,2025-11-01,2575,84,2491,140,4
Asthma,Amritsar,Himachal Pradesh,2025-12-01,3275,167,3108,67,1
Asthma,Amritsar,Jammu & Kashmir,2018-01-01,2711,50,2661,114,4
Asthma,Amritsar,Jammu & Kashmir,2018-02-01,1640,82,1558,190,4
Asthma,Amritsar,Jammu & Kashmir,2018-03-01,155,20,135,138,2
Asthma,Amritsar,Jammu & Kashmir,2018-04-01,1651,171,1480,25,7
Asthma,Amritsar,Jammu & Kashmir,2018-05-01,730,37,693,60,2
Asthma,Amritsar,Jammu & Kashmir,2018-06-01,4883,267,4616,56,8
Asthma,Amritsar,Jammu & Kashmir,2018-07-01,2443,52,2391,180,4
Asthma,Amritsar,Jammu & Kashmir,2018-08-01,2133,57,2076,170,3
Asthma,Amritsar,Jammu & Kashmir,2018-09-01,3790,229,3561,74,6
Asthma,Amritsar,Jammu & Kashmir,2018-10-01,1093,38,1055,73,5
Asthma,Amritsar,Jammu & Kashmir,2018-11-01,1569,119,1450,108,7
Asthma,Amritsar,Jammu & Kashmir,2018-12-01,2689,257,2432,110,1
Asthma,Amritsar,Jammu & Kashmir,2019-01-01,3978,237,3741,57,6
Asthma,Amritsar,Jammu & Kashmir,2019-02-01,3270,173,3097,94,3
Asthma,Amritsar,Jammu & Kashmir,2019-03-01,2931,3,2928,32,5
Asthma,Amritsar,Jammu & Kashmir,2019-04-01,2702,194,2508,171,5
Asthma,Amritsar,Jammu & Kashmir,2019-05-01,3134,52,3082,17,9
Asthma,Amritsar,Jammu & Kashmir,2019-06-01,2868,108,2760,16,1
Asthma,Amritsar,Jammu & Kashmir,2019-07-01,1216,94,1122,128,10
Asthma,Amritsar,Jammu & Kashmir,2019-08-01,2659,212,2447,43,7
Asthma,Amritsar,Jammu & Kashmir,2019-09-01,1157,42,1115,81,5
Asthma,Amritsar,Jammu & Kashmir,2019-10-01,2706,103,2603,109,1
Asthma,Amritsar,Jammu & Kashmir,2019-11-01,1953,58,1895,141,1
Asthma,Amritsar,Jammu & Kashmir,2019-12-01,4989,75,4914,95,3
Asthma,Amritsar,Jammu & Kashmir,2020-01-01,2544,80,2464,197,7
Asthma,Amritsar,Jammu & Kashmir,2020-02-01,714,2,712,106,5
Asthma,Amritsar,Jammu & Kashmir,2020-03-01,2417,169,2248,167,6
Asthma,Amritsar,Jammu & Kashmir,2020-04-01,3294,202,3092,120,1
Asthma,Amritsar,Jammu & Kashmir,2020-05-01,4842,321,4521,200,5
Asthma,Amritsar,Jammu & Kashmir,2020-06-01,1807,40,1767,160,8
Asthma,Amritsar,Jammu & Kashmir,2020-07-01,475,7,468,108,9
Asthma,Amritsar,Jammu & Kashmir,2020-08-01,3693,190,3503,138,1
Asthma,Amritsar,Jammu & Kashmir,2020-09-01,745,38,707,93,4
Asthma,Amritsar,Jammu & Kashmir,2020-10-01,2012,92,1920,92,4
Asthma,Amritsar,Jammu & Kashmir,2020-11-01,2252,93,2159,40,3
Asthma,Amritsar,Jammu & Kashmir,2020-12-01,2504,250,2254,65,7
Asthma,Amritsar,Jammu & Kashmir,2021-01-01,3522,220,3302,200,10
Asthma,Amritsar,Jammu & Kashmir,2021-02-01,1680,180,1500,45,2
Asthma,Amritsar,Jammu & Kashmir,2021-03-01,2230,194,2036,73,6
Asthma,Amritsar,Jammu & Kashmir,2021-04-01,2578,256,2322,101,6
Asthma,Amritsar,Jammu & Kashmir,2021-05-01,2798,52,2746,103,6
Asthma,Amritsar,Jammu & Kashmir,2021-06-01,2729,183,2546,126,9
Asthma,Amritsar,Jammu & Kashmir,2021-07-01,3182,119,3063,82,6
Asthma,Amritsar,Jammu & Kashmir,2021-08-01,3729,6,3723,129,1
Asthma,Amritsar,Jammu & Kashmir,2021-09-01,3124,292,2832,164,1
Asthma,Amritsar,Jammu & Kashmir,2021-10-01,3206,133,3073,171,2
Asthma,Amritsar,Jammu & Kashmir,2021-11-01,475,9,466,93,3
Asthma,Amritsar,Jammu & Kashmir,2021-12-01,2665,101,2564,137,4
Asthma,Amritsar,Jammu & Kashmir,2022-01-01,3241,87,3154,48,4
Asthma,Amritsar,Jammu & Kashmir,2022-02-01,3575,106,3469,69,1
Asthma,Amritsar,Jammu & Kashmir,2022-03-01,1669,72,1597,46,1
Asthma,Amritsar,Jammu & Kashmir,2022-04-01,1713,172,1541,104,1
Asthma,Amritsar,Jammu & Kashmir,2022-05-01,1827,56,1771,62,1
Asthma,Amritsar,Jammu & Kashmir,2022-06-01,3317,326,2991,29,8
Asthma,Amritsar,Jammu & Kashmir,2022-07-01,3984,297,3687,87,4
Asthma,Amritsar,Jammu & Kashmir,2022-08-01,2051,126,1925,18,2
Asthma,Amritsar,Jammu & Kashmir,2022-09-01,3815,274,3541,174,1
Asthma,Amritsar,Jammu & Kashmir,2022-10-01,2763,139,2624,78,2
Asthma,Amritsar,Jammu & Kashmir,2022-11-01,2431,212,2219,156,7
Asthma,Amritsar,Jammu & Kashmir,2022-12-01,2314,154,2160,81,6
Asthma,Amritsar,Jammu & Kashmir,2023-01-01,3599,5,3594,45,4
Asthma,Amritsar,Jammu & Kashmir,2023-02-01,3034,178,2856,166,4
Asthma,Amritsar,Jammu & Kashmir,2023-03-01,4989,363,4626,111,1
Asthma,Amritsar,Jammu & Kashmir,2023-04-01,1454,60,1394,200,3
Asthma,Amritsar,Jammu & Kashmir,2023-05-01,3292,176,3116,82,6
Asthma,Amritsar,Jammu & Kashmir,2023-06-01,1887,60,1827,84,3
Asthma,Amritsar,Jammu & Kashmir,2023-07-01,1431,14,1417,157,10
Asthma,Amritsar,Jammu & Kashmir,2023-08-01,2583,12,2571,158,8
Asthma,Amritsar,Jammu & Kashmir,2023-09-01,2782,14,2768,114,4
Asthma,Amritsar,Jammu & Kashmir,2023-10-01,4989,346,4643,200,4
Asthma,Amritsar,Jammu & Kashmir,2023-11-01,2350,0,2350,92,10
Asthma,Amritsar,Jammu & Kashmir,2023-12-01,1081,33,1048,42,7
Asthma,Amritsar,Jammu & Kashmir,2024-01-01,2964,82,2882,55,5
Asthma,Amritsar,Jammu & Kashmir,2024-02-01,78,0,78,92,5
Asthma,Amritsar,Jammu & Kashmir,2024-03-01,2474,0,2474,184,5
Asthma,Amritsar,Jammu & Kashmir,2024-04-01,2619,161,2458,97,5
Asthma,Amritsar,Jammu & Kashmir,2024-05-01,3663,47,3616,186,2
Asthma,Amritsar,Jammu & Kashmir,2024-06-01,3904,324,3580,128,4
Asthma,Amritsar,Jammu & Kashmir,2024-07-01,1922,61,1861,161,1
Asthma,Amritsar,Jammu & Kashmir,2024-08-01,2395,113,2282,126,7
Asthma,Amritsar,Jammu & Kashmir,2024-09-01,1570,78,1492,126,4
Asthma,Amritsar,Jammu & Kashmir,2024-10-01,1084,61,1023,145,7
Asthma,Amritsar,Jammu & Kashmir,2024-11-01,3013,154,2859,77,1
Asthma,Amritsar,Jammu & Kashmir,2024-12-01,889,33,856,78,9
Asthma,Amritsar,Jammu & Kashmir,2025-01-01,2041,122,1919,124,9
Asthma,Amritsar,Jammu & Kashmir,2025-02-01,1262,80,1182,200,1
Asthma,Amritsar,Jammu & Kashmir,2025-03-01,3335,92,3243,28,3
Asthma,Amritsar,Jammu & Kashmir,2025-04-01,4989,311,4678,11,4
Asthma,Amritsar,Jammu & Kashmir,2025-05-01,851,72,779,93,1
Asthma,Amritsar,Jammu & Kashmir,2025-06-01,112,7,105,159,4
Asthma,Amritsar,Jammu & Kashmir,2025-07-01,2430,187,2243,109,6
Asthma,Amritsar,Jammu & Kashmir,2025-08-01,2618,144,2474,47,3
Asthma,Amritsar,Jammu & Kashmir,2025-09-01,2891,65,2826,110,1
Asthma,Amritsar,Jammu & Kashmir,2025-10-01,1999,52,1947,18,7
Asthma,Amritsar,Jammu & Kashmir,2025-11-01,2328,138,2190,138,3
Asthma,Amritsar,Jammu & Kashmir,2025-12-01,3090,239,2851,90,3
Asthma,Amritsar,Haryana,2018-01-01,3993,442,3551,102,10
Asthma,Amritsar,Haryana,2018-02-01,78,0,78,128,6
Asthma,Amritsar,Haryana,2018-03-01,2102,33,2069,117,2
Asthma,Amritsar,Haryana,2018-04-01,2884,80,2804,79,1
Asthma,Amritsar,Haryana,2018-05-01,1366,158,1208,159,8
Asthma,Amritsar,Haryana,2018-06-01,4920,215,4705,147,7
Asthma,Amritsar,Haryana,2018-07-01,1745,89,1656,16,3
Asthma,Amritsar,Haryana,2018-08-01,2542,56,2486,94,1
Asthma,Amritsar,Haryana,2018-09-01,3343,319,3024,51,6
Asthma,Amritsar,Haryana,2018-10-01,1804,116,1688,42,7
Asthma,Amritsar,Haryana,2018-11-01,120,3,117,133,4
Asthma,Amritsar,Haryana,2018-12-01,2022,42,1980,85,2
Asthma,Amritsar,Haryana,2019-01-01,3978,234,3744,99,5
Asthma,Amritsar,Haryana,2019-02-01,2145,110,2035,72,6
Asthma,Amritsar,Haryana,2019-03-01,1462,108,1354,125,3
Asthma,Amritsar,Haryana,2019-04-01,3839,253,3586,141,6
Asthma,Amritsar,Haryana,2019-05-01,2154,91,2063,200,6
Asthma,Amritsar,Haryana,2019-06-01,1913,65,1848,97,8
Asthma,Amritsar,Haryana,2019-07-01,2798,127,2671,32,4
Asthma,Amritsar,Haryana,2019-08-01,3631,123,3508,81,2
Asthma,Amritsar,Haryana,2019-09-01,4989,230,4759,149,5
Asthma,Amritsar,Haryana,2019-10-01,3707,187,3520,67,10
Asthma,Amritsar,Haryana,2019-11-01,4153,99,4054,31,1
Asthma,Amritsar,Haryana,2019-12-01,1919,131,1788,68,1
Asthma,Amritsar,Haryana,2020-01-01,1221,47,1174,79,5
Asthma,Amritsar,Haryana,2020-02-01,2681,68,2613,51,4
Asthma,Amritsar,Haryana,2020-03-01,2741,109,2632,117,4
Asthma,Amritsar,Haryana,2020-04-01,1151,65,1086,102,4
Asthma,Amritsar,Haryana,2020-05-01,2362,123,2239,146,8
Asthma,Amritsar,Haryana,2020-06-01,3133,195,2938,83,5
Asthma,Amritsar,Haryana,2020-07-01,3081,234,2847,135,7
Asthma,Amritsar,Haryana,2020-08-01,3274,288,2986,81,1
Asthma,Amritsar,Haryana,2020-09-01,2988,174,2814,49,3
Asthma,Amritsar,Haryana,2020-10-01,1917,36,1881,79,2
Asthma,Amritsar,Haryana,2020-11-01,1908,80,1828,24,1
Asthma,Amritsar,Haryana,2020-12-01,989,20,969,197,5
Asthma,Amritsar,Haryana,2021-01-01,4989,442,4547,113,5
Asthma,Amritsar,Haryana,2021-02-01,2615,282,2333,66,3
Asthma,Amritsar,Haryana,2021-03-01,2296,158,2138,87,4
Asthma,Amritsar,Haryana,2021-04-01,1351,101,1250,11,5
Asthma,Amritsar,Haryana,2021-05-01,4989,286,4703,179,8
Asthma,Amritsar,Haryana,2021-06-01,1158,70,1088,174,7
Asthma,Amritsar,Haryana,2021-07-01,2022,7,2015,112,6
Asthma,Amritsar,Haryana,2021-08-01,3155,151,3004,122,10
Asthma,Amritsar,Haryana,2021-09-01,3403,83,3320,42,3
Asthma,Amritsar,Haryana,2021-10-01,3882,226,3656,45,1
Asthma,Amritsar,Haryana,2021-11-01,4989,241,4748,20,8
Asthma,Amritsar,Haryana,2021-12-01,3276,349,2927,98,10
Asthma,Amritsar,Haryana,2022-01-01,1181,90,1091,160,3
Asthma,Amritsar,Haryana,2022-02-01,2253,131,2122,87,9
Asthma,Amritsar,Haryana,2022-03-01,3010,127,2883,124,3
Asthma,Amritsar,Haryana,2022-04-01,4989,442,4547,156,7
Asthma,Amritsar,Haryana,2022-05-01,722,35,687,23,7
Asthma,Amritsar,Haryana,2022-06-01,4211,251,3960,200,3
Asthma,Amritsar,Haryana,2022-07-01,2839,145,2694,165,10
Asthma,Amritsar,Haryana,2022-08-01,3721,142,3579,132,10
Asthma,Amritsar,Haryana,2022-09-01,2461,125,2336,153,2
Asthma,Amritsar,Haryana,2022-10-01,1467,0,1467,156,5
Asthma,Amritsar,Haryana,2022-11-01,3605,18,3587,121,7
Asthma,Amritsar,Haryana,2022-12-01,3475,209,3266,179,1
Asthma,Amritsar,Haryana,2023-01-01,3901,373,3528,83,5
Asthma,Amritsar,Haryana,2023-02-01,2580,155,2425,130,1
Asthma,Amritsar,Haryana,2023-03-01,1793,52,1741,174,7
Asthma,Amritsar,Haryana,2023-04-01,506,4,502,11,5
Asthma,Amritsar,Haryana,2023-05-01,3697,269,3428,129,4
Asthma,Amritsar,Haryana,2023-06-01,3166,106,3060,143,1
Asthma,Amritsar,Haryana,2023-07-01,1302,89,1213,19,3
Asthma,Amritsar,Haryana,2023-08-01,1875,115,1760,121,6
Asthma,Amritsar,Haryana,2023-09-01,1971,126,1845,66,5
Asthma,Amritsar,Haryana,2023-10-01,608,31,577,126,8
Asthma,Amritsar,Haryana,2023-11-01,1500,91,1409,101,8
Asthma,Amritsar,Haryana,2023-12-01,1076,50,1026,58,8
Asthma,Amritsar,Haryana,2024-01-01,2044,64,1980,163,3
Asthma,Amritsar,Haryana,2024-02-01,1606,35,1571,85,6
Asthma,Amritsar,Haryana,2024-03-01,415,0,415,120,2
Asthma,Amritsar,Haryana,2024-04-01,4989,223,4766,173,1
Asthma,Amritsar,Haryana,2024-05-01,4278,403,3875,60,8
Asthma,Amritsar,Haryana,2024-06-01,1552,110,1442,107,1
Asthma,Amritsar,Haryana,2024-07-01,2963,167,2796,81,1
Asthma,Amritsar,Haryana,2024-08-01,3157,90,3067,92,5
Asthma,Amritsar,Haryana,2024-09-01,4195,331,3864,200,4
Asthma,Amritsar,Haryana,2024-10-01,1499,69,1430,129,4
Asthma,Amritsar,Haryana,2024-11-01,4062,389,3673,122,10
Asthma,Amritsar,Haryana,2024-12-01,1862,40,1822,133,2
Asthma,Amritsar,Haryana,2025-01-01,805,22,783,128,6
Asthma,Amritsar,Haryana,2025-02-01,3569,90,3479,13,5
Asthma,Amritsar,Haryana,2025-03-01,4329,30,4299,200,8
Asthma,Amritsar,Haryana,2025-04-01,4989,113,4876,32,3
Asthma,Amritsar,Haryana,2025-05-01,988,52,936,194,4
Asthma,Amritsar,Haryana,2025-06-01,3535,103,3432,138,5
Asthma,Amritsar,Haryana,2025-07-01,2048,0,2048,115,1
Asthma,Amritsar,Haryana,2025-08-01,3648,296,3352,91,1
Asthma,Amritsar,Haryana,2025-09-01,625,0,625,200,5
Asthma,Amritsar,Haryana,2025-10-01,903,60,843,137,9
Asthma,Amritsar,Haryana,2025-11-01,1557,79,1478,107,4
Asthma,Amritsar,Haryana,2025-12-01,2703,301,2402,79,4
Asthma,Ludhiana,Punjab,2018-01-01,1737,137,1600,73,8
Asthma,Ludhiana,Punjab,2018-02-01,3482,123,3359,109,4
Asthma,Ludhiana,Punjab,2018-03-01,3975,117,3858,59,7
Asthma,Ludhiana,Punjab,2018-04-01,3402,319,3083,141,10
Asthma,Ludhiana,Punjab,2018-05-01,4769,33,4736,73,3
Asthma,Ludhiana,Punjab,2018-06-01,3155,175,2980,157,4
Asthma,Ludhiana,Punjab,2018-07-01,965,44,921,156,6
Asthma,Ludhiana,Punjab,2018-08-01,4426,177,4249,103,9
Asthma,Ludhiana,Punjab,2018-09-01,1786,107,1679,136,4
Asthma,Ludhiana,Punjab,2018-10-01,3819,212,3607,138,7
Asthma,Ludhiana,Punjab,2018-11-01,4709,298,4411,32,6
Asthma,Ludhiana,Punjab,2018-12-01,3210,173,3037,194,5
Asthma,Ludhiana,Punjab,2019-01-01,590,36,554,93,4
Asthma,Ludhiana,Punjab,2019-02-01,1366,72,1294,142,3
Asthma,Ludhiana,Punjab,2019-03-01,4372,135,4237,143,10
Asthma,Ludhiana,Punjab,2019-04-01,2371,118,2253,11,1
Asthma,Ludhiana,Punjab,2019-05-01,2704,79,2625,73,1
Asthma,Ludhiana,Punjab,2019-06-01,3615,98,3517,149,6
Asthma,Ludhiana,Punjab,2019-07-01,3532,142,3390,109,5
Asthma,Ludhiana,Punjab,2019-08-01,2971,138,2833,141,6
Asthma,Ludhiana,Punjab,2019-09-01,2317,118,2199,111,2
Asthma,Ludhiana,Punjab,2019-10-01,2178,167,2011,169,2
Asthma,Ludhiana,Punjab,2019-11-01,3748,133,3615,112,4
Asthma,Ludhiana,Punjab,2019-12-01,3340,186,3154,179,7
Asthma,Ludhiana,Punjab,2020-01-01,2252,120,2132,56,2
Asthma,Ludhiana,Punjab,2020-02-01,4049,131,3918,100,5
Asthma,Ludhiana,Punjab,2020-03-01,2424,126,2298,76,3
Asthma,Ludhiana,Punjab,2020-04-01,1455,115,1340,126,1
Asthma,Ludhiana,Punjab,2020-05-01,1579,87,1492,92,1
Asthma,Ludhiana,Punjab,2020-06-01,1284,72,1212,95,7
Asthma,Ludhiana,Punjab,2020-07-01,2232,65,2167,70,3
Asthma,Ludhiana,Punjab,2020-08-01,4252,442,3810,83,8
Asthma,Ludhiana,Punjab,2020-09-01,1517,47,1470,106,5
Asthma,Ludhiana,Punjab,2020-10-01,2850,4,2846,11,1
Asthma,Ludhiana,Punjab,2020-11-01,1716,128,1588,11,6
Asthma,Ludhiana,Punjab,2020-12-01,2248,105,2143,109,2
Asthma,Ludhiana,Punjab,2021-01-01,572,23,549,11,4
Asthma,Ludhiana,Punjab,2021-02-01,2302,78,2224,96,8
Asthma,Ludhiana,Punjab,2021-03-01,2338,244,2094,87,1
Asthma,Ludhiana,Punjab,2021-04-01,3322,200,3122,134,4
Asthma,Ludhiana,Punjab,2021-05-01,2897,191,2706,72,2
Asthma,Ludhiana,Punjab,2021-06-01,990,54,936,186,1
Asthma,Ludhiana,Punjab,2021-07-01,4052,234,3818,149,3
Asthma,Ludhiana,Punjab,2021-08-01,2880,261,2619,29,2
Asthma,Ludhiana,Punjab,2021-09-01,2864,122,2742,92,4
Asthma,Ludhiana,Punjab,2021-10-01,2585,19,2566,184,7
Asthma,Ludhiana,Punjab,2021-11-01,1903,143,1760,71,3
Asthma,Ludhiana,Punjab,2021-12-01,2890,186,2704,104,1
Asthma,Ludhiana,Punjab,2022-01-01,3235,172,3063,178,7
Asthma,Ludhiana,Punjab,2022-02-01,254,16,238,79,3
Asthma,Ludhiana,Punjab,2022-03-01,1875,73,1802,163,10
Asthma,Ludhiana,Punjab,2022-04-01,2255,114,2141,60,4
Asthma,Ludhiana,Punjab,2022-05-01,2941,135,2806,11,4
Asthma,Ludhiana,Punjab,2022-06-01,4198,137,4061,169,1
Asthma,Ludhiana,Punjab,2022-07-01,1562,132,1430,129,1
Asthma,Ludhiana,Punjab,2022-08-01,1929,17,1912,132,1
Asthma,Ludhiana,Punjab,2022-09-01,1910,226,1684,51,6
Asthma,Ludhiana,Punjab,2022-10-01,1522,115,1407,55,5
Asthma,Ludhiana,Punjab,2022-11-01,2132,0,2132,165,7
Asthma,Ludhiana,Punjab,2022-12-01,3631,158,3473,119,7
Asthma,Ludhiana,Punjab,2023-01-01,1184,53,1131,100,8
Asthma,Ludhiana,Punjab,2023-02-01,3171,194,2977,117,4
Asthma,Ludhiana,Punjab,2023-03-01,314,6,308,183,5
Asthma,Ludhiana,Punjab,2023-04-01,1844,94,1750,143,7
Asthma,Ludhiana,Punjab,2023-05-01,2155,100,2055,82,3
Asthma,Ludhiana,Punjab,2023-06-01,4844,138,4706,35,2
Asthma,Ludhiana,Punjab,2023-07-01,2229,54,2175,136,9
Asthma,Ludhiana,Punjab,2023-08-01,78,0,78,59,1
Asthma,Ludhiana,Punjab,2023-09-01,78,0,78,46,6
Asthma,Ludhiana,Punjab,2023-10-01,2643,169,2474,173,6
Asthma,Ludhiana,Punjab,2023-11-01,3421,250,3171,151,2
Asthma,Ludhiana,Punjab,2023-12-01,3101,135,2966,126,3
Asthma,Ludhiana,Punjab,2024-01-01,2822,145,2677,43,4
Asthma,Ludhiana,Punjab,2024-02-01,4157,348,3809,197,5
Asthma,Ludhiana,Punjab,2024-03-01,1874,55,1819,159,6
Asthma,Ludhiana,Punjab,2024-04-01,3798,123,3675,91,5
Asthma,Ludhiana,Punjab,2024-05-01,408,14,394,80,5
Asthma,Ludhiana,Punjab,2024-06-01,1383,116,1267,110,7
Asthma,Ludhiana,Punjab,2024-07-01,173,15,158,82,7
Asthma,Ludhiana,Punjab,2024-08-01,2229,21,2208,200,9
Asthma,Ludhiana,Punjab,2024-09-01,2535,201,2334,87,8
Asthma,Ludhiana,Punjab,2024-10-01,2750,203,2547,52,5
Asthma,Ludhiana,Punjab,2024-11-01,2680,255,2425,187,7
Asthma,Ludhiana,Punjab,2024-12-01,1353,82,1271,77,6
Asthma,Ludhiana,Punjab,2025-01-01,2342,114,2228,146,5
Asthma,Ludhiana,Punjab,2025-02-01,589,49,540,141,2
Asthma,Ludhiana,Punjab,2025-03-01,4426,311,4115,103,5
Asthma,Ludhiana,Punjab,2025-04-01,2190,252,1938,57,1
Asthma,Ludhiana,Punjab,2025-05-01,1942,151,1791,104,8
Asthma,Ludhiana,Punjab,2025-06-01,4729,257,4472,47,6
Asthma,Ludhiana,Punjab,2025-07-01,931,14,917,105,4
Asthma,Ludhiana,Punjab,2025-08-01,1087,36,1051,146,4
Asthma,Ludhiana,Punjab,2025-09-01,1127,9,1118,194,7
Asthma,Ludhiana,Punjab,2025-10-01,2506,109,2397,51,10
Asthma,Ludhiana,Punjab,2025-11-01,3176,244,2932,93,6
Asthma,Ludhiana,Punjab,2025-12-01,3590,179,3411,79,10
Asthma,Ludhiana,Chandigarh,2018-01-01,4989,398,4591,120,7
Asthma,Ludhiana,Chandigarh,2018-02-01,78,0,78,29,2
Asthma,Ludhiana,Chandigarh,2018-03-01,3414,130,3284,59,6
Asthma,Ludhiana,Chandigarh,2018-04-01,1850,97,1753,20,6
Asthma,Ludhiana,Chandigarh,2018-05-01,1811,115,1696,33,2
Asthma,Ludhiana,Chandigarh,2018-06-01,1766,95,1671,73,4
Asthma,Ludhiana,Chandigarh,2018-07-01,1378,75,1303,191,4
Asthma,Ludhiana,Chandigarh,2018-08-01,4857,134,4723,124,5
Asthma,Ludhiana,Chandigarh,2018-09-01,3727,139,3588,110,4
Asthma,Ludhiana,Chandigarh,2018-10-01,2629,304,2325,175,6
Asthma,Ludhiana,Chandigarh,2018-11-01,4410,378,4032,126,6
Asthma,Ludhiana,Chandigarh,2018-12-01,568,4,564,131,9
Asthma,Ludhiana,Chandigarh,2019-01-01,812,0,812,82,6
Asthma,Ludhiana,Chandigarh,2019-02-01,78,0,78,74,3
Asthma,Ludhiana,Chandigarh,2019-03-01,1659,126,1533,39,10
Asthma,Ludhiana,Chandigarh,2019-04-01,2814,98,2716,76,3
Asthma,Ludhiana,Chandigarh,2019-05-01,2735,218,2517,92,4
Asthma,Ludhiana,Chandigarh,2019-06-01,2798,144,2654,124,7
Asthma,Ludhiana,Chandigarh,2019-07-01,704,31,673,104,10
Asthma,Ludhiana,Chandigarh,2019-08-01,3675,264,3411,88,6
Asthma,Ludhiana,Chandigarh,2019-09-01,2919,100,2819,60,3
Asthma,Ludhiana,Chandigarh,2019-10-01,3581,149,3432,127,1
Asthma,Ludhiana,Chandigarh,2019-11-01,78,0,78,81,1
Asthma,Ludhiana,Chandigarh,2019-12-01,3015,148,2867,124,5
Asthma,Ludhiana,Chandigarh,2020-01-01,1004,106,898,11,6
Asthma,Ludhiana,Chandigarh,2020-02-01,2064,145,1919,123,1
Asthma,Ludhiana,Chandigarh,2020-03-01,3314,226,3088,144,5
Asthma,Ludhiana,Chandigarh,2020-04-01,2720,132,2588,138,1
Asthma,Ludhiana,Chandigarh,2020-05-01,1455,109,1346,96,2
Asthma,Ludhiana,Chandigarh,2020-06-01,2606,106,2500,153,7
Asthma,Ludhiana,Chandigarh,2020-07-01,543,31,512,41,3
Asthma,Ludhiana,Chandigarh,2020-08-01,4140,96,4044,102,9
Asthma,Ludhiana,Chandigarh,2020-09-01,2322,186,2136,96,3
Asthma,Ludhiana,Chandigarh,2020-10-01,4098,239,3859,159,8
Asthma,Ludhiana,Chandigarh,2020-11-01,1891,203,1688,11,10
Asthma,Ludhiana,Chandigarh,2020-12-01,1895,226,1669,52,3
Asthma,Ludhiana,Chandigarh,2021-01-01,1572,113,1459,195,10
Asthma,Ludhiana,Chandigarh,2021-02-01,3773,196,3577,11,5
Asthma,Ludhiana,Chandigarh,2021-03-01,1646,37,1609,148,3
Asthma,Ludhiana,Chandigarh,2021-04-01,3462,264,3198,71,4
Asthma,Ludhiana,Chandigarh,2021-05-01,2084,117,1967,119,4
Asthma,Ludhiana,Chandigarh,2021-06-01,78,0,78,178,9
Asthma,Ludhiana,Chandigarh,2021-07-01,1832,183,1649,121,9
Asthma,Ludhiana,Chandigarh,2021-08-01,1016,26,990,179,9
Asthma,Ludhiana,Chandigarh,2021-09-01,2643,61,2582,81,1
Asthma,Ludhiana,Chandigarh,2021-10-01,1000,43,957,88,5
Asthma,Ludhiana,Chandigarh,2021-11-01,3840,284,3556,146,1
Asthma,Ludhiana,Chandigarh,2021-12-01,2475,163,2312,84,8
Asthma,Ludhiana,Chandigarh,2022-01-01,2359,56,2303,137,3
Asthma,Ludhiana,Chandigarh,2022-02-01,3477,250,3227,167,6
Asthma,Ludhiana,Chandigarh,2022-03-01,3890,58,3832,150,3
Asthma,Ludhiana,Chandigarh,2022-04-01,2570,66,2504,26,1
Asthma,Ludhiana,Chandigarh,2022-05-01,1563,73,1490,89,7
Asthma,Ludhiana,Chandigarh,2022-06-01,218,7,211,121,8
Asthma,Ludhiana,Chandigarh,2022-07-01,1677,127,1550,94,5
Asthma,Ludhiana,Chandigarh,2022-08-01,1769,103,1666,110,1
Asthma,Ludhiana,Chandigarh,2022-09-01,2741,278,2463,121,7
Asthma,Ludhiana,Chandigarh,2022-10-01,2134,91,2043,79,3
Asthma,Ludhiana,Chandigarh,2022-11-01,3520,163,3357,96,6
Asthma,Ludhiana,Chandigarh,2022-12-01,1775,151,1624,46,3
Asthma,Ludhiana,Chandigarh,2023-01-01,2521,119,2402,82,4
Asthma,Ludhiana,Chandigarh,2023-02-01,4186,391,3795,28,6
Asthma,Ludhiana,Chandigarh,2023-03-01,3056,201,2855,112,2
Asthma,Ludhiana,Chandigarh,2023-04-01,2517,0,2517,96,4
Asthma,Ludhiana,Chandigarh,2023-05-01,1790,150,1640,60,6
Asthma,Ludhiana,Chandigarh,2023-06-01,1748,133,1615,197,10
Asthma,Ludhiana,Chandigarh,2023-07-01,1456,113,1343,94,5
Asthma,Ludhiana,Chandigarh,2023-08-01,1872,0,1872,121,7
Asthma,Ludhiana,Chandigarh,2023-09-01,3611,111,3500,74,1
Asthma,Ludhiana,Chandigarh,2023-10-01,2300,75,2225,85,10
Asthma,Ludhiana,Chandigarh,2023-11-01,787,20,767,123,2
Asthma,Ludhiana,Chandigarh,2023-12-01,4969,442,4527,89,4
Asthma,Ludhiana,Chandigarh,2024-01-01,3027,150,2877,106,6
Asthma,Ludhiana,Chandigarh,2024-02-01,710,34,676,147,3
Asthma,Ludhiana,Chandigarh,2024-03-01,2005,132,1873,80,8
Asthma,Ludhiana,Chandigarh,2024-04-01,2746,182,2564,38,3
Asthma,Ludhiana,Chandigarh,2024-05-01,4884,0,4884,28,7
Asthma,Ludhiana,Chandigarh,2024-06-01,1111,34,1077,179,8
Asthma,Ludhiana,Chandigarh,2024-07-01,3907,34,3873,154,7
Asthma,Ludhiana,Chandigarh,2024-08-01,4475,276,4199,140,7
Asthma,Ludhiana,Chandigarh,2024-09-01,1754,73,1681,84,10
Asthma,Ludhiana,Chandigarh,2024-10-01,2225,112,2113,38,6
Asthma,Ludhiana,Chandigarh,2024-11-01,1207,0,1207,92,5
Asthma,Ludhiana,Chandigarh,2024-12-01,2324,95,2229,101,6
Asthma,Ludhiana,Chandigarh,2025-01-01,2548,210,2338,49,9
Asthma,Ludhiana,Chandigarh,2025-02-01,3482,317,3165,31,10
Asthma,Ludhiana,Chandigarh,2025-03-01,4060,288,3772,18,4
Asthma,Ludhiana,Chandigarh,2025-04-01,1594,17,1577,140,2
Asthma,Ludhiana,Chandigarh,2025-05-01,78,0,78,45,8
Asthma,Ludhiana,Chandigarh,2025-06-01,2569,182,2387,122,1
Asthma,Ludhiana,Chandigarh,2025-07-01,2991,139,2852,86,6
Asthma,Ludhiana,Chandigarh,2025-08-01,2932,0,2932,136,6
Asthma,Ludhiana,Chandigarh,2025-09-01,2159,168,1991,123,5
Asthma,Ludhiana,Chandigarh,2025-10-01,2765,90,2675,94,5
Asthma,Ludhiana,Chandigarh,2025-11-01,4630,278,4352,113,1
Asthma,Ludhiana,Chandigarh,2025-12-01,3110,161,2949,101,2
Asthma,Ludhiana,Himachal Pradesh,2018-01-01,2097,198,1899,75,8
Asthma,Ludhiana,Himachal Pradesh,2018-02-01,1926,89,1837,156,1
Asthma,Ludhiana,Himachal Pradesh,2018-03-01,2370,117,2253,85,5
Asthma,Ludhiana,Himachal Pradesh,2018-04-01,4793,442,4351,102,4
Asthma,Ludhiana,Himachal Pradesh,2018-05-01,2352,72,2280,34,1
Asthma,Ludhiana,Himachal Pradesh,2018-06-01,2571,189,2382,120,10
Asthma,Ludhiana,Himachal Pradesh,2018-07-01,1950,86,1864,75,2
Asthma,Ludhiana,Himachal Pradesh,2018-08-01,4072,85,3987,82,6
Asthma,Ludhiana,Himachal Pradesh,2018-09-01,4989,249,4740,63,3
Asthma,Ludhiana,Himachal Pradesh,2018-10-01,3202,224,2978,100,2
Asthma,Ludhiana,Himachal Pradesh,2018-11-01,2708,242,2466,11,4
Asthma,Ludhiana,Himachal Pradesh,2018-12-01,2647,246,2401,141,4
Asthma,Ludhiana,Himachal Pradesh,2019-01-01,78,0,78,104,4
Asthma,Ludhiana,Himachal Pradesh,2019-02-01,3597,76,3521,82,3
Asthma,Ludhiana,Himachal Pradesh,2019-03-01,2777,113,2664,27,2
Asthma,Ludhiana,Himachal Pradesh,2019-04-01,3172,49,3123,128,8
Asthma,Ludhiana,Himachal Pradesh,2019-05-01,1643,71,1572,74,5
Asthma,Ludhiana,Himachal Pradesh,2019-06-01,2082,83,1999,173,5
Asthma,Ludhiana,Himachal Pradesh,2019-07-01,2046,145,1901,131,2
Asthma,Ludhiana,Himachal Pradesh,2019-08-01,3968,0,3968,184,9
Asthma,Ludhiana,Himachal Pradesh,2019-09-01,2089,59,2030,113,5
Asthma,Ludhiana,Himachal Pradesh,2019-10-01,4989,144,4845,161,1
Asthma,Ludhiana,Himachal Pradesh,2019-11-01,3175,268,2907,130,6
Asthma,Ludhiana,Himachal Pradesh,2019-12-01,886,15,871,83,3
Asthma,Ludhiana,Himachal Pradesh,2020-01-01,2425,137,2288,116,7
Asthma,Ludhiana,Himachal Pradesh,2020-02-01,1723,79,1644,64,8
Asthma,Ludhiana,Himachal Pradesh,2020-03-01,78,0,78,200,8
Asthma,Ludhiana,Himachal Pradesh,2020-04-01,4743,319,4424,101,3
Asthma,Ludhiana,Himachal Pradesh,2020-05-01,3541,189,3352,108,4
Asthma,Ludhiana,Himachal Pradesh,2020-06-01,3313,112,3201,126,6
Asthma,Ludhiana,Himachal Pradesh,2020-07-01,2819,0,2819,51,7
Asthma,Ludhiana,Himachal Pradesh,2020-08-01,743,42,701,174,2
Asthma,Ludhiana,Himachal Pradesh,2020-09-01,1949,127,1822,54,5
Asthma,Ludhiana,Himachal Pradesh,2020-10-01,3727,15,3712,42,10
Asthma,Ludhiana,Himachal Pradesh,2020-11-01,1187,16,1171,98,3
Asthma,Ludhiana,Himachal Pradesh,2020-12-01,78,0,78,41,5
Asthma,Ludhiana,Himachal Pradesh,2021-01-01,2293,137,2156,186,10
Asthma,Ludhiana,Himachal Pradesh,2021-02-01,2407,51,2356,94,4
Asthma,Ludhiana,Himachal Pradesh,2021-03-01,2779,92,2687,11,1
Asthma,Ludhiana,Himachal Pradesh,2021-04-01,3575,0,3575,116,5
Asthma,Ludhiana,Himachal Pradesh,2021-05-01,3453,311,3142,134,10
Asthma,Ludhiana,Himachal Pradesh,2021-06-01,2945,36,2909,85,8
Asthma,Ludhiana,Himachal Pradesh,2021-07-01,4201,276,3925,37,2
Asthma,Ludhiana,Himachal Pradesh,2021-08-01,560,27,533,101,6
Asthma,Ludhiana,Himachal Pradesh,2021-09-01,3274,286,2988,82,4
Asthma,Ludhiana,Himachal Pradesh,2021-10-01,3438,92,3346,57,7
Asthma,Ludhiana,Himachal Pradesh,2021-11-01,935,48,887,52,3
Asthma,Ludhiana,Himachal Pradesh,2021-12-01,581,0,581,114,6
Asthma,Ludhiana,Himachal Pradesh,2022-01-01,1597,0,1597,152,10
Asthma,Ludhiana,Himachal Pradesh,2022-02-01,1710,115,1595,130,1
Asthma,Ludhiana,Himachal Pradesh,2022-03-01,3608,0,3608,18,7
Asthma,Ludhiana,Himachal Pradesh,2022-04-01,1773,76,1697,138,9
Asthma,Ludhiana,Himachal Pradesh,2022-05-01,1449,115,1334,146,1
Asthma,Ludhiana,Himachal Pradesh,2022-06-01,1777,127,1650,177,3
Asthma,Ludhiana,Himachal Pradesh,2022-07-01,4098,125,3973,58,4
Asthma,Ludhiana,Himachal Pradesh,2022-08-01,2615,10,2605,103,3
Asthma,Ludhiana,Himachal Pradesh,2022-09-01,2357,152,2205,135,2
Asthma,Ludhiana,Himachal Pradesh,2022-10-01,2450,218,2232,79,4
Asthma,Ludhiana,Himachal Pradesh,2022-11-01,4331,133,4198,134,7
Asthma,Ludhiana,Himachal Pradesh,2022-12-01,1592,42,1550,105,9
Asthma,Ludhiana,Himachal Pradesh,2023-01-01,4362,151,4211,63,9
Asthma,Ludhiana,Himachal Pradesh,2023-02-01,2880,192,2688,67,8
Asthma,Ludhiana,Himachal Pradesh,2023-03-01,2382,204,2178,170,10
Asthma,Ludhiana,Himachal Pradesh,2023-04-01,4989,69,4920,55,10
Asthma,Ludhiana,Himachal Pradesh,2023-05-01,1181,7,1174,47,5
Asthma,Ludhiana,Himachal Pradesh,2023-06-01,2123,250,1873,124,9
Asthma,Ludhiana,Himachal Pradesh,2023-07-01,944,42,902,105,6
Asthma,Ludhiana,Himachal Pradesh,2023-08-01,3875,222,3653,39,4
Asthma,Ludhiana,Himachal Pradesh,2023-09-01,4863,145,4718,80,5
Asthma,Ludhiana,Himachal Pradesh,2023-10-01,4838,311,4527,65,8
Asthma,Ludhiana,Himachal Pradesh,2023-11-01,4239,330,3909,74,9
Asthma,Ludhiana,Himachal Pradesh,2023-12-01,2332,137,2195,200,7
Asthma,Ludhiana,Himachal Pradesh,2024-01-01,2107,212,1895,91,4
Asthma,Ludhiana,Himachal Pradesh,2024-02-01,356,14,342,61,3
Asthma,Ludhiana,Himachal Pradesh,2024-03-01,4989,211,4778,200,1
Asthma,Ludhiana,Himachal Pradesh,2024-04-01,3227,183,3044,151,6
Asthma,Ludhiana,Himachal Pradesh,2024-05-01,1937,123,1814,143,6
Asthma,Ludhiana,Himachal Pradesh,2024-06-01,4379,248,4131,64,2
Asthma,Ludhiana,Himachal Pradesh,2024-07-01,1292,16,1276,167,6
Asthma,Ludhiana,Himachal Pradesh,2024-08-01,3143,185,2958,148,6
Asthma,Ludhiana,Himachal Pradesh,2024-09-01,2366,92,2274,114,1
Asthma,Ludhiana,Himachal Pradesh,2024-10-01,3454,114,3340,19,4
Asthma,Ludhiana,Himachal Pradesh,2024-11-01,2512,128,2384,105,9
Asthma,Ludhiana,Himachal Pradesh,2024-12-01,651,14,637,194,3
Asthma,Ludhiana,Himachal Pradesh,2025-01-01,2699,45,2654,117,5
Asthma,Ludhiana,Himachal Pradesh,2025-02-01,4004,0,4004,87,5
Asthma,Ludhiana,Himachal Pradesh,2025-03-01,2558,258,2300,95,5
Asthma,Ludhiana,Himachal Pradesh,2025-04-01,3637,240,3397,98,7
Asthma,Ludhiana,Himachal Pradesh,2025-05-01,1195,55,1140,65,8
Asthma,Ludhiana,Himachal Pradesh,2025-06-01,2562,78,2484,104,8
Asthma,Ludhiana,Himachal Pradesh,2025-07-01,1760,0,1760,180,4
Asthma,Ludhiana,Himachal Pradesh,2025-08-01,3599,103,3496,174,6
Asthma,Ludhiana,Himachal Pradesh,2025-09-01,2640,187,2453,68,7
Asthma,Ludhiana,Himachal Pradesh,2025-10-01,3523,273,3250,171,4
Asthma,Ludhiana,Himachal Pradesh,2025-11-01,4057,278,3779,145,3
Asthma,Ludhiana,Himachal Pradesh,2025-12-01,3525,192,3333,138,5
Asthma,Ludhiana,Jammu & Kashmir,2018-01-01,2964,260,2704,128,3
Asthma,Ludhiana,Jammu & Kashmir,2018-02-01,1258,50,1208,59,3
Asthma,Ludhiana,Jammu & Kashmir,2018-03-01,2594,211,2383,86,5
Asthma,Ludhiana,Jammu & Kashmir,2018-04-01,1882,73,1809,149,4
Asthma,Ludhiana,Jammu & Kashmir,2018-05-01,2136,52,2084,45,5
Asthma,Ludhiana,Jammu & Kashmir,2018-06-01,2095,43,2052,53,1
Asthma,Ludhiana,Jammu & Kashmir,2018-07-01,1283,24,1259,122,4
Asthma,Ludhiana,Jammu & Kashmir,2018-08-01,78,0,78,66,1
Asthma,Ludhiana,Jammu & Kashmir,2018-09-01,1701,48,1653,148,2
Asthma,Ludhiana,Jammu & Kashmir,2018-10-01,2857,57,2800,68,5
Asthma,Ludhiana,Jammu & Kashmir,2018-11-01,789,55,734,119,8
Asthma,Ludhiana,Jammu & Kashmir,2018-12-01,2618,156,2462,123,6
Asthma,Ludhiana,Jammu & Kashmir,2019-01-01,4989,389,4600,82,5
Asthma,Ludhiana,Jammu & Kashmir,2019-02-01,3970,258,3712,94,4
Asthma,Ludhiana,Jammu & Kashmir,2019-03-01,4802,135,4667,72,4
Asthma,Ludhiana,Jammu & Kashmir,2019-04-01,3122,163,2959,105,9
Asthma,Ludhiana,Jammu & Kashmir,2019-05-01,4164,223,3941,57,2
Asthma,Ludhiana,Jammu & Kashmir,2019-06-01,1626,37,1589,95,3
Asthma,Ludhiana,Jammu & Kashmir,2019-07-01,1733,31,1702,144,8
Asthma,Ludhiana,Jammu & Kashmir,2019-08-01,78,0,78,48,4
Asthma,Ludhiana,Jammu & Kashmir,2019-09-01,4189,442,3747,81,10
Asthma,Ludhiana,Jammu & Kashmir,2019-10-01,4664,177,4487,133,7
Asthma,Ludhiana,Jammu & Kashmir,2019-11-01,1855,159,1696,11,8
Asthma,Ludhiana,Jammu & Kashmir,2019-12-01,2257,82,2175,200,1
Asthma,Ludhiana,Jammu & Kashmir,2020-01-01,1586,120,1466,159,8
Asthma,Ludhiana,Jammu & Kashmir,2020-02-01,3111,237,2874,28,2
Asthma,Ludhiana,Jammu & Kashmir,2020-03-01,4107,319,3788,11,7
Asthma,Ludhiana,Jammu & Kashmir,2020-04-01,259,15,244,108,4
Asthma,Ludhiana,Jammu & Kashmir,2020-05-01,3147,283,2864,49,5
Asthma,Ludhiana,Jammu & Kashmir,2020-06-01,2226,135,2091,155,2
Asthma,Ludhiana,Jammu & Kashmir,2020-07-01,2750,274,2476,126,1
Asthma,Ludhiana,Jammu & Kashmir,2020-08-01,3213,9,3204,112,5
Asthma,Ludhiana,Jammu & Kashmir,2020-09-01,2345,141,2204,77,4
Asthma,Ludhiana,Jammu & Kashmir,2020-10-01,2458,143,2315,188,2
Asthma,Ludhiana,Jammu & Kashmir,2020-11-01,2310,52,2258,145,1
Asthma,Ludhiana,Jammu & Kashmir,2020-12-01,3899,260,3639,137,1
Asthma,Ludhiana,Jammu & Kashmir,2021-01-01,3159,21,3138,167,6
Asthma,Ludhiana,Jammu & Kashmir,2021-02-01,2893,89,2804,54,4
Asthma,Ludhiana,Jammu & Kashmir,2021-03-01,892,0,892,172,3
Asthma,Ludhiana,Jammu & Kashmir,2021-04-01,2090,199,1891,93,5
Asthma,Ludhiana,Jammu & Kashmir,2021-05-01,3803,164,3639,123,8
Asthma,Ludhiana,Jammu & Kashmir,2021-06-01,2648,299,2349,98,6
Asthma,Ludhiana,Jammu & Kashmir,2021-07-01,3482,255,3227,11,4
Asthma,Ludhiana,Jammu & Kashmir,2021-08-01,4967,313,4654,155,10
Asthma,Ludhiana,Jammu & Kashmir,2021-09-01,3991,131,3860,13,3
Asthma,Ludhiana,Jammu & Kashmir,2021-10-01,2722,53,2669,57,1
Asthma,Ludhiana,Jammu & Kashmir,2021-11-01,1912,124,1788,83,5
Asthma,Ludhiana,Jammu & Kashmir,2021-12-01,78,0,78,11,4
Asthma,Ludhiana,Jammu & Kashmir,2022-01-01,2372,26,2346,50,8
Asthma,Ludhiana,Jammu & Kashmir,2022-02-01,2160,12,2148,119,3
Asthma,Ludhiana,Jammu & Kashmir,2022-03-01,3121,69,3052,89,4
Asthma,Ludhiana,Jammu & Kashmir,2022-04-01,2391,246,2145,93,2
Asthma,Ludhiana,Jammu & Kashmir,2022-05-01,2168,248,1920,60,7
Asthma,Ludhiana,Jammu & Kashmir,2022-06-01,210,11,199,109,5
Asthma,Ludhiana,Jammu & Kashmir,2022-07-01,1336,72,1264,90,4
Asthma,Ludhiana,Jammu & Kashmir,2022-08-01,3237,130,3107,23,4
Asthma,Ludhiana,Jammu & Kashmir,2022-09-01,4899,112,4787,96,5
Asthma,Ludhiana,Jammu & Kashmir,2022-10-01,2467,222,2245,43,1
Asthma,Ludhiana,Jammu & Kashmir,2022-11-01,3037,317,2720,152,8
Asthma,Ludhiana,Jammu & Kashmir,2022-12-01,3875,93,3782,86,8
Asthma,Ludhiana,Jammu & Kashmir,2023-01-01,1510,71,1439,200,5
Asthma,Ludhiana,Jammu & Kashmir,2023-02-01,3089,114,2975,155,5
Asthma,Ludhiana,Jammu & Kashmir,2023-03-01,1604,60,1544,100,2
Asthma,Ludhiana,Jammu & Kashmir,2023-04-01,3758,317,3441,136,10
Asthma,Ludhiana,Jammu & Kashmir,2023-05-01,2801,33,2768,11,9
Asthma,Ludhiana,Jammu & Kashmir,2023-06-01,2998,190,2808,155,6
Asthma,Ludhiana,Jammu & Kashmir,2023-07-01,1548,110,1438,64,7
Asthma,Ludhiana,Jammu & Kashmir,2023-08-01,3546,162,3384,111,8
Asthma,Ludhiana,Jammu & Kashmir,2023-09-01,4989,379,4610,69,8
Asthma,Ludhiana,Jammu & Kashmir,2023-10-01,1245,67,1178,75,2
Asthma,Ludhiana,Jammu & Kashmir,2023-11-01,2142,183,1959,97,4
Asthma,Ludhiana,Jammu & Kashmir,2023-12-01,2908,16,2892,110,6
Asthma,Ludhiana,Jammu & Kashmir,2024-01-01,3652,145,3507,105,5
Asthma,Ludhiana,Jammu & Kashmir,2024-02-01,1847,88,1759,106,7
Asthma,Ludhiana,Jammu & Kashmir,2024-03-01,78,0,78,23,7
Asthma,Ludhiana,Jammu & Kashmir,2024-04-01,4421,81,4340,200,6
Asthma,Ludhiana,Jammu & Kashmir,2024-05-01,3618,95,3523,118,1
Asthma,Ludhiana,Jammu & Kashmir,2024-06-01,259,20,239,129,8
Asthma,Ludhiana,Jammu & Kashmir,2024-07-01,1782,52,1730,89,7
Asthma,Ludhiana,Jammu & Kashmir,2024-08-01,4701,123,4578,62,10
Asthma,Ludhiana,Jammu & Kashmir,2024-09-01,4540,335,4205,114,3
Asthma,Ludhiana,Jammu & Kashmir,2024-10-01,3857,11,3846,121,1
Asthma,Ludhiana,Jammu & Kashmir,2024-11-01,2361,0,2361,173,4
Asthma,Ludhiana,Jammu & Kashmir,2024-12-01,2709,107,2602,200,6
Asthma,Ludhiana,Jammu & Kashmir,2025-01-01,2422,19,2403,181,4
Asthma,Ludhiana,Jammu & Kashmir,2025-02-01,4111,37,4074,16,9
Asthma,Ludhiana,Jammu & Kashmir,2025-03-01,1422,94,1328,83,3
Asthma,Ludhiana,Jammu & Kashmir,2025-04-01,1516,114,1402,123,5
Asthma,Ludhiana,Jammu & Kashmir,2025-05-01,3953,288,3665,86,4
Asthma,Ludhiana,Jammu & Kashmir,2025-06-01,2538,208,2330,104,10
Asthma,Ludhiana,Jammu & Kashmir,2025-07-01,4447,383,4064,11,2
Asthma,Ludhiana,Jammu & Kashmir,2025-08-01,1697,0,1697,153,7
Asthma,Ludhiana,Jammu & Kashmir,2025-09-01,2524,159,2365,11,1
Asthma,Ludhiana,Jammu & Kashmir,2025-10-01,1360,47,1313,26,6
Asthma,Ludhiana,Jammu & Kashmir,2025-11-01,2607,73,2534,55,2
Asthma,Ludhiana,Jammu & Kashmir,2025-12-01,614,40,574,101,8
Asthma,Ludhiana,Haryana,2018-01-01,1943,0,1943,24,7
Asthma,Ludhiana,Haryana,2018-02-01,671,0,671,52,6
Asthma,Ludhiana,Haryana,2018-03-01,3528,241,3287,165,1
Asthma,Ludhiana,Haryana,2018-04-01,3559,228,3331,100,5
Asthma,Ludhiana,Haryana,2018-05-01,276,14,262,128,4
Asthma,Ludhiana,Haryana,2018-06-01,4387,107,4280,43,7
Asthma,Ludhiana,Haryana,2018-07-01,4989,357,4632,103,2
Asthma,Ludhiana,Haryana,2018-08-01,2659,185,2474,99,8
Asthma,Ludhiana,Haryana,2018-09-01,1737,91,1646,66,8
Asthma,Ludhiana,Haryana,2018-10-01,4989,78,4911,104,1
Asthma,Ludhiana,Haryana,2018-11-01,828,31,797,11,4
Asthma,Ludhiana,Haryana,2018-12-01,2624,195,2429,129,5
Asthma,Ludhiana,Haryana,2019-01-01,2838,251,2587,86,8
Asthma,Ludhiana,Haryana,2019-02-01,4402,178,4224,93,3
Asthma,Ludhiana,Haryana,2019-03-01,3080,131,2949,150,5
Asthma,Ludhiana,Haryana,2019-04-01,1928,87,1841,128,8
Asthma,Ludhiana,Haryana,2019-05-01,1321,76,1245,90,6
Asthma,Ludhiana,Haryana,2019-06-01,2139,70,2069,49,1
Asthma,Ludhiana,Haryana,2019-07-01,1247,0,1247,174,3
Asthma,Ludhiana,Haryana,2019-08-01,2662,225,2437,38,7
Asthma,Ludhiana,Haryana,2019-09-01,1841,188,1653,138,7
Asthma,Ludhiana,Haryana,2019-10-01,593,19,574,25,1
Asthma,Ludhiana,Haryana,2019-11-01,4281,81,4200,153,5
Asthma,Ludhiana,Haryana,2019-12-01,1930,88,1842,158,8
Asthma,Ludhiana,Haryana,2020-01-01,896,39,857,11,6
Asthma,Ludhiana,Haryana,2020-02-01,2372,187,2185,129,7
Asthma,Ludhiana,Haryana,2020-03-01,2689,138,2551,125,10
Asthma,Ludhiana,Haryana,2020-04-01,255,6,249,142,5
Asthma,Ludhiana,Haryana,2020-05-01,3042,35,3007,125,6
Asthma,Ludhiana,Haryana,2020-06-01,1193,89,1104,57,2
Asthma,Ludhiana,Haryana,2020-07-01,4893,330,4563,95,3
Asthma,Ludhiana,Haryana,2020-08-01,3300,267,3033,191,4
Asthma,Ludhiana,Haryana,2020-09-01,2061,45,2016,50,7
Asthma,Ludhiana,Haryana,2020-10-01,1598,165,1433,123,3
Asthma,Ludhiana,Haryana,2020-11-01,2457,0,2457,165,8
Asthma,Ludhiana,Haryana,2020-12-01,3419,241,3178,56,2
Asthma,Ludhiana,Haryana,2021-01-01,2563,0,2563,34,7
Asthma,Ludhiana,Haryana,2021-02-01,2306,62,2244,42,6
Asthma,Ludhiana,Haryana,2021-03-01,2676,255,2421,126,6
Asthma,Ludhiana,Haryana,2021-04-01,1787,132,1655,41,8
Asthma,Ludhiana,Haryana,2021-05-01,2137,73,2064,99,3
Asthma,Ludhiana,Haryana,2021-06-01,78,0,78,176,3
Asthma,Ludhiana,Haryana,2021-07-01,3904,206,3698,104,2
Asthma,Ludhiana,Haryana,2021-08-01,2998,194,2804,67,5
Asthma,Ludhiana,Haryana,2021-09-01,1560,134,1426,113,4
Asthma,Ludhiana,Haryana,2021-10-01,4989,183,4806,103,7
Asthma,Ludhiana,Haryana,2021-11-01,2714,8,2706,129,6
Asthma,Ludhiana,Haryana,2021-12-01,1207,65,1142,189,7
Asthma,Ludhiana,Haryana,2022-01-01,3747,137,3610,126,4
Asthma,Ludhiana,Haryana,2022-02-01,3131,38,3093,200,6
Asthma,Ludhiana,Haryana,2022-03-01,3127,183,2944,129,10
Asthma,Ludhiana,Haryana,2022-04-01,2026,88,1938,67,1
Asthma,Ludhiana,Haryana,2022-05-01,3202,188,3014,200,1
Asthma,Ludhiana,Haryana,2022-06-01,2246,53,2193,100,7
Asthma,Ludhiana,Haryana,2022-07-01,3343,214,3129,52,2
Asthma,Ludhiana,Haryana,2022-08-01,78,0,78,200,1
Asthma,Ludhiana,Haryana,2022-09-01,2015,52,1963,69,6
Asthma,Ludhiana,Haryana,2022-10-01,4908,211,4697,67,2
Asthma,Ludhiana,Haryana,2022-11-01,1568,158,1410,78,9
Asthma,Ludhiana,Haryana,2022-12-01,1787,130,1657,115,5
Asthma,Ludhiana,Haryana,2023-01-01,1996,162,1834,154,4
Asthma,Ludhiana,Haryana,2023-02-01,968,88,880,11,2
Asthma,Ludhiana,Haryana,2023-03-01,78,0,78,153,5
Asthma,Ludhiana,Haryana,2023-04-01,2288,117,2171,78,1
Asthma,Ludhiana,Haryana,2023-05-01,2780,254,2526,85,1
Asthma,Ludhiana,Haryana,2023-06-01,2527,201,2326,194,1
Asthma,Ludhiana,Haryana,2023-07-01,2403,189,2214,117,8
Asthma,Ludhiana,Haryana,2023-08-01,2655,270,2385,129,2
Asthma,Ludhiana,Haryana,2023-09-01,3970,150,3820,104,1
Asthma,Ludhiana,Haryana,2023-10-01,2342,83,2259,145,5
Asthma,Ludhiana,Haryana,2023-11-01,1827,108,1719,189,10
Asthma,Ludhiana,Haryana,2023-12-01,2220,99,2121,11,8
Asthma,Ludhiana,Haryana,2024-01-01,3375,200,3175,161,2
Asthma,Ludhiana,Haryana,2024-02-01,4492,429,4063,185,2
Asthma,Ludhiana,Haryana,2024-03-01,1755,63,1692,132,3
Asthma,Ludhiana,Haryana,2024-04-01,2730,112,2618,72,2
Asthma,Ludhiana,Haryana,2024-05-01,3051,168,2883,48,6
Asthma,Ludhiana,Haryana,2024-06-01,1266,54,1212,200,4
Asthma,Ludhiana,Haryana,2024-07-01,2625,0,2625,60,2
Asthma,Ludhiana,Haryana,2024-08-01,631,20,611,184,1
Asthma,Ludhiana,Haryana,2024-09-01,224,15,209,126,10
Asthma,Ludhiana,Haryana,2024-10-01,3089,283,2806,200,7
Asthma,Ludhiana,Haryana,2024-11-01,2082,34,2048,90,2
Asthma,Ludhiana,Haryana,2024-12-01,2869,46,2823,24,8
Asthma,Ludhiana,Haryana,2025-01-01,2573,131,2442,106,1
Asthma,Ludhiana,Haryana,2025-02-01,1288,0,1288,30,4
Asthma,Ludhiana,Haryana,2025-03-01,2537,94,2443,200,4
Asthma,Ludhiana,Haryana,2025-04-01,943,0,943,138,5
Asthma,Ludhiana,Haryana,2025-05-01,4463,401,4062,146,2
Asthma,Ludhiana,Haryana,2025-06-01,778,21,757,146,5
Asthma,Ludhiana,Haryana,2025-07-01,2335,229,2106,71,1
Asthma,Ludhiana,Haryana,2025-08-01,1199,98,1101,99,4
Asthma,Ludhiana,Haryana,2025-09-01,3363,105,3258,112,9
Asthma,Ludhiana,Haryana,2025-10-01,2153,40,2113,200,8
Asthma,Ludhiana,Haryana,2025-11-01,1902,84,1818,47,3
Asthma,Ludhiana,Haryana,2025-12-01,3742,175,3567,69,1
Asthma,Chandigarh,Punjab,2018-01-01,2637,158,2479,88,1
Asthma,Chandigarh,Punjab,2018-02-01,3290,90,3200,72,7
Asthma,Chandigarh,Punjab,2018-03-01,1281,91,1190,32,6
Asthma,Chandigarh,Punjab,2018-04-01,713,41,672,11,6
Asthma,Chandigarh,Punjab,2018-05-01,2741,110,2631,13,10
Asthma,Chandigarh,Punjab,2018-06-01,2170,63,2107,162,5
Asthma,Chandigarh,Punjab,2018-07-01,3438,153,3285,106,5
Asthma,Chandigarh,Punjab,2018-08-01,2490,65,2425,149,1
Asthma,Chandigarh,Punjab,2018-09-01,2873,148,2725,77,10
Asthma,Chandigarh,Punjab,2018-10-01,420,22,398,101,4
Asthma,Chandigarh,Punjab,2018-11-01,4989,287,4702,188,2
Asthma,Chandigarh,Punjab,2018-12-01,2377,241,2136,185,5
Asthma,Chandigarh,Punjab,2019-01-01,3533,163,3370,154,10
Asthma,Chandigarh,Punjab,2019-02-01,1476,117,1359,117,10
Asthma,Chandigarh,Punjab,2019-03-01,3011,170,2841,133,2
Asthma,Chandigarh,Punjab,2019-04-01,850,36,814,125,8
Asthma,Chandigarh,Punjab,2019-05-01,3204,149,3055,98,6
Asthma,Chandigarh,Punjab,2019-06-01,2120,102,2018,86,8
Asthma,Chandigarh,Punjab,2019-07-01,2637,153,2484,163,6
Asthma,Chandigarh,Punjab,2019-08-01,3534,78,3456,40,7
Asthma,Chandigarh,Punjab,2019-09-01,944,7,937,182,9
Asthma,Chandigarh,Punjab,2019-10-01,1679,116,1563,92,1
Asthma,Chandigarh,Punjab,2019-11-01,3211,244,2967,39,6
Asthma,Chandigarh,Punjab,2019-12-01,4989,358,4631,78,1
Asthma,Chandigarh,Punjab,2020-01-01,2412,131,2281,62,3
Asthma,Chandigarh,Punjab,2020-02-01,3390,245,3145,77,5
Asthma,Chandigarh,Punjab,2020-03-01,2454,173,2281,76,2
Asthma,Chandigarh,Punjab,2020-04-01,4989,364,4625,74,3
Asthma,Chandigarh,Punjab,2020-05-01,253,6,247,91,1
Asthma,Chandigarh,Punjab,2020-06-01,2724,49,2675,103,3
Asthma,Chandigarh,Punjab,2020-07-01,417,16,401,145,6
Asthma,Chandigarh,Punjab,2020-08-01,78,0,78,94,7
Asthma,Chandigarh,Punjab,2020-09-01,2996,128,2868,123,3
Asthma,Chandigarh,Punjab,2020-10-01,2785,0,2785,107,9
Asthma,Chandigarh,Punjab,2020-11-01,2215,221,1994,134,6
Asthma,Chandigarh,Punjab,2020-12-01,2455,103,2352,109,9
Asthma,Chandigarh,Punjab,2021-01-01,4989,274,4715,73,1
Asthma,Chandigarh,Punjab,2021-02-01,2251,194,2057,59,6
Asthma,Chandigarh,Punjab,2021-03-01,3282,0,3282,117,7
Asthma,Chandigarh,Punjab,2021-04-01,1726,60,1666,171,1
Asthma,Chandigarh,Punjab,2021-05-01,2993,116,2877,95,10
Asthma,Chandigarh,Punjab,2021-06-01,2278,91,2187,71,3
Asthma,Chandigarh,Punjab,2021-07-01,2047,92,1955,93,6
Asthma,Chandigarh,Punjab,2021-08-01,4989,442,4547,78,8
Asthma,Chandigarh,Punjab,2021-09-01,4177,291,3886,72,5
Asthma,Chandigarh,Punjab,2021-10-01,2781,216,2565,33,9
Asthma,Chandigarh,Punjab,2021-11-01,78,0,78,94,10
Asthma,Chandigarh,Punjab,2021-12-01,2113,19,2094,118,2
Asthma,Chandigarh,Punjab,2022-01-01,4989,20,4969,51,5
Asthma,Chandigarh,Punjab,2022-02-01,2288,12,2276,61,7
Asthma,Chandigarh,Punjab,2022-03-01,4077,246,3831,58,1
Asthma,Chandigarh,Punjab,2022-04-01,4532,231,4301,36,8
Asthma,Chandigarh,Punjab,2022-05-01,2891,127,2764,58,10
Asthma,Chandigarh,Punjab,2022-06-01,1468,57,1411,96,9
Asthma,Chandigarh,Punjab,2022-07-01,78,0,78,38,6
Asthma,Chandigarh,Punjab,2022-08-01,3515,91,3424,99,9
Asthma,Chandigarh,Punjab,2022-09-01,1504,115,1389,70,6
Asthma,Chandigarh,Punjab,2022-10-01,2834,142,2692,59,1
Asthma,Chandigarh,Punjab,2022-11-01,921,44,877,125,3
Asthma,Chandigarh,Punjab,2022-12-01,2242,189,2053,74,4
Asthma,Chandigarh,Punjab,2023-01-01,2643,244,2399,82,5
Asthma,Chandigarh,Punjab,2023-02-01,2958,127,2831,172,5
Asthma,Chandigarh,Punjab,2023-03-01,1102,80,1022,59,4
Asthma,Chandigarh,Punjab,2023-04-01,4203,254,3949,186,5
Asthma,Chandigarh,Punjab,2023-05-01,1797,90,1707,88,9
Asthma,Chandigarh,Punjab,2023-06-01,351,19,332,48,5
Asthma,Chandigarh,Punjab,2023-07-01,2451,73,2378,78,7
Asthma,Chandigarh,Punjab,2023-08-01,2644,108,2536,110,1
Asthma,Chandigarh,Punjab,2023-09-01,2813,93,2720,170,5
Asthma,Chandigarh,Punjab,2023-10-01,4425,337,4088,147,8
Asthma,Chandigarh,Punjab,2023-11-01,2280,107,2173,109,8
Asthma,Chandigarh,Punjab,2023-12-01,2437,29,2408,170,8
Asthma,Chandigarh,Punjab,2024-01-01,1117,32,1085,11,6
Asthma,Chandigarh,Punjab,2024-02-01,3698,0,3698,119,6
Asthma,Chandigarh,Punjab,2024-03-01,2845,101,2744,122,3
Asthma,Chandigarh,Punjab,2024-04-01,2034,104,1930,123,7
Asthma,Chandigarh,Punjab,2024-05-01,78,0,78,24,3
Asthma,Chandigarh,Punjab,2024-06-01,4535,442,4093,54,7
Asthma,Chandigarh,Punjab,2024-07-01,950,63,887,98,5
Asthma,Chandigarh,Punjab,2024-08-01,1804,118,1686,163,5
Asthma,Chandigarh,Punjab,2024-09-01,3078,6,3072,200,8
Asthma,Chandigarh,Punjab,2024-10-01,992,39,953,72,6
Asthma,Chandigarh,Punjab,2024-11-01,594,21,573,39,6
Asthma,Chandigarh,Punjab,2024-12-01,78,0,78,148,3
Asthma,Chandigarh,Punjab,2025-01-01,3565,95,3470,200,9
Asthma,Chandigarh,Punjab,2025-02-01,1866,0,1866,163,6
Asthma,Chandigarh,Punjab,2025-03-01,4989,64,4925,68,7
Asthma,Chandigarh,Punjab,2025-04-01,1263,95,1168,200,5
Asthma,Chandigarh,Punjab,2025-05-01,1361,62,1299,141,3
Asthma,Chandigarh,Punjab,2025-06-01,1839,64,1775,66,6
Asthma,Chandigarh,Punjab,2025-07-01,2924,145,2779,200,3
Asthma,Chandigarh,Punjab,2025-08-01,1967,165,1802,62,6
Asthma,Chandigarh,Punjab,2025-09-01,3419,171,3248,75,1
Asthma,Chandigarh,Punjab,2025-10-01,1285,84,1201,143,4
Asthma,Chandigarh,Punjab,2025-11-01,744,18,726,105,5
Asthma,Chandigarh,Punjab,2025-12-01,185,5,180,108,2
Asthma,Chandigarh,Chandigarh,2018-01-01,78,0,78,108,6
Asthma,Chandigarh,Chandigarh,2018-02-01,1902,200,1702,163,4
Asthma,Chandigarh,Chandigarh,2018-03-01,2194,201,1993,11,5
Asthma,Chandigarh,Chandigarh,2018-04-01,1750,117,1633,121,3
Asthma,Chandigarh,Chandigarh,2018-05-01,4265,232,4033,91,8
Asthma,Chandigarh,Chandigarh,2018-06-01,4245,385,3860,68,6
Asthma,Chandigarh,Chandigarh,2018-07-01,2148,157,1991,68,6
Asthma,Chandigarh,Chandigarh,2018-08-01,191,0,191,11,5
Asthma,Chandigarh,Chandigarh,2018-09-01,1837,35,1802,66,10
Asthma,Chandigarh,Chandigarh,2018-10-01,1793,107,1686,172,4
Asthma,Chandigarh,Chandigarh,2018-11-01,1716,0,1716,149,3
Asthma,Chandigarh,Chandigarh,2018-12-01,1661,39,1622,96,1
Asthma,Chandigarh,Chandigarh,2019-01-01,1721,51,1670,34,7
Asthma,Chandigarh,Chandigarh,2019-02-01,2079,88,1991,148,10
Asthma,Chandigarh,Chandigarh,2019-03-01,1745,72,1673,173,2
Asthma,Chandigarh,Chandigarh,2019-04-01,2877,119,2758,159,4
Asthma,Chandigarh,Chandigarh,2019-05-01,3081,228,2853,57,4
Asthma,Chandigarh,Chandigarh,2019-06-01,1376,58,1318,62,4
Asthma,Chandigarh,Chandigarh,2019-07-01,4303,167,4136,191,1
Asthma,Chandigarh,Chandigarh,2019-08-01,1283,13,1270,45,7
Asthma,Chandigarh,Chandigarh,2019-09-01,427,34,393,131,8
Asthma,Chandigarh,Chandigarh,2019-10-01,3108,94,3014,16,1
Asthma,Chandigarh,Chandigarh,2019-11-01,1501,27,1474,91,10
Asthma,Chandigarh,Chandigarh,2019-12-01,3028,170,2858,136,10
Asthma,Chandigarh,Chandigarh,2020-01-01,78,0,78,105,1
Asthma,Chandigarh,Chandigarh,2020-02-01,4465,155,4310,133,1
Asthma,Chandigarh,Chandigarh,2020-03-01,3499,201,3298,44,4
Asthma,Chandigarh,Chandigarh,2020-04-01,585,23,562,64,9
Asthma,Chandigarh,Chandigarh,2020-05-01,614,72,542,131,6
Asthma,Chandigarh,Chandigarh,2020-06-01,4841,231,4610,142,5
Asthma,Chandigarh,Chandigarh,2020-07-01,1608,109,1499,117,6
Asthma,Chandigarh,Chandigarh,2020-08-01,1478,0,1478,154,2
Asthma,Chandigarh,Chandigarh,2020-09-01,78,0,78,22,9
Asthma,Chandigarh,Chandigarh,2020-10-01,2127,39,2088,82,5
Asthma,Chandigarh,Chandigarh,2020-11-01,2292,51,2241,199,1
Asthma,Chandigarh,Chandigarh,2020-12-01,3557,221,3336,172,3
Asthma,Chandigarh,Chandigarh,2021-01-01,721,57,664,138,6
Asthma,Chandigarh,Chandigarh,2021-02-01,558,33,525,98,4
Asthma,Chandigarh,Chandigarh,2021-03-01,3202,139,3063,159,4
Asthma,Chandigarh,Chandigarh,2021-04-01,3948,125,3823,128,5
Asthma,Chandigarh,Chandigarh,2021-05-01,490,40,450,29,6
Asthma,Chandigarh,Chandigarh,2021-06-01,4048,442,3606,157,1
Asthma,Chandigarh,Chandigarh,2021-07-01,2648,142,2506,62,8
Asthma,Chandigarh,Chandigarh,2021-08-01,4062,314,3748,145,4
Asthma,Chandigarh,Chandigarh,2021-09-01,2503,150,2353,24,6
Asthma,Chandigarh,Chandigarh,2021-10-01,78,0,78,188,5
Asthma,Chandigarh,Chandigarh,2021-11-01,2394,38,2356,92,4
Asthma,Chandigarh,Chandigarh,2021-12-01,4020,144,3876,50,7
Asthma,Chandigarh,Chandigarh,2022-01-01,1398,86,1312,71,5
Asthma,Chandigarh,Chandigarh,2022-02-01,2077,177,1900,89,5
Asthma,Chandigarh,Chandigarh,2022-03-01,2361,61,2300,106,1
Asthma,Chandigarh,Chandigarh,2022-04-01,78,0,78,173,7
Asthma,Chandigarh,Chandigarh,2022-05-01,4840,172,4668,110,4
Asthma,Chandigarh,Chandigarh,2022-06-01,1388,110,1278,11,7
Asthma,Chandigarh,Chandigarh,2022-07-01,3276,13,3263,44,10
Asthma,Chandigarh,Chandigarh,2022-08-01,2481,39,2442,200,7
Asthma,Chandigarh,Chandigarh,2022-09-01,4285,234,4051,113,5
Asthma,Chandigarh,Chandigarh,2022-10-01,3142,146,2996,155,4
Asthma,Chandigarh,Chandigarh,2022-11-01,2282,153,2129,91,10
Asthma,Chandigarh,Chandigarh,2022-12-01,1399,20,1379,55,6
Asthma,Chandigarh,Chandigarh,2023-01-01,3668,148,3520,82,5
Asthma,Chandigarh,Chandigarh,2023-02-01,84,6,78,113,4
Asthma,Chandigarh,Chandigarh,2023-03-01,3464,53,3411,83,2
Asthma,Chandigarh,Chandigarh,2023-04-01,1123,104,1019,200,1
Asthma,Chandigarh,Chandigarh,2023-05-01,4277,81,4196,75,9
Asthma,Chandigarh,Chandigarh,2023-06-01,2814,210,2604,52,3
Asthma,Chandigarh,Chandigarh,2023-07-01,3462,135,3327,147,4
Asthma,Chandigarh,Chandigarh,2023-08-01,2707,45,2662,154,5
Asthma,Chandigarh,Chandigarh,2023-09-01,247,8,239,108,9
Asthma,Chandigarh,Chandigarh,2023-10-01,1443,95,1348,76,3
Asthma,Chandigarh,Chandigarh,2023-11-01,3499,174,3325,11,6
Asthma,Chandigarh,Chandigarh,2023-12-01,2821,233,2588,168,6
Asthma,Chandigarh,Chandigarh,2024-01-01,4182,384,3798,150,1
Asthma,Chandigarh,Chandigarh,2024-02-01,3138,49,3089,84,1
Asthma,Chandigarh,Chandigarh,2024-03-01,1301,17,1284,109,3
Asthma,Chandigarh,Chandigarh,2024-04-01,1529,18,1511,95,6
Asthma,Chandigarh,Chandigarh,2024-05-01,2735,65,2670,189,5
Asthma,Chandigarh,Chandigarh,2024-06-01,78,0,78,53,4
Asthma,Chandigarh,Chandigarh,2024-07-01,4842,321,4521,75,7
Asthma,Chandigarh,Chandigarh,2024-08-01,3190,109,3081,70,2
Asthma,Chandigarh,Chandigarh,2024-09-01,4243,211,4032,122,4
Asthma,Chandigarh,Chandigarh,2024-10-01,477,43,434,109,4
Asthma,Chandigarh,Chandigarh,2024-11-01,4267,442,3825,116,2
Asthma,Chandigarh,Chandigarh,2024-12-01,4989,287,4702,61,10
Asthma,Chandigarh,Chandigarh,2025-01-01,825,0,825,182,1
Asthma,Chandigarh,Chandigarh,2025-02-01,3632,213,3419,83,8
Asthma,Chandigarh,Chandigarh,2025-03-01,2599,200,2399,167,7
Asthma,Chandigarh,Chandigarh,2025-04-01,526,29,497,200,7
Asthma,Chandigarh,Chandigarh,2025-05-01,3259,232,3027,62,5
Asthma,Chandigarh,Chandigarh,2025-06-01,3716,224,3492,124,9
Asthma,Chandigarh,Chandigarh,2025-07-01,1791,25,1766,100,4
Asthma,Chandigarh,Chandigarh,2025-08-01,4161,101,4060,200,6
Asthma,Chandigarh,Chandigarh,2025-09-01,361,14,347,92,5
Asthma,Chandigarh,Chandigarh,2025-10-01,592,47,545,119,4
Asthma,Chandigarh,Chandigarh,2025-11-01,2781,77,2704,118,5
Asthma,Chandigarh,Chandigarh,2025-12-01,2631,166,2465,101,2
Asthma,Chandigarh,Himachal Pradesh,2018-01-01,1636,96,1540,145,3
Asthma,Chandigarh,Himachal Pradesh,2018-02-01,3683,354,3329,111,9
Asthma,Chandigarh,Himachal Pradesh,2018-03-01,3310,161,3149,131,10
Asthma,Chandigarh,Himachal Pradesh,2018-04-01,3749,0,3749,117,6
Asthma,Chandigarh,Himachal Pradesh,2018-05-01,2432,167,2265,75,7
Asthma,Chandigarh,Himachal Pradesh,2018-06-01,3406,382,3024,93,6
Asthma,Chandigarh,Himachal Pradesh,2018-07-01,2000,141,1859,135,6
Asthma,Chandigarh,Himachal Pradesh,2018-08-01,4989,135,4854,134,6
Asthma,Chandigarh,Himachal Pradesh,2018-09-01,1507,28,1479,170,8
Asthma,Chandigarh,Himachal Pradesh,2018-10-01,4989,111,4878,200,9
Asthma,Chandigarh,Himachal Pradesh,2018-11-01,2644,286,2358,80,2
Asthma,Chandigarh,Himachal Pradesh,2018-12-01,752,30,722,113,10
Asthma,Chandigarh,Himachal Pradesh,2019-01-01,4433,136,4297,96,5
Asthma,Chandigarh,Himachal Pradesh,2019-02-01,2766,125,2641,50,5
Asthma,Chandigarh,Himachal Pradesh,2019-03-01,3739,152,3587,135,4
Asthma,Chandigarh,Himachal Pradesh,2019-04-01,4239,405,3834,146,4
Asthma,Chandigarh,Himachal Pradesh,2019-05-01,3051,62,2989,51,7
Asthma,Chandigarh,Himachal Pradesh,2019-06-01,1803,152,1651,87,7
Asthma,Chandigarh,Himachal Pradesh,2019-07-01,3906,209,3697,82,6
Asthma,Chandigarh,Himachal Pradesh,2019-08-01,2598,221,2377,29,3
Asthma,Chandigarh,Himachal Pradesh,2019-09-01,3517,338,3179,104,1
Asthma,Chandigarh,Himachal Pradesh,2019-10-01,78,0,78,48,1
Asthma,Chandigarh,Himachal Pradesh,2019-11-01,3197,130,3067,114,5
Asthma,Chandigarh,Himachal Pradesh,2019-12-01,1741,90,1651,120,6
Asthma,Chandigarh,Himachal Pradesh,2020-01-01,4815,227,4588,126,4
Asthma,Chandigarh,Himachal Pradesh,2020-02-01,3433,6,3427,129,3
Asthma,Chandigarh,Himachal Pradesh,2020-03-01,2919,278,2641,184,6
Asthma,Chandigarh,Himachal Pradesh,2020-04-01,3250,185,3065,65,5
Asthma,Chandigarh,Himachal Pradesh,2020-05-01,1258,20,1238,68,3
Asthma,Chandigarh,Himachal Pradesh,2020-06-01,4775,0,4775,140,1
Asthma,Chandigarh,Himachal Pradesh,2020-07-01,4989,20,4969,99,2
Asthma,Chandigarh,Himachal Pradesh,2020-08-01,3125,226,2899,164,8
Asthma,Chandigarh,Himachal Pradesh,2020-09-01,4731,151,4580,135,2
Asthma,Chandigarh,Himachal Pradesh,2020-10-01,1834,67,1767,200,7
Asthma,Chandigarh,Himachal Pradesh,2020-11-01,1528,98,1430,102,9
Asthma,Chandigarh,Himachal Pradesh,2020-12-01,2652,92,2560,31,3
Asthma,Chandigarh,Himachal Pradesh,2021-01-01,3181,209,2972,124,4
Asthma,Chandigarh,Himachal Pradesh,2021-02-01,2069,109,1960,103,8
Asthma,Chandigarh,Himachal Pradesh,2021-03-01,3319,158,3161,133,8
Asthma,Chandigarh,Himachal Pradesh,2021-04-01,3008,12,2996,140,3
Asthma,Chandigarh,Himachal Pradesh,2021-05-01,1258,32,1226,79,1
Asthma,Chandigarh,Himachal Pradesh,2021-06-01,3293,222,3071,55,8
Asthma,Chandigarh,Himachal Pradesh,2021-07-01,3756,113,3643,99,7
Asthma,Chandigarh,Himachal Pradesh,2021-08-01,2827,240,2587,11,6
Asthma,Chandigarh,Himachal Pradesh,2021-09-01,4144,442,3702,110,7
Asthma,Chandigarh,Himachal Pradesh,2021-10-01,964,66,898,85,1
Asthma,Chandigarh,Himachal Pradesh,2021-11-01,3225,301,2924,150,6
Asthma,Chandigarh,Himachal Pradesh,2021-12-01,1027,72,955,11,4
Asthma,Chandigarh,Himachal Pradesh,2022-01-01,1103,38,1065,107,7
Asthma,Chandigarh,Himachal Pradesh,2022-02-01,1751,97,1654,187,7
Asthma,Chandigarh,Himachal Pradesh,2022-03-01,1334,144,1190,141,8
Asthma,Chandigarh,Himachal Pradesh,2022-04-01,1862,64,1798,156,7
Asthma,Chandigarh,Himachal Pradesh,2022-05-01,2310,45,2265,124,6
Asthma,Chandigarh,Himachal Pradesh,2022-06-01,3720,63,3657,22,6
Asthma,Chandigarh,Himachal Pradesh,2022-07-01,2167,94,2073,115,6
Asthma,Chandigarh,Himachal Pradesh,2022-08-01,470,9,461,127,3
Asthma,Chandigarh,Himachal Pradesh,2022-09-01,4127,407,3720,51,4
Asthma,Chandigarh,Himachal Pradesh,2022-10-01,1474,83,1391,100,6
Asthma,Chandigarh,Himachal Pradesh,2022-11-01,2519,197,2322,11,7
Asthma,Chandigarh,Himachal Pradesh,2022-12-01,3196,132,3064,89,3
Asthma,Chandigarh,Himachal Pradesh,2023-01-01,2865,48,2817,84,2
Asthma,Chandigarh,Himachal Pradesh,2023-02-01,4065,48,4017,178,1
Asthma,Chandigarh,Himachal Pradesh,2023-03-01,3240,76,3164,75,1
Asthma,Chandigarh,Himachal Pradesh,2023-04-01,1442,86,1356,93,3
Asthma,Chandigarh,Himachal Pradesh,2023-05-01,4989,325,4664,102,4
Asthma,Chandigarh,Himachal Pradesh,2023-06-01,2858,193,2665,76,4
Asthma,Chandigarh,Himachal Pradesh,2023-07-01,2400,16,2384,143,1
Asthma,Chandigarh,Himachal Pradesh,2023-08-01,3891,194,3697,11,1
Asthma,Chandigarh,Himachal Pradesh,2023-09-01,2932,59,2873,164,5
Asthma,Chandigarh,Himachal Pradesh,2023-10-01,3133,193,2940,106,5
Asthma,Chandigarh,Himachal Pradesh,2023-11-01,4989,319,4670,173,7
Asthma,Chandigarh,Himachal Pradesh,2023-12-01,2228,35,2193,11,7
Asthma,Chandigarh,Himachal Pradesh,2024-01-01,2171,169,2002,11,6
Asthma,Chandigarh,Himachal Pradesh,2024-02-01,2754,325,2429,91,5
Asthma,Chandigarh,Himachal Pradesh,2024-03-01,4035,300,3735,132,7
Asthma,Chandigarh,Himachal Pradesh,2024-04-01,576,26,550,78,9
Asthma,Chandigarh,Himachal Pradesh,2024-05-01,78,0,78,136,3
Asthma,Chandigarh,Himachal Pradesh,2024-06-01,1810,79,1731,156,7
Asthma,Chandigarh,Himachal Pradesh,2024-07-01,405,11,394,140,3
Asthma,Chandigarh,Himachal Pradesh,2024-08-01,2027,116,1911,111,5
Asthma,Chandigarh,Himachal Pradesh,2024-09-01,3272,55,3217,111,8
Asthma,Chandigarh,Himachal Pradesh,2024-10-01,1402,0,1402,75,4
Asthma,Chandigarh,Himachal Pradesh,2024-11-01,683,38,645,103,2
Asthma,Chandigarh,Himachal Pradesh,2024-12-01,2690,136,2554,54,3
Asthma,Chandigarh,Himachal Pradesh,2025-01-01,3755,125,3630,66,2
Asthma,Chandigarh,Himachal Pradesh,2025-02-01,324,4,320,132,2
Asthma,Chandigarh,Himachal Pradesh,2025-03-01,3698,216,3482,83,8
Asthma,Chandigarh,Himachal Pradesh,2025-04-01,3694,78,3616,69,6
Asthma,Chandigarh,Himachal Pradesh,2025-05-01,3877,178,3699,129,3
Asthma,Chandigarh,Himachal Pradesh,2025-06-01,4232,429,3803,126,2
Asthma,Chandigarh,Himachal Pradesh,2025-07-01,4989,344,4645,95,2
Asthma,Chandigarh,Himachal Pradesh,2025-08-01,2120,21,2099,99,3
Asthma,Chandigarh,Himachal Pradesh,2025-09-01,2744,35,2709,127,8
Asthma,Chandigarh,Himachal Pradesh,2025-10-01,2039,111,1928,156,5
Asthma,Chandigarh,Himachal Pradesh,2025-11-01,2600,26,2574,116,10
Asthma,Chandigarh,Himachal Pradesh,2025-12-01,4654,0,4654,45,5
Asthma,Chandigarh,Jammu & Kashmir,2018-01-01,793,51,742,95,3
Asthma,Chandigarh,Jammu & Kashmir,2018-02-01,1442,85,1357,85,8
Asthma,Chandigarh,Jammu & Kashmir,2018-03-01,4445,280,4165,53,1
Asthma,Chandigarh,Jammu & Kashmir,2018-04-01,3966,228,3738,132,5
Asthma,Chandigarh,Jammu & Kashmir,2018-05-01,2110,101,2009,135,1
Asthma,Chandigarh,Jammu & Kashmir,2018-06-01,3744,115,3629,143,1
Asthma,Chandigarh,Jammu & Kashmir,2018-07-01,3055,198,2857,56,4
Asthma,Chandigarh,Jammu & Kashmir,2018-08-01,4610,436,4174,114,7
Asthma,Chandigarh,Jammu & Kashmir,2018-09-01,2697,95,2602,106,5
Asthma,Chandigarh,Jammu & Kashmir,2018-10-01,3973,80,3893,122,5
Asthma,Chandigarh,Jammu & Kashmir,2018-11-01,4989,84,4905,113,1
Asthma,Chandigarh,Jammu & Kashmir,2018-12-01,3400,84,3316,106,4
Asthma,Chandigarh,Jammu & Kashmir,2019-01-01,2664,149,2515,99,4
Asthma,Chandigarh,Jammu & Kashmir,2019-02-01,3567,0,3567,163,7
Asthma,Chandigarh,Jammu & Kashmir,2019-03-01,2107,132,1975,62,2
Asthma,Chandigarh,Jammu & Kashmir,2019-04-01,4989,343,4646,97,7
Asthma,Chandigarh,Jammu & Kashmir,2019-05-01,2839,0,2839,161,3
Asthma,Chandigarh,Jammu & Kashmir,2019-06-01,2231,48,2183,65,4
Asthma,Chandigarh,Jammu & Kashmir,2019-07-01,1476,77,1399,67,6
Asthma,Chandigarh,Jammu & Kashmir,2019-08-01,4069,186,3883,144,1
Asthma,Chandigarh,Jammu & Kashmir,2019-09-01,3761,245,3516,34,7
Asthma,Chandigarh,Jammu & Kashmir,2019-10-01,1930,88,1842,140,1
Asthma,Chandigarh,Jammu & Kashmir,2019-11-01,3371,292,3079,81,7
Asthma,Chandigarh,Jammu & Kashmir,2019-12-01,574,23,551,127,4
Asthma,Chandigarh,Jammu & Kashmir,2020-01-01,2846,61,2785,44,4
Asthma,Chandigarh,Jammu & Kashmir,2020-02-01,3205,61,3144,167,1
Asthma,Chandigarh,Jammu & Kashmir,2020-03-01,4888,349,4539,44,3
Asthma,Chandigarh,Jammu & Kashmir,2020-04-01,1563,79,1484,143,4
Asthma,Chandigarh,Jammu & Kashmir,2020-05-01,882,60,822,46,9
Asthma,Chandigarh,Jammu & Kashmir,2020-06-01,1396,94,1302,198,5
Asthma,Chandigarh,Jammu & Kashmir,2020-07-01,804,0,804,103,3
Asthma,Chandigarh,Jammu & Kashmir,2020-08-01,4391,74,4317,200,7
Asthma,Chandigarh,Jammu & Kashmir,2020-09-01,4675,95,4580,64,3
Asthma,Chandigarh,Jammu & Kashmir,2020-10-01,3027,79,2948,84,8
Asthma,Chandigarh,Jammu & Kashmir,2020-11-01,4236,160,4076,168,6
Asthma,Chandigarh,Jammu & Kashmir,2020-12-01,2777,219,2558,34,2
Asthma,Chandigarh,Jammu & Kashmir,2021-01-01,2470,209,2261,71,8
Asthma,Chandigarh,Jammu & Kashmir,2021-02-01,2151,89,2062,131,7
Asthma,Chandigarh,Jammu & Kashmir,2021-03-01,2181,93,2088,54,7
Asthma,Chandigarh,Jammu & Kashmir,2021-04-01,521,15,506,133,4
Asthma,Chandigarh,Jammu & Kashmir,2021-05-01,2952,155,2797,115,7
Asthma,Chandigarh,Jammu & Kashmir,2021-06-01,2543,142,2401,29,10
Asthma,Chandigarh,Jammu & Kashmir,2021-07-01,3597,264,3333,156,5
Asthma,Chandigarh,Jammu & Kashmir,2021-08-01,2723,199,2524,42,4
Asthma,Chandigarh,Jammu & Kashmir,2021-09-01,2379,0,2379,146,9
Asthma,Chandigarh,Jammu & Kashmir,2021-10-01,1429,65,1364,113,7
Asthma,Chandigarh,Jammu & Kashmir,2021-11-01,2694,243,2451,83,4
Asthma,Chandigarh,Jammu & Kashmir,2021-12-01,3588,133,3455,50,10
Asthma,Chandigarh,Jammu & Kashmir,2022-01-01,1064,88,976,123,1
Asthma,Chandigarh,Jammu & Kashmir,2022-02-01,2715,111,2604,62,6
Asthma,Chandigarh,Jammu & Kashmir,2022-03-01,2910,160,2750,168,8
Asthma,Chandigarh,Jammu & Kashmir,2022-04-01,1634,27,1607,170,8
Asthma,Chandigarh,Jammu & Kashmir,2022-05-01,1809,32,1777,190,2
Asthma,Chandigarh,Jammu & Kashmir,2022-06-01,2907,206,2701,121,1
Asthma,Chandigarh,Jammu & Kashmir,2022-07-01,1077,81,996,86,5
Asthma,Chandigarh,Jammu & Kashmir,2022-08-01,3067,155,2912,91,7
Asthma,Chandigarh,Jammu & Kashmir,2022-09-01,1396,20,1376,87,2
Asthma,Chandigarh,Jammu & Kashmir,2022-10-01,4023,206,3817,119,6
Asthma,Chandigarh,Jammu & Kashmir,2022-11-01,4989,432,4557,128,1
Asthma,Chandigarh,Jammu & Kashmir,2022-12-01,1443,145,1298,169,8
Asthma,Chandigarh,Jammu & Kashmir,2023-01-01,3314,135,3179,107,3
Asthma,Chandigarh,Jammu & Kashmir,2023-02-01,1622,2,1620,35,4
Asthma,Chandigarh,Jammu & Kashmir,2023-03-01,3994,297,3697,85,7
Asthma,Chandigarh,Jammu & Kashmir,2023-04-01,900,37,863,185,7
Asthma,Chandigarh,Jammu & Kashmir,2023-05-01,3242,251,2991,27,6
Asthma,Chandigarh,Jammu & Kashmir,2023-06-01,1426,83,1343,144,8
Asthma,Chandigarh,Jammu & Kashmir,2023-07-01,2320,56,2264,86,6
Asthma,Chandigarh,Jammu & Kashmir,2023-08-01,1214,62,1152,61,9
Asthma,Chandigarh,Jammu & Kashmir,2023-09-01,3701,326,3375,126,1
Asthma,Chandigarh,Jammu & Kashmir,2023-10-01,1475,67,1408,186,5
Asthma,Chandigarh,Jammu & Kashmir,2023-11-01,3338,66,3272,124,5
Asthma,Chandigarh,Jammu & Kashmir,2023-12-01,2136,8,2128,93,4
Asthma,Chandigarh,Jammu & Kashmir,2024-01-01,2444,67,2377,40,6
Asthma,Chandigarh,Jammu & Kashmir,2024-02-01,2796,106,2690,101,5
Asthma,Chandigarh,Jammu & Kashmir,2024-03-01,1575,116,1459,38,7
Asthma,Chandigarh,Jammu & Kashmir,2024-04-01,2880,50,2830,90,1
Asthma,Chandigarh,Jammu & Kashmir,2024-05-01,4650,442,4208,103,10
Asthma,Chandigarh,Jammu & Kashmir,2024-06-01,1554,17,1537,11,4
Asthma,Chandigarh,Jammu & Kashmir,2024-07-01,4169,442,3727,177,6
Asthma,Chandigarh,Jammu & Kashmir,2024-08-01,4607,442,4165,43,4
Asthma,Chandigarh,Jammu & Kashmir,2024-09-01,1503,81,1422,97,5
Asthma,Chandigarh,Jammu & Kashmir,2024-10-01,645,1,644,133,3
Asthma,Chandigarh,Jammu & Kashmir,2024-11-01,3002,145,2857,173,5
Asthma,Chandigarh,Jammu & Kashmir,2024-12-01,1863,72,1791,66,7
Asthma,Chandigarh,Jammu & Kashmir,2025-01-01,4989,64,4925,11,1
Asthma,Chandigarh,Jammu & Kashmir,2025-02-01,2644,154,2490,161,4
Asthma,Chandigarh,Jammu & Kashmir,2025-03-01,1521,39,1482,43,4
Asthma,Chandigarh,Jammu & Kashmir,2025-04-01,1058,30,1028,125,10
Asthma,Chandigarh,Jammu & Kashmir,2025-05-01,4060,179,3881,128,7
Asthma,Chandigarh,Jammu & Kashmir,2025-06-01,1831,61,1770,11,9
Asthma,Chandigarh,Jammu & Kashmir,2025-07-01,2656,293,2363,24,6
Asthma,Chandigarh,Jammu & Kashmir,2025-08-01,3880,133,3747,83,5
Asthma,Chandigarh,Jammu & Kashmir,2025-09-01,1948,122,1826,11,6
Asthma,Chandigarh,Jammu & Kashmir,2025-10-01,2536,137,2399,38,8
Asthma,Chandigarh,Jammu & Kashmir,2025-11-01,2575,155,2420,112,10
Asthma,Chandigarh,Jammu & Kashmir,2025-12-01,3514,219,3295,102,6
Asthma,Chandigarh,Haryana,2018-01-01,3390,256,3134,122,3
Asthma,Chandigarh,Haryana,2018-02-01,2302,133,2169,129,8
Asthma,Chandigarh,Haryana,2018-03-01,2683,151,2532,21,2
Asthma,Chandigarh,Haryana,2018-04-01,2099,108,1991,41,6
Asthma,Chandigarh,Haryana,2018-05-01,615,28,587,145,7
Asthma,Chandigarh,Haryana,2018-06-01,2943,69,2874,184,5
Asthma,Chandigarh,Haryana,2018-07-01,4989,240,4749,57,2
Asthma,Chandigarh,Haryana,2018-08-01,1412,80,1332,119,3
Asthma,Chandigarh,Haryana,2018-09-01,1560,96,1464,147,4
Asthma,Chandigarh,Haryana,2018-10-01,1429,79,1350,118,2
Asthma,Chandigarh,Haryana,2018-11-01,3569,154,3415,94,4
Asthma,Chandigarh,Haryana,2018-12-01,3199,154,3045,74,1
Asthma,Chandigarh,Haryana,2019-01-01,2385,80,2305,200,7
Asthma,Chandigarh,Haryana,2019-02-01,1366,80,1286,111,6
Asthma,Chandigarh,Haryana,2019-03-01,2721,118,2603,126,6
Asthma,Chandigarh,Haryana,2019-04-01,498,27,471,123,4
Asthma,Chandigarh,Haryana,2019-05-01,2790,220,2570,65,4
Asthma,Chandigarh,Haryana,2019-06-01,3767,110,3657,109,2
Asthma,Chandigarh,Haryana,2019-07-01,919,61,858,90,6
Asthma,Chandigarh,Haryana,2019-08-01,542,27,515,89,1
Asthma,Chandigarh,Haryana,2019-09-01,4716,442,4274,122,5
Asthma,Chandigarh,Haryana,2019-10-01,1777,77,1700,60,3
Asthma,Chandigarh,Haryana,2019-11-01,4121,289,3832,45,10
Asthma,Chandigarh,Haryana,2019-12-01,2391,120,2271,132,6
Asthma,Chandigarh,Haryana,2020-01-01,2380,23,2357,79,5
Asthma,Chandigarh,Haryana,2020-02-01,3186,111,3075,89,2
Asthma,Chandigarh,Haryana,2020-03-01,1412,106,1306,11,1
Asthma,Chandigarh,Haryana,2020-04-01,2775,104,2671,155,6
Asthma,Chandigarh,Haryana,2020-05-01,2086,0,2086,133,10
Asthma,Chandigarh,Haryana,2020-06-01,826,40,786,142,6
Asthma,Chandigarh,Haryana,2020-07-01,3050,55,2995,126,5
Asthma,Chandigarh,Haryana,2020-08-01,2244,120,2124,29,5
Asthma,Chandigarh,Haryana,2020-09-01,2387,227,2160,118,5
Asthma,Chandigarh,Haryana,2020-10-01,974,70,904,75,5
Asthma,Chandigarh,Haryana,2020-11-01,4732,442,4290,57,3
Asthma,Chandigarh,Haryana,2020-12-01,3774,127,3647,132,2
Asthma,Chandigarh,Haryana,2021-01-01,3891,178,3713,191,5
Asthma,Chandigarh,Haryana,2021-02-01,2188,43,2145,182,9
Asthma,Chandigarh,Haryana,2021-03-01,278,8,270,138,7
Asthma,Chandigarh,Haryana,2021-04-01,4989,115,4874,105,1
Asthma,Chandigarh,Haryana,2021-05-01,2515,30,2485,95,4
Asthma,Chandigarh,Haryana,2021-06-01,1593,143,1450,60,7
Asthma,Chandigarh,Haryana,2021-07-01,3157,0,3157,92,9
Asthma,Chandigarh,Haryana,2021-08-01,4163,374,3789,152,10
Asthma,Chandigarh,Haryana,2021-09-01,2566,221,2345,199,4
Asthma,Chandigarh,Haryana,2021-10-01,4313,278,4035,65,7
Asthma,Chandigarh,Haryana,2021-11-01,4050,71,3979,11,6
Asthma,Chandigarh,Haryana,2021-12-01,1153,4,1149,79,4
Asthma,Chandigarh,Haryana,2022-01-01,1694,57,1637,152,5
Asthma,Chandigarh,Haryana,2022-02-01,3882,265,3617,200,5
Asthma,Chandigarh,Haryana,2022-03-01,78,0,78,173,8
Asthma,Chandigarh,Haryana,2022-04-01,2397,47,2350,172,1
Asthma,Chandigarh,Haryana,2022-05-01,678,56,622,63,6
Asthma,Chandigarh,Haryana,2022-06-01,1958,194,1764,64,9
Asthma,Chandigarh,Haryana,2022-07-01,2197,95,2102,39,9
Asthma,Chandigarh,Haryana,2022-08-01,2117,112,2005,72,6
Asthma,Chandigarh,Haryana,2022-09-01,1857,11,1846,153,3
Asthma,Chandigarh,Haryana,2022-10-01,1126,42,1084,189,7
Asthma,Chandigarh,Haryana,2022-11-01,4989,323,4666,124,9
Asthma,Chandigarh,Haryana,2022-12-01,4989,301,4688,93,3
Asthma,Chandigarh,Haryana,2023-01-01,1038,36,1002,52,6
Asthma,Chandigarh,Haryana,2023-02-01,4720,198,4522,100,4
Asthma,Chandigarh,Haryana,2023-03-01,2062,76,1986,117,3
Asthma,Chandigarh,Haryana,2023-04-01,2771,116,2655,32,4
Asthma,Chandigarh,Haryana,2023-05-01,2513,156,2357,153,5
Asthma,Chandigarh,Haryana,2023-06-01,1712,0,1712,85,2
Asthma,Chandigarh,Haryana,2023-07-01,3917,187,3730,150,2
Asthma,Chandigarh,Haryana,2023-08-01,2766,166,2600,106,2
Asthma,Chandigarh,Haryana,2023-09-01,1958,65,1893,121,6
Asthma,Chandigarh,Haryana,2023-10-01,847,30,817,70,1
Asthma,Chandigarh,Haryana,2023-11-01,1399,51,1348,89,1
Asthma,Chandigarh,Haryana,2023-12-01,395,14,381,139,9
Asthma,Chandigarh,Haryana,2024-01-01,2614,131,2483,100,2
Asthma,Chandigarh,Haryana,2024-02-01,992,53,939,50,4
Asthma,Chandigarh,Haryana,2024-03-01,2241,0,2241,112,7
Asthma,Chandigarh,Haryana,2024-04-01,4435,306,4129,126,1
Asthma,Chandigarh,Haryana,2024-05-01,4206,175,4031,176,1
Asthma,Chandigarh,Haryana,2024-06-01,2554,271,2283,165,3
Asthma,Chandigarh,Haryana,2024-07-01,2481,38,2443,103,8
Asthma,Chandigarh,Haryana,2024-08-01,4989,123,4866,78,5
Asthma,Chandigarh,Haryana,2024-09-01,3296,145,3151,95,5
Asthma,Chandigarh,Haryana,2024-10-01,2158,134,2024,80,4
Asthma,Chandigarh,Haryana,2024-11-01,684,0,684,132,6
Asthma,Chandigarh,Haryana,2024-12-01,3126,81,3045,159,9
Asthma,Chandigarh,Haryana,2025-01-01,3710,249,3461,169,10
Asthma,Chandigarh,Haryana,2025-02-01,1750,39,1711,85,4
Asthma,Chandigarh,Haryana,2025-03-01,2988,268,2720,80,9
Asthma,Chandigarh,Haryana,2025-04-01,2110,77,2033,85,8
Asthma,Chandigarh,Haryana,2025-05-01,2351,56,2295,11,6
Asthma,Chandigarh,Haryana,2025-06-01,78,0,78,45,1
Asthma,Chandigarh,Haryana,2025-07-01,2300,222,2078,104,4
Asthma,Chandigarh,Haryana,2025-08-01,3898,242,3656,126,4
Asthma,Chandigarh,Haryana,2025-09-01,1750,151,1599,131,6
Asthma,Chandigarh,Haryana,2025-10-01,2668,263,2405,66,4
Asthma,Chandigarh,Haryana,2025-11-01,1583,36,1547,81,3
Asthma,Chandigarh,Haryana,2025-12-01,3081,238,2843,92,10
Asthma,Shimla,Punjab,2018-01-01,2307,13,2294,87,9
Asthma,Shimla,Punjab,2018-02-01,1337,83,1254,141,1
Asthma,Shimla,Punjab,2018-03-01,4385,210,4175,40,4
Asthma,Shimla,Punjab,2018-04-01,3844,331,3513,48,7
Asthma,Shimla,Punjab,2018-05-01,1786,150,1636,91,9
Asthma,Shimla,Punjab,2018-06-01,3265,217,3048,37,4
Asthma,Shimla,Punjab,2018-07-01,3318,194,3124,11,4
Asthma,Shimla,Punjab,2018-08-01,3459,224,3235,30,5
Asthma,Shimla,Punjab,2018-09-01,325,16,309,94,7
Asthma,Shimla,Punjab,2018-10-01,3948,190,3758,138,1
Asthma,Shimla,Punjab,2018-11-01,1833,168,1665,139,1
Asthma,Shimla,Punjab,2018-12-01,2117,202,1915,187,8
Asthma,Shimla,Punjab,2019-01-01,4989,229,4760,111,2
Asthma,Shimla,Punjab,2019-02-01,3002,171,2831,118,10
Asthma,Shimla,Punjab,2019-03-01,2079,109,1970,93,2
Asthma,Shimla,Punjab,2019-04-01,78,0,78,96,4
Asthma,Shimla,Punjab,2019-05-01,4462,179,4283,200,6
Asthma,Shimla,Punjab,2019-06-01,793,76,717,120,1
Asthma,Shimla,Punjab,2019-07-01,1251,35,1216,124,10
Asthma,Shimla,Punjab,2019-08-01,2153,240,1913,48,4
Asthma,Shimla,Punjab,2019-09-01,4498,378,4120,127,2
Asthma,Shimla,Punjab,2019-10-01,3635,224,3411,140,1
Asthma,Shimla,Punjab,2019-11-01,2386,158,2228,163,6
Asthma,Shimla,Punjab,2019-12-01,3011,70,2941,138,6
Asthma,Shimla,Punjab,2020-01-01,1792,75,1717,100,2
Asthma,Shimla,Punjab,2020-02-01,2785,256,2529,98,1
Asthma,Shimla,Punjab,2020-03-01,2696,86,2610,103,8
Asthma,Shimla,Punjab,2020-04-01,3897,315,3582,112,3
Asthma,Shimla,Punjab,2020-05-01,3895,38,3857,171,1
Asthma,Shimla,Punjab,2020-06-01,3260,49,3211,161,4
Asthma,Shimla,Punjab,2020-07-01,2111,222,1889,145,4
Asthma,Shimla,Punjab,2020-08-01,3593,178,3415,200,10
Asthma,Shimla,Punjab,2020-09-01,2474,85,2389,11,3
Asthma,Shimla,Punjab,2020-10-01,1146,102,1044,83,4
Asthma,Shimla,Punjab,2020-11-01,2056,177,1879,106,5
Asthma,Shimla,Punjab,2020-12-01,2711,208,2503,72,3
Asthma,Shimla,Punjab,2021-01-01,3818,127,3691,59,6
Asthma,Shimla,Punjab,2021-02-01,2351,98,2253,19,2
Asthma,Shimla,Punjab,2021-03-01,975,57,918,90,4
Asthma,Shimla,Punjab,2021-04-01,2674,187,2487,152,6
Asthma,Shimla,Punjab,2021-05-01,2750,96,2654,146,8
Asthma,Shimla,Punjab,2021-06-01,2847,156,2691,68,3
Asthma,Shimla,Punjab,2021-07-01,3831,221,3610,117,3
Asthma,Shimla,Punjab,2021-08-01,3964,346,3618,175,9
Asthma,Shimla,Punjab,2021-09-01,1800,129,1671,29,3
Asthma,Shimla,Punjab,2021-10-01,1771,11,1760,98,5
Asthma,Shimla,Punjab,2021-11-01,1202,52,1150,121,10
Asthma,Shimla,Punjab,2021-12-01,3535,81,3454,107,5
Asthma,Shimla,Punjab,2022-01-01,4541,302,4239,150,4
Asthma,Shimla,Punjab,2022-02-01,2175,167,2008,30,4
Asthma,Shimla,Punjab,2022-03-01,2274,120,2154,55,3
Asthma,Shimla,Punjab,2022-04-01,4565,192,4373,141,6
Asthma,Shimla,Punjab,2022-05-01,3276,170,3106,19,2
Asthma,Shimla,Punjab,2022-06-01,3183,178,3005,148,7
Asthma,Shimla,Punjab,2022-07-01,1000,31,969,129,5
Asthma,Shimla,Punjab,2022-08-01,3508,51,3457,144,6
Asthma,Shimla,Punjab,2022-09-01,1351,0,1351,82,10
Asthma,Shimla,Punjab,2022-10-01,1076,93,983,132,1
Asthma,Shimla,Punjab,2022-11-01,2132,137,1995,46,5
Asthma,Shimla,Punjab,2022-12-01,1812,109,1703,85,7
Asthma,Shimla,Punjab,2023-01-01,2300,199,2101,108,3
Asthma,Shimla,Punjab,2023-02-01,664,8,656,60,8
Asthma,Shimla,Punjab,2023-03-01,3884,0,3884,117,3
Asthma,Shimla,Punjab,2023-04-01,4110,251,3859,48,6
Asthma,Shimla,Punjab,2023-05-01,78,0,78,120,4
Asthma,Shimla,Punjab,2023-06-01,3910,0,3910,195,5
Asthma,Shimla,Punjab,2023-07-01,1510,91,1419,42,5
Asthma,Shimla,Punjab,2023-08-01,3747,143,3604,105,5
Asthma,Shimla,Punjab,2023-09-01,2506,66,2440,24,3
Asthma,Shimla,Punjab,2023-10-01,2636,106,2530,64,3
Asthma,Shimla,Punjab,2023-11-01,2349,0,2349,142,6
Asthma,Shimla,Punjab,2023-12-01,4223,138,4085,84,5
Asthma,Shimla,Punjab,2024-01-01,934,27,907,144,3
Asthma,Shimla,Punjab,2024-02-01,3413,226,3187,124,6
Asthma,Shimla,Punjab,2024-03-01,4075,185,3890,103,3
Asthma,Shimla,Punjab,2024-04-01,3558,244,3314,54,9
Asthma,Shimla,Punjab,2024-05-01,4989,20,4969,141,10
Asthma,Shimla,Punjab,2024-06-01,1888,48,1840,122,9
Asthma,Shimla,Punjab,2024-07-01,3882,257,3625,28,9
Asthma,Shimla,Punjab,2024-08-01,2455,100,2355,57,7
Asthma,Shimla,Punjab,2024-09-01,4252,317,3935,11,4
Asthma,Shimla,Punjab,2024-10-01,2587,0,2587,37,1
Asthma,Shimla,Punjab,2024-11-01,2077,148,1929,90,2
Asthma,Shimla,Punjab,2024-12-01,4350,136,4214,52,3
Asthma,Shimla,Punjab,2025-01-01,1938,55,1883,64,8
Asthma,Shimla,Punjab,2025-02-01,702,55,647,177,6
Asthma,Shimla,Punjab,2025-03-01,1904,159,1745,159,3
Asthma,Shimla,Punjab,2025-04-01,3428,274,3154,71,1
Asthma,Shimla,Punjab,2025-05-01,4465,442,4023,147,10
Asthma,Shimla,Punjab,2025-06-01,2746,238,2508,168,6
Asthma,Shimla,Punjab,2025-07-01,4366,117,4249,138,7
Asthma,Shimla,Punjab,2025-08-01,775,41,734,121,3
Asthma,Shimla,Punjab,2025-09-01,2003,79,1924,162,4
Asthma,Shimla,Punjab,2025-10-01,2210,241,1969,145,4
Asthma,Shimla,Punjab,2025-11-01,2444,200,2244,44,5
Asthma,Shimla,Punjab,2025-12-01,2710,120,2590,97,10
Asthma,Shimla,Chandigarh,2018-01-01,3524,266,3258,78,1
Asthma,Shimla,Chandigarh,2018-02-01,2001,28,1973,165,5
Asthma,Shimla,Chandigarh,2018-03-01,2784,159,2625,77,6
Asthma,Shimla,Chandigarh,2018-04-01,2537,57,2480,68,4
Asthma,Shimla,Chandigarh,2018-05-01,1355,1,1354,159,8
Asthma,Shimla,Chandigarh,2018-06-01,2445,178,2267,119,1
Asthma,Shimla,Chandigarh,2018-07-01,2405,184,2221,200,10
Asthma,Shimla,Chandigarh,2018-08-01,2376,150,2226,62,1
Asthma,Shimla,Chandigarh,2018-09-01,2640,118,2522,80,2
Asthma,Shimla,Chandigarh,2018-10-01,2699,35,2664,163,4
Asthma,Shimla,Chandigarh,2018-11-01,2017,32,1985,41,3
Asthma,Shimla,Chandigarh,2018-12-01,4305,94,4211,173,6
Asthma,Shimla,Chandigarh,2019-01-01,1029,44,985,45,6
Asthma,Shimla,Chandigarh,2019-02-01,1630,132,1498,137,5
Asthma,Shimla,Chandigarh,2019-03-01,4989,403,4586,12,1
Asthma,Shimla,Chandigarh,2019-04-01,1205,2,1203,109,4
Asthma,Shimla,Chandigarh,2019-05-01,781,23,758,36,5
Asthma,Shimla,Chandigarh,2019-06-01,3583,104,3479,200,8
Asthma,Shimla,Chandigarh,2019-07-01,78,0,78,52,5
Asthma,Shimla,Chandigarh,2019-08-01,2282,151,2131,64,6
Asthma,Shimla,Chandigarh,2019-09-01,4989,214,4775,133,10
Asthma,Shimla,Chandigarh,2019-10-01,525,24,501,76,1
Asthma,Shimla,Chandigarh,2019-11-01,78,0,78,142,4
Asthma,Shimla,Chandigarh,2019-12-01,586,30,556,70,2
Asthma,Shimla,Chandigarh,2020-01-01,3803,142,3661,66,9
Asthma,Shimla,Chandigarh,2020-02-01,4106,273,3833,105,10
Asthma,Shimla,Chandigarh,2020-03-01,1910,154,1756,44,9
Asthma,Shimla,Chandigarh,2020-04-01,3514,206,3308,126,6
Asthma,Shimla,Chandigarh,2020-05-01,4462,312,4150,151,6
Asthma,Shimla,Chandigarh,2020-06-01,4989,228,4761,134,3
Asthma,Shimla,Chandigarh,2020-07-01,2267,108,2159,139,7
Asthma,Shimla,Chandigarh,2020-08-01,78,0,78,11,1
Asthma,Shimla,Chandigarh,2020-09-01,1496,42,1454,83,1
Asthma,Shimla,Chandigarh,2020-10-01,2025,67,1958,95,4
Asthma,Shimla,Chandigarh,2020-11-01,2250,202,2048,180,10
Asthma,Shimla,Chandigarh,2020-12-01,2345,254,2091,77,3
Asthma,Shimla,Chandigarh,2021-01-01,4098,395,3703,11,4
Asthma,Shimla,Chandigarh,2021-02-01,4307,49,4258,55,6
Asthma,Shimla,Chandigarh,2021-03-01,2367,20,2347,73,7
Asthma,Shimla,Chandigarh,2021-04-01,4071,62,4009,11,8
Asthma,Shimla,Chandigarh,2021-05-01,3077,166,2911,156,2
Asthma,Shimla,Chandigarh,2021-06-01,2684,0,2684,26,5
Asthma,Shimla,Chandigarh,2021-07-01,3814,125,3689,129,5
Asthma,Shimla,Chandigarh,2021-08-01,2694,245,2449,51,6
Asthma,Shimla,Chandigarh,2021-09-01,4989,392,4597,183,7
Asthma,Shimla,Chandigarh,2021-10-01,668,23,645,92,7
Asthma,Shimla,Chandigarh,2021-11-01,1906,71,1835,82,5
Asthma,Shimla,Chandigarh,2021-12-01,2428,161,2267,133,8
Asthma,Shimla,Chandigarh,2022-01-01,3187,246,2941,55,8
Asthma,Shimla,Chandigarh,2022-02-01,4298,148,4150,136,7
Asthma,Shimla,Chandigarh,2022-03-01,2565,110,2455,82,3
Asthma,Shimla,Chandigarh,2022-04-01,689,23,666,76,7
Asthma,Shimla,Chandigarh,2022-05-01,3728,42,3686,102,8
Asthma,Shimla,Chandigarh,2022-06-01,3610,157,3453,51,3
Asthma,Shimla,Chandigarh,2022-07-01,78,0,78,96,5
Asthma,Shimla,Chandigarh,2022-08-01,2592,34,2558,124,9
Asthma,Shimla,Chandigarh,2022-09-01,464,31,433,11,6
Asthma,Shimla,Chandigarh,2022-10-01,1706,109,1597,162,5
Asthma,Shimla,Chandigarh,2022-11-01,1386,97,1289,148,9
Asthma,Shimla,Chandigarh,2022-12-01,3683,102,3581,12,3
Asthma,Shimla,Chandigarh,2023-01-01,2754,0,2754,11,1
Asthma,Shimla,Chandigarh,2023-02-01,873,55,818,149,3
Asthma,Shimla,Chandigarh,2023-03-01,3778,116,3662,145,8
Asthma,Shimla,Chandigarh,2023-04-01,674,16,658,138,6
Asthma,Shimla,Chandigarh,2023-05-01,3040,40,3000,34,5
Asthma,Shimla,Chandigarh,2023-06-01,1505,63,1442,199,8
Asthma,Shimla,Chandigarh,2023-07-01,2107,202,1905,68,5
Asthma,Shimla,Chandigarh,2023-08-01,3274,115,3159,118,4
Asthma,Shimla,Chandigarh,2023-09-01,3297,60,3237,119,7
Asthma,Shimla,Chandigarh,2023-10-01,4391,303,4088,187,4
Asthma,Shimla,Chandigarh,2023-11-01,2487,137,2350,113,6
Asthma,Shimla,Chandigarh,2023-12-01,3009,0,3009,127,3
Asthma,Shimla,Chandigarh,2024-01-01,2010,139,1871,102,2
Asthma,Shimla,Chandigarh,2024-02-01,2842,318,2524,45,2
Asthma,Shimla,Chandigarh,2024-03-01,3187,0,3187,11,5
Asthma,Shimla,Chandigarh,2024-04-01,2466,34,2432,108,3
Asthma,Shimla,Chandigarh,2024-05-01,178,0,178,34,3
Asthma,Shimla,Chandigarh,2024-06-01,3042,145,2897,124,4
Asthma,Shimla,Chandigarh,2024-07-01,3086,243,2843,114,5
Asthma,Shimla,Chandigarh,2024-08-01,1685,89,1596,113,1
Asthma,Shimla,Chandigarh,2024-09-01,874,79,795,53,1
Asthma,Shimla,Chandigarh,2024-10-01,4577,339,4238,159,6
Asthma,Shimla,Chandigarh,2024-11-01,3257,324,2933,130,5
Asthma,Shimla,Chandigarh,2024-12-01,2290,191,2099,46,1
Asthma,Shimla,Chandigarh,2025-01-01,1072,41,1031,200,6
Asthma,Shimla,Chandigarh,2025-02-01,1495,77,1418,95,6
Asthma,Shimla,Chandigarh,2025-03-01,4345,107,4238,38,4
Asthma,Shimla,Chandigarh,2025-04-01,2782,120,2662,68,10
Asthma,Shimla,Chandigarh,2025-05-01,1859,96,1763,29,9
Asthma,Shimla,Chandigarh,2025-06-01,3281,156,3125,175,4
Asthma,Shimla,Chandigarh,2025-07-01,1505,134,1371,161,4
Asthma,Shimla,Chandigarh,2025-08-01,4611,186,4425,144,1
Asthma,Shimla,Chandigarh,2025-09-01,4412,101,4311,134,8
Asthma,Shimla,Chandigarh,2025-10-01,1971,48,1923,170,6
Asthma,Shimla,Chandigarh,2025-11-01,1754,121,1633,94,7
Asthma,Shimla,Chandigarh,2025-12-01,78,0,78,128,1
Asthma,Shimla,Himachal Pradesh,2018-01-01,610,26,584,65,7
Asthma,Shimla,Himachal Pradesh,2018-02-01,800,70,730,98,3
Asthma,Shimla,Himachal Pradesh,2018-03-01,2779,162,2617,129,7
Asthma,Shimla,Himachal Pradesh,2018-04-01,2160,103,2057,11,6
Asthma,Shimla,Himachal Pradesh,2018-05-01,793,38,755,75,5
Asthma,Shimla,Himachal Pradesh,2018-06-01,2220,44,2176,115,3
Asthma,Shimla,Himachal Pradesh,2018-07-01,3275,82,3193,102,6
Asthma,Shimla,Himachal Pradesh,2018-08-01,3306,146,3160,83,2
Asthma,Shimla,Himachal Pradesh,2018-09-01,78,0,78,136,8
Asthma,Shimla,Himachal Pradesh,2018-10-01,2425,188,2237,70,3
Asthma,Shimla,Himachal Pradesh,2018-11-01,742,39,703,44,5
Asthma,Shimla,Himachal Pradesh,2018-12-01,3807,340,3467,167,3
Asthma,Shimla,Himachal Pradesh,2019-01-01,3649,353,3296,159,5
Asthma,Shimla,Himachal Pradesh,2019-02-01,1393,101,1292,76,2
Asthma,Shimla,Himachal Pradesh,2019-03-01,1570,134,1436,103,2
Asthma,Shimla,Himachal Pradesh,2019-04-01,1979,42,1937,149,10
Asthma,Shimla,Himachal Pradesh,2019-05-01,78,0,78,108,7
Asthma,Shimla,Himachal Pradesh,2019-06-01,3048,198,2850,133,6
Asthma,Shimla,Himachal Pradesh,2019-07-01,2231,24,2207,130,6
Asthma,Shimla,Himachal Pradesh,2019-08-01,3899,162,3737,90,6
Asthma,Shimla,Himachal Pradesh,2019-09-01,1124,81,1043,132,5
Asthma,Shimla,Himachal Pradesh,2019-10-01,1767,161,1606,57,7
Asthma,Shimla,Himachal Pradesh,2019-11-01,576,24,552,126,2
Asthma,Shimla,Himachal Pradesh,2019-12-01,1250,38,1212,102,9
Asthma,Shimla,Himachal Pradesh,2020-01-01,1012,60,952,88,5
Asthma,Shimla,Himachal Pradesh,2020-02-01,3934,74,3860,43,7
Asthma,Shimla,Himachal Pradesh,2020-03-01,1661,74,1587,113,9
Asthma,Shimla,Himachal Pradesh,2020-04-01,2764,137,2627,108,6
Asthma,Shimla,Himachal Pradesh,2020-05-01,2087,102,1985,63,2
Asthma,Shimla,Himachal Pradesh,2020-06-01,894,47,847,25,8
Asthma,Shimla,Himachal Pradesh,2020-07-01,2372,61,2311,22,10
Asthma,Shimla,Himachal Pradesh,2020-08-01,3401,98,3303,93,1
Asthma,Shimla,Himachal Pradesh,2020-09-01,977,27,950,122,5
Asthma,Shimla,Himachal Pradesh,2020-10-01,3683,10,3673,200,6
Asthma,Shimla,Himachal Pradesh,2020-11-01,1457,87,1370,104,4
Asthma,Shimla,Himachal Pradesh,2020-12-01,1949,148,1801,23,1
Asthma,Shimla,Himachal Pradesh,2021-01-01,3309,242,3067,96,2
Asthma,Shimla,Himachal Pradesh,2021-02-01,1707,72,1635,170,1
Asthma,Shimla,Himachal Pradesh,2021-03-01,2648,70,2578,71,8
Asthma,Shimla,Himachal Pradesh,2021-04-01,2175,156,2019,163,9
Asthma,Shimla,Himachal Pradesh,2021-05-01,2771,190,2581,115,9
Asthma,Shimla,Himachal Pradesh,2021-06-01,78,0,78,139,5
Asthma,Shimla,Himachal Pradesh,2021-07-01,143,14,129,200,6
Asthma,Shimla,Himachal Pradesh,2021-08-01,3424,168,3256,13,8
Asthma,Shimla,Himachal Pradesh,2021-09-01,3989,169,3820,152,4
Asthma,Shimla,Himachal Pradesh,2021-10-01,1376,52,1324,101,2
Asthma,Shimla,Himachal Pradesh,2021-11-01,2270,10,2260,58,3
Asthma,Shimla,Himachal Pradesh,2021-12-01,2993,207,2786,101,5
Asthma,Shimla,Himachal Pradesh,2022-01-01,3527,165,3362,192,3
Asthma,Shimla,Himachal Pradesh,2022-02-01,78,0,78,174,6
Asthma,Shimla,Himachal Pradesh,2022-03-01,1409,146,1263,11,1
Asthma,Shimla,Himachal Pradesh,2022-04-01,2151,83,2068,67,4
Asthma,Shimla,Himachal Pradesh,2022-05-01,3541,0,3541,154,6
Asthma,Shimla,Himachal Pradesh,2022-06-01,4989,319,4670,105,5
Asthma,Shimla,Himachal Pradesh,2022-07-01,2292,125,2167,105,3
Asthma,Shimla,Himachal Pradesh,2022-08-01,710,20,690,26,7
Asthma,Shimla,Himachal Pradesh,2022-09-01,3137,193,2944,68,6
Asthma,Shimla,Himachal Pradesh,2022-10-01,4370,318,4052,37,1
Asthma,Shimla,Himachal Pradesh,2022-11-01,2742,61,2681,22,6
Asthma,Shimla,Himachal Pradesh,2022-12-01,1381,57,1324,42,4
Asthma,Shimla,Himachal Pradesh,2023-01-01,3883,361,3522,59,3
Asthma,Shimla,Himachal Pradesh,2023-02-01,3488,101,3387,67,2
Asthma,Shimla,Himachal Pradesh,2023-03-01,1221,63,1158,63,2
Asthma,Shimla,Himachal Pradesh,2023-04-01,3109,0,3109,158,5
Asthma,Shimla,Himachal Pradesh,2023-05-01,3935,27,3908,60,6
Asthma,Shimla,Himachal Pradesh,2023-06-01,4183,228,3955,179,5
Asthma,Shimla,Himachal Pradesh,2023-07-01,2508,215,2293,82,8
Asthma,Shimla,Himachal Pradesh,2023-08-01,2117,22,2095,129,7
Asthma,Shimla,Himachal Pradesh,2023-09-01,4244,221,4023,130,1
Asthma,Shimla,Himachal Pradesh,2023-10-01,974,38,936,60,2
Asthma,Shimla,Himachal Pradesh,2023-11-01,3186,247,2939,89,8
Asthma,Shimla,Himachal Pradesh,2023-12-01,760,11,749,81,1
Asthma,Shimla,Himachal Pradesh,2024-01-01,4027,252,3775,125,1
Asthma,Shimla,Himachal Pradesh,2024-02-01,2251,69,2182,100,10
Asthma,Shimla,Himachal Pradesh,2024-03-01,4299,243,4056,68,6
Asthma,Shimla,Himachal Pradesh,2024-04-01,3257,169,3088,112,3
Asthma,Shimla,Himachal Pradesh,2024-05-01,956,40,916,124,2
Asthma,Shimla,Himachal Pradesh,2024-06-01,4509,288,4221,200,7
Asthma,Shimla,Himachal Pradesh,2024-07-01,4678,240,4438,110,6
Asthma,Shimla,Himachal Pradesh,2024-08-01,3781,174,3607,107,6
Asthma,Shimla,Himachal Pradesh,2024-09-01,1576,62,1514,128,4
Asthma,Shimla,Himachal Pradesh,2024-10-01,2187,114,2073,58,1
Asthma,Shimla,Himachal Pradesh,2024-11-01,2792,157,2635,18,5
Asthma,Shimla,Himachal Pradesh,2024-12-01,1653,35,1618,90,8
Asthma,Shimla,Himachal Pradesh,2025-01-01,4868,194,4674,161,3
Asthma,Shimla,Himachal Pradesh,2025-02-01,2791,54,2737,169,7
Asthma,Shimla,Himachal Pradesh,2025-03-01,78,0,78,11,4
Asthma,Shimla,Himachal Pradesh,2025-04-01,3053,100,2953,140,7
Asthma,Shimla,Himachal Pradesh,2025-05-01,2130,154,1976,11,2
Asthma,Shimla,Himachal Pradesh,2025-06-01,2497,173,2324,130,5
Asthma,Shimla,Himachal Pradesh,2025-07-01,2103,48,2055,127,6
Asthma,Shimla,Himachal Pradesh,2025-08-01,3680,184,3496,18,3
Asthma,Shimla,Himachal Pradesh,2025-09-01,4099,281,3818,157,6
Asthma,Shimla,Himachal Pradesh,2025-10-01,2977,133,2844,195,5
Asthma,Shimla,Himachal Pradesh,2025-11-01,2142,61,2081,103,5
Asthma,Shimla,Himachal Pradesh,2025-12-01,2542,46,2496,113,3
Asthma,Shimla,Jammu & Kashmir,2018-01-01,2624,196,2428,182,8
Asthma,Shimla,Jammu & Kashmir,2018-02-01,1521,116,1405,49,2
Asthma,Shimla,Jammu & Kashmir,2018-03-01,3374,148,3226,50,6
Asthma,Shimla,Jammu & Kashmir,2018-04-01,3215,232,2983,63,2
Asthma,Shimla,Jammu & Kashmir,2018-05-01,4664,0,4664,108,5
Asthma,Shimla,Jammu & Kashmir,2018-06-01,4281,379,3902,108,7
Asthma,Shimla,Jammu & Kashmir,2018-07-01,1678,76,1602,78,4
Asthma,Shimla,Jammu & Kashmir,2018-08-01,3698,200,3498,91,1
Asthma,Shimla,Jammu & Kashmir,2018-09-01,1322,53,1269,79,1
Asthma,Shimla,Jammu & Kashmir,2018-10-01,3531,320,3211,81,1
Asthma,Shimla,Jammu & Kashmir,2018-11-01,1904,36,1868,67,5
Asthma,Shimla,Jammu & Kashmir,2018-12-01,1225,113,1112,67,5
Asthma,Shimla,Jammu & Kashmir,2019-01-01,2973,183,2790,11,4
Asthma,Shimla,Jammu & Kashmir,2019-02-01,78,0,78,95,3
Asthma,Shimla,Jammu & Kashmir,2019-03-01,248,10,238,11,5
Asthma,Shimla,Jammu & Kashmir,2019-04-01,2359,28,2331,144,1
Asthma,Shimla,Jammu & Kashmir,2019-05-01,2708,208,2500,78,8
Asthma,Shimla,Jammu & Kashmir,2019-06-01,2102,124,1978,100,5
Asthma,Shimla,Jammu & Kashmir,2019-07-01,479,42,437,87,2
Asthma,Shimla,Jammu & Kashmir,2019-08-01,1500,66,1434,94,4
Asthma,Shimla,Jammu & Kashmir,2019-09-01,3122,118,3004,171,4
Asthma,Shimla,Jammu & Kashmir,2019-10-01,3378,305,3073,37,1
Asthma,Shimla,Jammu & Kashmir,2019-11-01,2576,272,2304,24,7
Asthma,Shimla,Jammu & Kashmir,2019-12-01,4149,208,3941,112,8
Asthma,Shimla,Jammu & Kashmir,2020-01-01,3131,88,3043,81,5
Asthma,Shimla,Jammu & Kashmir,2020-02-01,1595,117,1478,125,8
Asthma,Shimla,Jammu & Kashmir,2020-03-01,2221,94,2127,143,10
Asthma,Shimla,Jammu & Kashmir,2020-04-01,715,48,667,50,1
Asthma,Shimla,Jammu & Kashmir,2020-05-01,2452,104,2348,137,5
Asthma,Shimla,Jammu & Kashmir,2020-06-01,4089,390,3699,54,1
Asthma,Shimla,Jammu & Kashmir,2020-07-01,3517,104,3413,110,9
Asthma,Shimla,Jammu & Kashmir,2020-08-01,4478,286,4192,43,6
Asthma,Shimla,Jammu & Kashmir,2020-09-01,2191,78,2113,113,3
Asthma,Shimla,Jammu & Kashmir,2020-10-01,4403,184,4219,105,4
Asthma,Shimla,Jammu & Kashmir,2020-11-01,2338,89,2249,50,9
Asthma,Shimla,Jammu & Kashmir,2020-12-01,4572,327,4245,37,6
Asthma,Shimla,Jammu & Kashmir,2021-01-01,2568,197,2371,144,7
Asthma,Shimla,Jammu & Kashmir,2021-02-01,3546,235,3311,83,9
Asthma,Shimla,Jammu & Kashmir,2021-03-01,4576,214,4362,158,8
Asthma,Shimla,Jammu & Kashmir,2021-04-01,2338,126,2212,79,8
Asthma,Shimla,Jammu & Kashmir,2021-05-01,2890,220,2670,173,4
Asthma,Shimla,Jammu & Kashmir,2021-06-01,4326,333,3993,58,1
Asthma,Shimla,Jammu & Kashmir,2021-07-01,2419,0,2419,181,5
Asthma,Shimla,Jammu & Kashmir,2021-08-01,825,34,791,115,3
Asthma,Shimla,Jammu & Kashmir,2021-09-01,4989,217,4772,127,7
Asthma,Shimla,Jammu & Kashmir,2021-10-01,1967,136,1831,55,1
Asthma,Shimla,Jammu & Kashmir,2021-11-01,2810,135,2675,143,7
Asthma,Shimla,Jammu & Kashmir,2021-12-01,4148,294,3854,145,5
Asthma,Shimla,Jammu & Kashmir,2022-01-01,1781,33,1748,90,6
Asthma,Shimla,Jammu & Kashmir,2022-02-01,1245,71,1174,11,7
Asthma,Shimla,Jammu & Kashmir,2022-03-01,2938,224,2714,49,5
Asthma,Shimla,Jammu & Kashmir,2022-04-01,192,1,191,49,4
Asthma,Shimla,Jammu & Kashmir,2022-05-01,2211,272,1939,129,8
Asthma,Shimla,Jammu & Kashmir,2022-06-01,2926,247,2679,83,7
Asthma,Shimla,Jammu & Kashmir,2022-07-01,2235,111,2124,84,7
Asthma,Shimla,Jammu & Kashmir,2022-08-01,527,13,514,77,5
Asthma,Shimla,Jammu & Kashmir,2022-09-01,4736,213,4523,181,5
Asthma,Shimla,Jammu & Kashmir,2022-10-01,2736,143,2593,109,5
Asthma,Shimla,Jammu & Kashmir,2022-11-01,4517,284,4233,116,1
Asthma,Shimla,Jammu & Kashmir,2022-12-01,2249,210,2039,75,1
Asthma,Shimla,Jammu & Kashmir,2023-01-01,1417,51,1366,105,4
Asthma,Shimla,Jammu & Kashmir,2023-02-01,2959,196,2763,57,1
Asthma,Shimla,Jammu & Kashmir,2023-03-01,2308,28,2280,124,5
Asthma,Shimla,Jammu & Kashmir,2023-04-01,1017,38,979,48,2
Asthma,Shimla,Jammu & Kashmir,2023-05-01,4569,278,4291,144,5
Asthma,Shimla,Jammu & Kashmir,2023-06-01,1763,123,1640,69,5
Asthma,Shimla,Jammu & Kashmir,2023-07-01,129,3,126,155,1
Asthma,Shimla,Jammu & Kashmir,2023-08-01,4379,163,4216,200,6
Asthma,Shimla,Jammu & Kashmir,2023-09-01,1921,177,1744,106,4
Asthma,Shimla,Jammu & Kashmir,2023-10-01,1782,149,1633,173,1
Asthma,Shimla,Jammu & Kashmir,2023-11-01,229,12,217,144,3
Asthma,Shimla,Jammu & Kashmir,2023-12-01,4933,0,4933,33,6
Asthma,Shimla,Jammu & Kashmir,2024-01-01,868,106,762,112,4
Asthma,Shimla,Jammu & Kashmir,2024-02-01,2676,132,2544,132,3
Asthma,Shimla,Jammu & Kashmir,2024-03-01,3822,156,3666,137,5
Asthma,Shimla,Jammu & Kashmir,2024-04-01,3163,110,3053,115,3
Asthma,Shimla,Jammu & Kashmir,2024-05-01,2517,153,2364,115,4
Asthma,Shimla,Jammu & Kashmir,2024-06-01,315,19,296,106,1
Asthma,Shimla,Jammu & Kashmir,2024-07-01,1511,117,1394,113,3
Asthma,Shimla,Jammu & Kashmir,2024-08-01,2849,65,2784,44,10
Asthma,Shimla,Jammu & Kashmir,2024-09-01,1541,63,1478,94,5
Asthma,Shimla,Jammu & Kashmir,2024-10-01,2870,313,2557,32,6
Asthma,Shimla,Jammu & Kashmir,2024-11-01,3512,198,3314,81,3
Asthma,Shimla,Jammu & Kashmir,2024-12-01,3889,175,3714,76,4
Asthma,Shimla,Jammu & Kashmir,2025-01-01,952,21,931,73,4
Asthma,Shimla,Jammu & Kashmir,2025-02-01,4989,323,4666,53,7
Asthma,Shimla,Jammu & Kashmir,2025-03-01,3627,290,3337,120,8
Asthma,Shimla,Jammu & Kashmir,2025-04-01,2595,195,2400,90,4
Asthma,Shimla,Jammu & Kashmir,2025-05-01,4059,172,3887,85,5
Asthma,Shimla,Jammu & Kashmir,2025-06-01,4989,302,4687,34,4
Asthma,Shimla,Jammu & Kashmir,2025-07-01,667,65,602,91,7
Asthma,Shimla,Jammu & Kashmir,2025-08-01,2295,186,2109,165,6
Asthma,Shimla,Jammu & Kashmir,2025-09-01,78,0,78,165,5
Asthma,Shimla,Jammu & Kashmir,2025-10-01,2856,0,2856,125,8
Asthma,Shimla,Jammu & Kashmir,2025-11-01,3088,181,2907,91,6
Asthma,Shimla,Jammu & Kashmir,2025-12-01,2545,186,2359,135,3
Asthma,Shimla,Haryana,2018-01-01,1719,31,1688,72,5
Asthma,Shimla,Haryana,2018-02-01,78,0,78,91,4
Asthma,Shimla,Haryana,2018-03-01,3099,131,2968,68,2
Asthma,Shimla,Haryana,2018-04-01,4550,241,4309,152,4
Asthma,Shimla,Haryana,2018-05-01,1805,61,1744,146,8
Asthma,Shimla,Haryana,2018-06-01,3188,279,2909,104,8
Asthma,Shimla,Haryana,2018-07-01,494,26,468,194,7
Asthma,Shimla,Haryana,2018-08-01,3211,78,3133,127,7
Asthma,Shimla,Haryana,2018-09-01,2070,158,1912,124,5
Asthma,Shimla,Haryana,2018-10-01,1575,20,1555,119,3
Asthma,Shimla,Haryana,2018-11-01,1577,137,1440,42,6
Asthma,Shimla,Haryana,2018-12-01,2069,163,1906,61,1
Asthma,Shimla,Haryana,2019-01-01,3110,281,2829,103,3
Asthma,Shimla,Haryana,2019-02-01,837,38,799,104,8
Asthma,Shimla,Haryana,2019-03-01,2065,73,1992,136,3
Asthma,Shimla,Haryana,2019-04-01,2542,133,2409,72,7
Asthma,Shimla,Haryana,2019-05-01,1123,53,1070,110,4
Asthma,Shimla,Haryana,2019-06-01,4989,155,4834,111,6
Asthma,Shimla,Haryana,2019-07-01,1452,49,1403,113,1
Asthma,Shimla,Haryana,2019-08-01,1699,66,1633,107,9
Asthma,Shimla,Haryana,2019-09-01,1285,20,1265,35,2
Asthma,Shimla,Haryana,2019-10-01,4989,348,4641,11,1
Asthma,Shimla,Haryana,2019-11-01,3339,162,3177,58,8
Asthma,Shimla,Haryana,2019-12-01,1341,55,1286,79,5
Asthma,Shimla,Haryana,2020-01-01,4081,72,4009,46,4
Asthma,Shimla,Haryana,2020-02-01,2867,46,2821,103,9
Asthma,Shimla,Haryana,2020-03-01,2943,313,2630,162,7
Asthma,Shimla,Haryana,2020-04-01,2135,67,2068,143,4
Asthma,Shimla,Haryana,2020-05-01,1592,108,1484,130,4
Asthma,Shimla,Haryana,2020-06-01,3051,167,2884,156,8
Asthma,Shimla,Haryana,2020-07-01,1866,0,1866,59,2
Asthma,Shimla,Haryana,2020-08-01,4989,442,4547,83,9
Asthma,Shimla,Haryana,2020-09-01,895,62,833,138,4
Asthma,Shimla,Haryana,2020-10-01,4658,129,4529,82,2
Asthma,Shimla,Haryana,2020-11-01,2448,120,2328,85,8
Asthma,Shimla,Haryana,2020-12-01,2999,49,2950,200,7
Asthma,Shimla,Haryana,2021-01-01,3715,383,3332,111,1
Asthma,Shimla,Haryana,2021-02-01,1752,41,1711,196,5
Asthma,Shimla,Haryana,2021-03-01,3757,130,3627,13,2
Asthma,Shimla,Haryana,2021-04-01,78,0,78,74,7
Asthma,Shimla,Haryana,2021-05-01,1632,85,1547,127,10
Asthma,Shimla,Haryana,2021-06-01,1358,122,1236,111,6
Asthma,Shimla,Haryana,2021-07-01,916,93,823,11,3
Asthma,Shimla,Haryana,2021-08-01,2309,88,2221,95,7
Asthma,Shimla,Haryana,2021-09-01,3115,190,2925,200,5
Asthma,Shimla,Haryana,2021-10-01,3540,185,3355,119,5
Asthma,Shimla,Haryana,2021-11-01,2921,62,2859,137,3
Asthma,Shimla,Haryana,2021-12-01,1704,205,1499,73,5
Asthma,Shimla,Haryana,2022-01-01,3092,277,2815,119,5
Asthma,Shimla,Haryana,2022-02-01,2764,153,2611,106,1
Asthma,Shimla,Haryana,2022-03-01,3853,370,3483,163,5
Asthma,Shimla,Haryana,2022-04-01,3640,310,3330,162,4
Asthma,Shimla,Haryana,2022-05-01,2638,138,2500,127,6
Asthma,Shimla,Haryana,2022-06-01,1394,83,1311,110,1
Asthma,Shimla,Haryana,2022-07-01,1721,161,1560,21,6
Asthma,Shimla,Haryana,2022-08-01,1860,41,1819,19,5
Asthma,Shimla,Haryana,2022-09-01,2174,214,1960,110,6
Asthma,Shimla,Haryana,2022-10-01,2957,128,2829,151,1
Asthma,Shimla,Haryana,2022-11-01,3557,335,3222,174,1
Asthma,Shimla,Haryana,2022-12-01,2529,126,2403,61,1
Asthma,Shimla,Haryana,2023-01-01,2619,156,2463,29,5
Asthma,Shimla,Haryana,2023-02-01,2790,136,2654,154,4
Asthma,Shimla,Haryana,2023-03-01,1905,65,1840,65,4
Asthma,Shimla,Haryana,2023-04-01,1356,57,1299,26,1
Asthma,Shimla,Haryana,2023-05-01,242,21,221,81,1
Asthma,Shimla,Haryana,2023-06-01,1665,0,1665,80,1
Asthma,Shimla,Haryana,2023-07-01,3232,45,3187,173,1
Asthma,Shimla,Haryana,2023-08-01,1654,47,1607,150,3
Asthma,Shimla,Haryana,2023-09-01,2278,42,2236,69,3
Asthma,Shimla,Haryana,2023-10-01,3223,303,2920,177,5
Asthma,Shimla,Haryana,2023-11-01,3296,285,3011,113,7
Asthma,Shimla,Haryana,2023-12-01,1149,77,1072,160,3
Asthma,Shimla,Haryana,2024-01-01,3935,123,3812,174,6
Asthma,Shimla,Haryana,2024-02-01,4110,365,3745,93,7
Asthma,Shimla,Haryana,2024-03-01,1082,4,1078,135,8
Asthma,Shimla,Haryana,2024-04-01,1492,167,1325,85,6
Asthma,Shimla,Haryana,2024-05-01,4195,126,4069,154,5
Asthma,Shimla,Haryana,2024-06-01,2400,101,2299,111,2
Asthma,Shimla,Haryana,2024-07-01,78,0,78,155,6
Asthma,Shimla,Haryana,2024-08-01,720,13,707,184,4
Asthma,Shimla,Haryana,2024-09-01,2263,240,2023,134,9
Asthma,Shimla,Haryana,2024-10-01,1037,75,962,101,5
Asthma,Shimla,Haryana,2024-11-01,2043,174,1869,102,4
Asthma,Shimla,Haryana,2024-12-01,2641,38,2603,11,9
Asthma,Shimla,Haryana,2025-01-01,4559,252,4307,70,3
Asthma,Shimla,Haryana,2025-02-01,2208,144,2064,154,5
Asthma,Shimla,Haryana,2025-03-01,4036,233,3803,156,10
Asthma,Shimla,Haryana,2025-04-01,4514,73,4441,69,6
Asthma,Shimla,Haryana,2025-05-01,4522,367,4155,115,8
Asthma,Shimla,Haryana,2025-06-01,2979,159,2820,97,9
Asthma,Shimla,Haryana,2025-07-01,78,0,78,141,3
Asthma,Shimla,Haryana,2025-08-01,3216,0,3216,200,7
Asthma,Shimla,Haryana,2025-09-01,4004,271,3733,142,4
Asthma,Shimla,Haryana,2025-10-01,2489,302,2187,72,10
Asthma,Shimla,Haryana,2025-11-01,4938,101,4837,102,9
Asthma,Shimla,Haryana,2025-12-01,3751,206,3545,178,7
Asthma,Manali,Punjab,2018-01-01,3360,276,3084,34,8
Asthma,Manali,Punjab,2018-02-01,4055,53,4002,75,3
Asthma,Manali,Punjab,2018-03-01,3045,109,2936,142,10
Asthma,Manali,Punjab,2018-04-01,78,0,78,172,2
Asthma,Manali,Punjab,2018-05-01,1928,151,1777,137,6
Asthma,Manali,Punjab,2018-06-01,4203,372,3831,75,3
Asthma,Manali,Punjab,2018-07-01,1514,82,1432,134,7
Asthma,Manali,Punjab,2018-08-01,2298,58,2240,127,10
Asthma,Manali,Punjab,2018-09-01,1196,44,1152,124,6
Asthma,Manali,Punjab,2018-10-01,4989,158,4831,101,6
Asthma,Manali,Punjab,2018-11-01,4853,104,4749,109,4
Asthma,Manali,Punjab,2018-12-01,1412,66,1346,60,5
Asthma,Manali,Punjab,2019-01-01,2795,186,2609,200,4
Asthma,Manali,Punjab,2019-02-01,1685,108,1577,114,10
Asthma,Manali,Punjab,2019-03-01,3422,170,3252,134,7
Asthma,Manali,Punjab,2019-04-01,3281,169,3112,95,4
Asthma,Manali,Punjab,2019-05-01,3686,175,3511,149,5
Asthma,Manali,Punjab,2019-06-01,3043,37,3006,40,10
Asthma,Manali,Punjab,2019-07-01,4989,273,4716,17,6
Asthma,Manali,Punjab,2019-08-01,1218,40,1178,105,9
Asthma,Manali,Punjab,2019-09-01,303,3,300,200,3
Asthma,Manali,Punjab,2019-10-01,2070,125,1945,168,6
Asthma,Manali,Punjab,2019-11-01,494,15,479,65,3
Asthma,Manali,Punjab,2019-12-01,595,33,562,133,3
Asthma,Manali,Punjab,2020-01-01,1254,93,1161,74,7
Asthma,Manali,Punjab,2020-02-01,1360,30,1330,128,2
Asthma,Manali,Punjab,2020-03-01,1317,69,1248,132,1
Asthma,Manali,Punjab,2020-04-01,3293,0,3293,153,7
Asthma,Manali,Punjab,2020-05-01,1918,181,1737,26,3
Asthma,Manali,Punjab,2020-06-01,2357,24,2333,42,4
Asthma,Manali,Punjab,2020-07-01,3797,133,3664,102,1
Asthma,Manali,Punjab,2020-08-01,1569,139,1430,54,1
Asthma,Manali,Punjab,2020-09-01,2243,96,2147,50,5
Asthma,Manali,Punjab,2020-10-01,3088,47,3041,120,4
Asthma,Manali,Punjab,2020-11-01,78,0,78,60,7
Asthma,Manali,Punjab,2020-12-01,78,0,78,200,2
Asthma,Manali,Punjab,2021-01-01,3062,96,2966,79,4
Asthma,Manali,Punjab,2021-02-01,3257,113,3144,92,5
Asthma,Manali,Punjab,2021-03-01,4989,186,4803,121,4
Asthma,Manali,Punjab,2021-04-01,2809,123,2686,29,7
Asthma,Manali,Punjab,2021-05-01,3697,0,3697,132,2
Asthma,Manali,Punjab,2021-06-01,2335,104,2231,124,6
Asthma,Manali,Punjab,2021-07-01,2996,305,2691,88,8
Asthma,Manali,Punjab,2021-08-01,4834,115,4719,120,2
Asthma,Manali,Punjab,2021-09-01,78,0,78,128,6
Asthma,Manali,Punjab,2021-10-01,3152,49,3103,179,6
Asthma,Manali,Punjab,2021-11-01,4989,338,4651,200,7
Asthma,Manali,Punjab,2021-12-01,2976,253,2723,52,5
Asthma,Manali,Punjab,2022-01-01,4812,406,4406,40,9
Asthma,Manali,Punjab,2022-02-01,1753,24,1729,111,10
Asthma,Manali,Punjab,2022-03-01,2554,165,2389,11,7
Asthma,Manali,Punjab,2022-04-01,2642,242,2400,139,6
Asthma,Manali,Punjab,2022-05-01,78,0,78,112,5
Asthma,Manali,Punjab,2022-06-01,1030,65,965,125,1
Asthma,Manali,Punjab,2022-07-01,1126,40,1086,91,1
Asthma,Manali,Punjab,2022-08-01,3700,208,3492,119,1
Asthma,Manali,Punjab,2022-09-01,3767,324,3443,130,6
Asthma,Manali,Punjab,2022-10-01,3032,180,2852,116,4
Asthma,Manali,Punjab,2022-11-01,3703,50,3653,38,9
Asthma,Manali,Punjab,2022-12-01,2377,87,2290,115,1
Asthma,Manali,Punjab,2023-01-01,4210,358,3852,200,5
Asthma,Manali,Punjab,2023-02-01,2609,155,2454,118,6
Asthma,Manali,Punjab,2023-03-01,2675,143,2532,113,7
Asthma,Manali,Punjab,2023-04-01,2241,76,2165,186,5
Asthma,Manali,Punjab,2023-05-01,3516,297,3219,68,6
Asthma,Manali,Punjab,2023-06-01,2032,200,1832,152,5
Asthma,Manali,Punjab,2023-07-01,3907,339,3568,79,6
Asthma,Manali,Punjab,2023-08-01,1079,99,980,162,5
Asthma,Manali,Punjab,2023-09-01,1123,44,1079,147,10
Asthma,Manali,Punjab,2023-10-01,3520,125,3395,85,6
Asthma,Manali,Punjab,2023-11-01,2479,112,2367,93,5
Asthma,Manali,Punjab,2023-12-01,1989,101,1888,156,3
Asthma,Manali,Punjab,2024-01-01,3791,347,3444,12,4
Asthma,Manali,Punjab,2024-02-01,1783,149,1634,84,9
Asthma,Manali,Punjab,2024-03-01,2329,153,2176,138,1
Asthma,Manali,Punjab,2024-04-01,4474,37,4437,91,5
Asthma,Manali,Punjab,2024-05-01,4662,4,4658,113,5
Asthma,Manali,Punjab,2024-06-01,4707,268,4439,11,6
Asthma,Manali,Punjab,2024-07-01,2219,167,2052,63,6
Asthma,Manali,Punjab,2024-08-01,4248,202,4046,141,9
Asthma,Manali,Punjab,2024-09-01,1324,140,1184,68,5
Asthma,Manali,Punjab,2024-10-01,1381,25,1356,40,5
Asthma,Manali,Punjab,2024-11-01,78,0,78,160,8
Asthma,Manali,Punjab,2024-12-01,4842,148,4694,132,9
Asthma,Manali,Punjab,2025-01-01,1438,42,1396,51,7
Asthma,Manali,Punjab,2025-02-01,2428,158,2270,113,8
Asthma,Manali,Punjab,2025-03-01,1376,52,1324,52,4
Asthma,Manali,Punjab,2025-04-01,3530,17,3513,98,5
Asthma,Manali,Punjab,2025-05-01,2093,159,1934,115,9
Asthma,Manali,Punjab,2025-06-01,847,0,847,65,6
Asthma,Manali,Punjab,2025-07-01,3190,60,3130,144,4
Asthma,Manali,Punjab,2025-08-01,674,1,673,152,5
Asthma,Manali,Punjab,2025-09-01,1474,82,1392,120,8
Asthma,Manali,Punjab,2025-10-01,78,0,78,127,8
Asthma,Manali,Punjab,2025-11-01,687,72,615,32,2
Asthma,Manali,Punjab,2025-12-01,2837,217,2620,176,6
Asthma,Manali,Chandigarh,2018-01-01,78,0,78,102,5
Asthma,Manali,Chandigarh,2018-02-01,610,35,575,59,5
Asthma,Manali,Chandigarh,2018-03-01,2594,56,2538,114,9
Asthma,Manali,Chandigarh,2018-04-01,1868,100,1768,144,4
Asthma,Manali,Chandigarh,2018-05-01,4989,335,4654,132,3
Asthma,Manali,Chandigarh,2018-06-01,4989,352,4637,51,2
Asthma,Manali,Chandigarh,2018-07-01,1433,52,1381,145,4
Asthma,Manali,Chandigarh,2018-08-01,3345,215,3130,103,3
Asthma,Manali,Chandigarh,2018-09-01,3603,82,3521,132,2
Asthma,Manali,Chandigarh,2018-10-01,1796,35,1761,65,2
Asthma,Manali,Chandigarh,2018-11-01,591,10,581,159,2
Asthma,Manali,Chandigarh,2018-12-01,2581,131,2450,116,3
Asthma,Manali,Chandigarh,2019-01-01,2366,37,2329,167,6
Asthma,Manali,Chandigarh,2019-02-01,2013,75,1938,28,1
Asthma,Manali,Chandigarh,2019-03-01,3191,243,2948,35,3
Asthma,Manali,Chandigarh,2019-04-01,1590,31,1559,94,5
Asthma,Manali,Chandigarh,2019-05-01,1052,37,1015,181,8
Asthma,Manali,Chandigarh,2019-06-01,2744,143,2601,200,4
Asthma,Manali,Chandigarh,2019-07-01,3115,178,2937,61,4
Asthma,Manali,Chandigarh,2019-08-01,1019,36,983,109,5
Asthma,Manali,Chandigarh,2019-09-01,3842,280,3562,114,1
Asthma,Manali,Chandigarh,2019-10-01,222,14,208,143,7
Asthma,Manali,Chandigarh,2019-11-01,1822,151,1671,151,7
Asthma,Manali,Chandigarh,2019-12-01,2251,107,2144,49,7
Asthma,Manali,Chandigarh,2020-01-01,1744,61,1683,110,10
Asthma,Manali,Chandigarh,2020-02-01,1839,55,1784,11,1
Asthma,Manali,Chandigarh,2020-03-01,4989,294,4695,148,1
Asthma,Manali,Chandigarh,2020-04-01,1456,56,1400,89,7
Asthma,Manali,Chandigarh,2020-05-01,4989,167,4822,45,4
Asthma,Manali,Chandigarh,2020-06-01,3184,117,3067,123,2
Asthma,Manali,Chandigarh,2020-07-01,2721,82,2639,87,4
Asthma,Manali,Chandigarh,2020-08-01,3236,180,3056,170,3
Asthma,Manali,Chandigarh,2020-09-01,4989,44,4945,61,10
Asthma,Manali,Chandigarh,2020-10-01,1264,74,1190,200,10
Asthma,Manali,Chandigarh,2020-11-01,1094,76,1018,150,1
Asthma,Manali,Chandigarh,2020-12-01,1585,52,1533,172,1
Asthma,Manali,Chandigarh,2021-01-01,2641,279,2362,54,3
Asthma,Manali,Chandigarh,2021-02-01,282,14,268,197,3
Asthma,Manali,Chandigarh,2021-03-01,2627,12,2615,44,3
Asthma,Manali,Chandigarh,2021-04-01,4869,203,4666,96,4
Asthma,Manali,Chandigarh,2021-05-01,2801,145,2656,173,4
Asthma,Manali,Chandigarh,2021-06-01,2205,139,2066,132,1
Asthma,Manali,Chandigarh,2021-07-01,1768,75,1693,43,2
Asthma,Manali,Chandigarh,2021-08-01,3803,78,3725,164,9
Asthma,Manali,Chandigarh,2021-09-01,1490,27,1463,124,4
Asthma,Manali,Chandigarh,2021-10-01,4989,154,4835,85,4
Asthma,Manali,Chandigarh,2021-11-01,4989,168,4821,28,1
Asthma,Manali,Chandigarh,2021-12-01,2942,50,2892,128,3
Asthma,Manali,Chandigarh,2022-01-01,2582,74,2508,98,8
Asthma,Manali,Chandigarh,2022-02-01,3980,275,3705,114,7
Asthma,Manali,Chandigarh,2022-03-01,4066,398,3668,25,7
Asthma,Manali,Chandigarh,2022-04-01,1516,109,1407,85,1
Asthma,Manali,Chandigarh,2022-05-01,1891,166,1725,131,1
Asthma,Manali,Chandigarh,2022-06-01,823,64,759,200,8
Asthma,Manali,Chandigarh,2022-07-01,3146,233,2913,96,7
Asthma,Manali,Chandigarh,2022-08-01,3492,140,3352,180,4
Asthma,Manali,Chandigarh,2022-09-01,786,42,744,146,7
Asthma,Manali,Chandigarh,2022-10-01,1987,75,1912,118,1
Asthma,Manali,Chandigarh,2022-11-01,790,34,756,55,1
Asthma,Manali,Chandigarh,2022-12-01,1392,72,1320,57,1
Asthma,Manali,Chandigarh,2023-01-01,3337,236,3101,138,6
Asthma,Manali,Chandigarh,2023-02-01,1613,100,1513,79,5
Asthma,Manali,Chandigarh,2023-03-01,2194,99,2095,75,3
Asthma,Manali,Chandigarh,2023-04-01,414,21,393,97,3
Asthma,Manali,Chandigarh,2023-05-01,2848,178,2670,98,10
Asthma,Manali,Chandigarh,2023-06-01,2538,176,2362,152,4
Asthma,Manali,Chandigarh,2023-07-01,1620,9,1611,80,9
Asthma,Manali,Chandigarh,2023-08-01,2344,43,2301,147,4
Asthma,Manali,Chandigarh,2023-09-01,2839,233,2606,129,3
Asthma,Manali,Chandigarh,2023-10-01,1504,72,1432,21,9
Asthma,Manali,Chandigarh,2023-11-01,617,23,594,121,7
Asthma,Manali,Chandigarh,2023-12-01,4989,211,4778,11,5
Asthma,Manali,Chandigarh,2024-01-01,1748,74,1674,61,8
Asthma,Manali,Chandigarh,2024-02-01,2468,163,2305,130,10
Asthma,Manali,Chandigarh,2024-03-01,3953,70,3883,106,3
Asthma,Manali,Chandigarh,2024-04-01,4989,253,4736,16,6
Asthma,Manali,Chandigarh,2024-05-01,928,53,875,49,4
Asthma,Manali,Chandigarh,2024-06-01,3201,197,3004,11,2
Asthma,Manali,Chandigarh,2024-07-01,1648,93,1555,38,2
Asthma,Manali,Chandigarh,2024-08-01,1875,122,1753,136,9
Asthma,Manali,Chandigarh,2024-09-01,1631,54,1577,78,1
Asthma,Manali,Chandigarh,2024-10-01,1087,24,1063,115,6
Asthma,Manali,Chandigarh,2024-11-01,2542,309,2233,107,2
Asthma,Manali,Chandigarh,2024-12-01,619,25,594,108,10
Asthma,Manali,Chandigarh,2025-01-01,3868,172,3696,158,4
Asthma,Manali,Chandigarh,2025-02-01,2671,186,2485,96,4
Asthma,Manali,Chandigarh,2025-03-01,3164,305,2859,153,9
Asthma,Manali,Chandigarh,2025-04-01,1972,67,1905,11,7
Asthma,Manali,Chandigarh,2025-05-01,2105,44,2061,163,6
Asthma,Manali,Chandigarh,2025-06-01,2983,41,2942,40,7
Asthma,Manali,Chandigarh,2025-07-01,1036,99,937,52,2
Asthma,Manali,Chandigarh,2025-08-01,2117,42,2075,70,7
Asthma,Manali,Chandigarh,2025-09-01,1444,71,1373,161,4
Asthma,Manali,Chandigarh,2025-10-01,1403,30,1373,61,6
Asthma,Manali,Chandigarh,2025-11-01,78,0,78,73,6
Asthma,Manali,Chandigarh,2025-12-01,4394,182,4212,57,2
Asthma,Manali,Himachal Pradesh,2018-01-01,1676,38,1638,119,7
Asthma,Manali,Himachal Pradesh,2018-02-01,4158,124,4034,144,4
Asthma,Manali,Himachal Pradesh,2018-03-01,4031,437,3594,193,1
Asthma,Manali,Himachal Pradesh,2018-04-01,872,54,818,200,4
Asthma,Manali,Himachal Pradesh,2018-05-01,1137,87,1050,139,5
Asthma,Manali,Himachal Pradesh,2018-06-01,4989,369,4620,125,7
Asthma,Manali,Himachal Pradesh,2018-07-01,4946,233,4713,44,1
Asthma,Manali,Himachal Pradesh,2018-08-01,2555,95,2460,200,6
Asthma,Manali,Himachal Pradesh,2018-09-01,2943,168,2775,117,3
Asthma,Manali,Himachal Pradesh,2018-10-01,1751,96,1655,91,7
Asthma,Manali,Himachal Pradesh,2018-11-01,3177,106,3071,126,5
Asthma,Manali,Himachal Pradesh,2018-12-01,1635,88,1547,74,4
Asthma,Manali,Himachal Pradesh,2019-01-01,78,0,78,11,4
Asthma,Manali,Himachal Pradesh,2019-02-01,825,37,788,135,6
Asthma,Manali,Himachal Pradesh,2019-03-01,2626,105,2521,175,7
Asthma,Manali,Himachal Pradesh,2019-04-01,1080,14,1066,135,2
Asthma,Manali,Himachal Pradesh,2019-05-01,2507,0,2507,106,4
Asthma,Manali,Himachal Pradesh,2019-06-01,1156,26,1130,107,9
Asthma,Manali,Himachal Pradesh,2019-07-01,1548,158,1390,115,4
Asthma,Manali,Himachal Pradesh,2019-08-01,3742,153,3589,113,6
Asthma,Manali,Himachal Pradesh,2019-09-01,2929,212,2717,103,1
Asthma,Manali,Himachal Pradesh,2019-10-01,2584,0,2584,108,1
Asthma,Manali,Himachal Pradesh,2019-11-01,3777,78,3699,185,2
Asthma,Manali,Himachal Pradesh,2019-12-01,3242,34,3208,130,3
Asthma,Manali,Himachal Pradesh,2020-01-01,4538,200,4338,112,8
Asthma,Manali,Himachal Pradesh,2020-02-01,1981,238,1743,140,8
Asthma,Manali,Himachal Pradesh,2020-03-01,2021,128,1893,140,1
Asthma,Manali,Himachal Pradesh,2020-04-01,852,84,768,154,3
Asthma,Manali,Himachal Pradesh,2020-05-01,2022,86,1936,68,7
Asthma,Manali,Himachal Pradesh,2020-06-01,3892,349,3543,82,5
Asthma,Manali,Himachal Pradesh,2020-07-01,4341,442,3899,65,9
Asthma,Manali,Himachal Pradesh,2020-08-01,3886,182,3704,145,7
Asthma,Manali,Himachal Pradesh,2020-09-01,190,6,184,143,4
Asthma,Manali,Himachal Pradesh,2020-10-01,4050,47,4003,41,4
Asthma,Manali,Himachal Pradesh,2020-11-01,131,5,126,126,5
Asthma,Manali,Himachal Pradesh,2020-12-01,3802,199,3603,176,2
Asthma,Manali,Himachal Pradesh,2021-01-01,2104,229,1875,94,8
Asthma,Manali,Himachal Pradesh,2021-02-01,3540,43,3497,122,7
Asthma,Manali,Himachal Pradesh,2021-03-01,810,41,769,143,6
Asthma,Manali,Himachal Pradesh,2021-04-01,4169,0,4169,39,6
Asthma,Manali,Himachal Pradesh,2021-05-01,632,23,609,114,2
Asthma,Manali,Himachal Pradesh,2021-06-01,1701,100,1601,171,6
Asthma,Manali,Himachal Pradesh,2021-07-01,1258,81,1177,76,5
Asthma,Manali,Himachal Pradesh,2021-08-01,244,16,228,149,10
Asthma,Manali,Himachal Pradesh,2021-09-01,2724,167,2557,108,1
Asthma,Manali,Himachal Pradesh,2021-10-01,4989,334,4655,72,3
Asthma,Manali,Himachal Pradesh,2021-11-01,4989,256,4733,101,1
Asthma,Manali,Himachal Pradesh,2021-12-01,2728,53,2675,79,4
Asthma,Manali,Himachal Pradesh,2022-01-01,4095,0,4095,61,1
Asthma,Manali,Himachal Pradesh,2022-02-01,2909,99,2810,93,8
Asthma,Manali,Himachal Pradesh,2022-03-01,3267,150,3117,110,8
Asthma,Manali,Himachal Pradesh,2022-04-01,2138,185,1953,98,4
Asthma,Manali,Himachal Pradesh,2022-05-01,2859,134,2725,93,2
Asthma,Manali,Himachal Pradesh,2022-06-01,3318,147,3171,118,1
Asthma,Manali,Himachal Pradesh,2022-07-01,1821,111,1710,133,3
Asthma,Manali,Himachal Pradesh,2022-08-01,2493,105,2388,48,7
Asthma,Manali,Himachal Pradesh,2022-09-01,2519,185,2334,93,3
Asthma,Manali,Himachal Pradesh,2022-10-01,3706,399,3307,11,10
Asthma,Manali,Himachal Pradesh,2022-11-01,1167,132,1035,98,9
Asthma,Manali,Himachal Pradesh,2022-12-01,2528,133,2395,114,5
Asthma,Manali,Himachal Pradesh,2023-01-01,4989,298,4691,135,3
Asthma,Manali,Himachal Pradesh,2023-02-01,4159,399,3760,114,3
Asthma,Manali,Himachal Pradesh,2023-03-01,4407,201,4206,134,9
Asthma,Manali,Himachal Pradesh,2023-04-01,2630,183,2447,110,3
Asthma,Manali,Himachal Pradesh,2023-05-01,3028,51,2977,72,8
Asthma,Manali,Himachal Pradesh,2023-06-01,3942,161,3781,49,5
Asthma,Manali,Himachal Pradesh,2023-07-01,4690,392,4298,93,7
Asthma,Manali,Himachal Pradesh,2023-08-01,78,0,78,67,2
Asthma,Manali,Himachal Pradesh,2023-09-01,833,38,795,100,4
Asthma,Manali,Himachal Pradesh,2023-10-01,4354,18,4336,81,5
Asthma,Manali,Himachal Pradesh,2023-11-01,2226,241,1985,128,3
Asthma,Manali,Himachal Pradesh,2023-12-01,1696,147,1549,109,8
Asthma,Manali,Himachal Pradesh,2024-01-01,915,50,865,129,3
Asthma,Manali,Himachal Pradesh,2024-02-01,1853,120,1733,129,3
Asthma,Manali,Himachal Pradesh,2024-03-01,716,44,672,97,9
Asthma,Manali,Himachal Pradesh,2024-04-01,4989,442,4547,100,8
Asthma,Manali,Himachal Pradesh,2024-05-01,2567,89,2478,132,9
Asthma,Manali,Himachal Pradesh,2024-06-01,2520,179,2341,200,1
Asthma,Manali,Himachal Pradesh,2024-07-01,3386,275,3111,56,5
Asthma,Manali,Himachal Pradesh,2024-08-01,3888,332,3556,108,5
Asthma,Manali,Himachal Pradesh,2024-09-01,3866,0,3866,45,3
Asthma,Manali,Himachal Pradesh,2024-10-01,4038,131,3907,105,6
Asthma,Manali,Himachal Pradesh,2024-11-01,1751,35,1716,72,4
Asthma,Manali,Himachal Pradesh,2024-12-01,2198,119,2079,100,5
Asthma,Manali,Himachal Pradesh,2025-01-01,3629,0,3629,114,10
Asthma,Manali,Himachal Pradesh,2025-02-01,1890,0,1890,81,6
Asthma,Manali,Himachal Pradesh,2025-03-01,2591,293,2298,15,6
Asthma,Manali,Himachal Pradesh,2025-04-01,3132,213,2919,179,7
Asthma,Manali,Himachal Pradesh,2025-05-01,3651,195,3456,149,5
Asthma,Manali,Himachal Pradesh,2025-06-01,213,12,201,100,2
Asthma,Manali,Himachal Pradesh,2025-07-01,3556,193,3363,61,1
Asthma,Manali,Himachal Pradesh,2025-08-01,2284,180,2104,111,5
Asthma,Manali,Himachal Pradesh,2025-09-01,3546,112,3434,125,4
Asthma,Manali,Himachal Pradesh,2025-10-01,3640,202,3438,145,1
Asthma,Manali,Himachal Pradesh,2025-11-01,4754,269,4485,150,10
Asthma,Manali,Himachal Pradesh,2025-12-01,4413,86,4327,160,5
Asthma,Manali,Jammu & Kashmir,2018-01-01,4404,384,4020,18,9
Asthma,Manali,Jammu & Kashmir,2018-02-01,4534,168,4366,91,1
Asthma,Manali,Jammu & Kashmir,2018-03-01,2988,238,2750,157,9
Asthma,Manali,Jammu & Kashmir,2018-04-01,2641,141,2500,59,3
Asthma,Manali,Jammu & Kashmir,2018-05-01,3768,367,3401,168,8
Asthma,Manali,Jammu & Kashmir,2018-06-01,3579,70,3509,198,5
Asthma,Manali,Jammu & Kashmir,2018-07-01,2183,40,2143,167,6
Asthma,Manali,Jammu & Kashmir,2018-08-01,3140,74,3066,140,6
Asthma,Manali,Jammu & Kashmir,2018-09-01,2550,137,2413,83,4
Asthma,Manali,Jammu & Kashmir,2018-10-01,1452,137,1315,121,3
Asthma,Manali,Jammu & Kashmir,2018-11-01,4329,417,3912,38,4
Asthma,Manali,Jammu & Kashmir,2018-12-01,2671,0,2671,66,1
Asthma,Manali,Jammu & Kashmir,2019-01-01,4989,286,4703,70,3
Asthma,Manali,Jammu & Kashmir,2019-02-01,417,0,417,109,3
Asthma,Manali,Jammu & Kashmir,2019-03-01,1850,135,1715,86,1
Asthma,Manali,Jammu & Kashmir,2019-04-01,2641,218,2423,120,6
Asthma,Manali,Jammu & Kashmir,2019-05-01,4123,201,3922,151,5
Asthma,Manali,Jammu & Kashmir,2019-06-01,3133,164,2969,70,6
Asthma,Manali,Jammu & Kashmir,2019-07-01,3014,157,2857,114,7
Asthma,Manali,Jammu & Kashmir,2019-08-01,1085,29,1056,85,4
Asthma,Manali,Jammu & Kashmir,2019-09-01,1045,65,980,116,2
Asthma,Manali,Jammu & Kashmir,2019-10-01,3030,131,2899,141,6
Asthma,Manali,Jammu & Kashmir,2019-11-01,767,59,708,153,1
Asthma,Manali,Jammu & Kashmir,2019-12-01,1884,88,1796,140,5
Asthma,Manali,Jammu & Kashmir,2020-01-01,3269,81,3188,127,7
Asthma,Manali,Jammu & Kashmir,2020-02-01,1280,6,1274,34,8
Asthma,Manali,Jammu & Kashmir,2020-03-01,4751,0,4751,51,3
Asthma,Manali,Jammu & Kashmir,2020-04-01,4239,374,3865,64,1
Asthma,Manali,Jammu & Kashmir,2020-05-01,489,17,472,124,1
Asthma,Manali,Jammu & Kashmir,2020-06-01,1347,80,1267,40,7
Asthma,Manali,Jammu & Kashmir,2020-07-01,78,0,78,123,4
Asthma,Manali,Jammu & Kashmir,2020-08-01,1548,52,1496,120,10
Asthma,Manali,Jammu & Kashmir,2020-09-01,3626,115,3511,11,1
Asthma,Manali,Jammu & Kashmir,2020-10-01,2042,94,1948,51,6
Asthma,Manali,Jammu & Kashmir,2020-11-01,3216,163,3053,159,10
Asthma,Manali,Jammu & Kashmir,2020-12-01,555,58,497,142,5
Asthma,Manali,Jammu & Kashmir,2021-01-01,3668,350,3318,63,1
Asthma,Manali,Jammu & Kashmir,2021-02-01,1853,126,1727,53,10
Asthma,Manali,Jammu & Kashmir,2021-03-01,2614,241,2373,11,9
Asthma,Manali,Jammu & Kashmir,2021-04-01,2473,110,2363,181,4
Asthma,Manali,Jammu & Kashmir,2021-05-01,892,52,840,108,7
Asthma,Manali,Jammu & Kashmir,2021-06-01,1051,43,1008,200,7
Asthma,Manali,Jammu & Kashmir,2021-07-01,3896,48,3848,96,7
Asthma,Manali,Jammu & Kashmir,2021-08-01,3133,266,2867,121,1
Asthma,Manali,Jammu & Kashmir,2021-09-01,4006,262,3744,152,6
Asthma,Manali,Jammu & Kashmir,2021-10-01,3033,153,2880,190,9
Asthma,Manali,Jammu & Kashmir,2021-11-01,2789,139,2650,132,6
Asthma,Manali,Jammu & Kashmir,2021-12-01,282,1,281,106,6
Asthma,Manali,Jammu & Kashmir,2022-01-01,2235,48,2187,108,3
Asthma,Manali,Jammu & Kashmir,2022-02-01,2561,153,2408,53,2
Asthma,Manali,Jammu & Kashmir,2022-03-01,4989,172,4817,87,1
Asthma,Manali,Jammu & Kashmir,2022-04-01,3519,153,3366,109,7
Asthma,Manali,Jammu & Kashmir,2022-05-01,4658,219,4439,177,4
Asthma,Manali,Jammu & Kashmir,2022-06-01,3399,102,3297,84,1
Asthma,Manali,Jammu & Kashmir,2022-07-01,1643,35,1608,160,8
Asthma,Manali,Jammu & Kashmir,2022-08-01,2755,8,2747,102,3
Asthma,Manali,Jammu & Kashmir,2022-09-01,2914,133,2781,170,2
Asthma,Manali,Jammu & Kashmir,2022-10-01,1338,91,1247,141,3
Asthma,Manali,Jammu & Kashmir,2022-11-01,2082,4,2078,137,4
Asthma,Manali,Jammu & Kashmir,2022-12-01,2321,114,2207,156,6
Asthma,Manali,Jammu & Kashmir,2023-01-01,4751,276,4475,149,2
Asthma,Manali,Jammu & Kashmir,2023-02-01,78,0,78,160,8
Asthma,Manali,Jammu & Kashmir,2023-03-01,4215,385,3830,200,6
Asthma,Manali,Jammu & Kashmir,2023-04-01,1341,52,1289,189,3
Asthma,Manali,Jammu & Kashmir,2023-05-01,757,35,722,130,4
Asthma,Manali,Jammu & Kashmir,2023-06-01,4180,189,3991,84,4
Asthma,Manali,Jammu & Kashmir,2023-07-01,3579,0,3579,125,5
Asthma,Manali,Jammu & Kashmir,2023-08-01,4280,339,3941,11,9
Asthma,Manali,Jammu & Kashmir,2023-09-01,3672,81,3591,148,4
Asthma,Manali,Jammu & Kashmir,2023-10-01,4989,215,4774,52,5
Asthma,Manali,Jammu & Kashmir,2023-11-01,3347,225,3122,163,3
Asthma,Manali,Jammu & Kashmir,2023-12-01,2387,221,2166,200,6
Asthma,Manali,Jammu & Kashmir,2024-01-01,3057,56,3001,32,6
Asthma,Manali,Jammu & Kashmir,2024-02-01,4266,158,4108,104,9
Asthma,Manali,Jammu & Kashmir,2024-03-01,1552,140,1412,52,2
Asthma,Manali,Jammu & Kashmir,2024-04-01,1723,109,1614,18,7
Asthma,Manali,Jammu & Kashmir,2024-05-01,2183,151,2032,101,8
Asthma,Manali,Jammu & Kashmir,2024-06-01,78,0,78,139,4
Asthma,Manali,Jammu & Kashmir,2024-07-01,2783,108,2675,145,4
Asthma,Manali,Jammu & Kashmir,2024-08-01,78,0,78,114,5
Asthma,Manali,Jammu & Kashmir,2024-09-01,2669,66,2603,21,4
Asthma,Manali,Jammu & Kashmir,2024-10-01,3758,5,3753,112,5
Asthma,Manali,Jammu & Kashmir,2024-11-01,1958,68,1890,30,7
Asthma,Manali,Jammu & Kashmir,2024-12-01,4847,433,4414,34,4
Asthma,Manali,Jammu & Kashmir,2025-01-01,638,33,605,55,4
Asthma,Manali,Jammu & Kashmir,2025-02-01,4195,377,3818,160,6
Asthma,Manali,Jammu & Kashmir,2025-03-01,3503,193,3310,134,4
Asthma,Manali,Jammu & Kashmir,2025-04-01,295,8,287,123,4
Asthma,Manali,Jammu & Kashmir,2025-05-01,4989,435,4554,62,2
Asthma,Manali,Jammu & Kashmir,2025-06-01,2512,141,2371,86,5
Asthma,Manali,Jammu & Kashmir,2025-07-01,1420,110,1310,36,6
Asthma,Manali,Jammu & Kashmir,2025-08-01,710,13,697,176,4
Asthma,Manali,Jammu & Kashmir,2025-09-01,2302,184,2118,200,3
Asthma,Manali,Jammu & Kashmir,2025-10-01,2426,196,2230,135,5
Asthma,Manali,Jammu & Kashmir,2025-11-01,2735,160,2575,143,6
Asthma,Manali,Jammu & Kashmir,2025-12-01,2198,58,2140,98,5
Asthma,Manali,Haryana,2018-01-01,3447,167,3280,24,10
Asthma,Manali,Haryana,2018-02-01,2077,140,1937,63,3
Asthma,Manali,Haryana,2018-03-01,78,0,78,83,4
Asthma,Manali,Haryana,2018-04-01,2397,161,2236,87,7
Asthma,Manali,Haryana,2018-05-01,78,0,78,75,3
Asthma,Manali,Haryana,2018-06-01,3072,95,2977,109,10
Asthma,Manali,Haryana,2018-07-01,1284,21,1263,63,5
Asthma,Manali,Haryana,2018-08-01,2817,137,2680,200,6
Asthma,Manali,Haryana,2018-09-01,4360,176,4184,37,5
Asthma,Manali,Haryana,2018-10-01,1325,96,1229,151,8
Asthma,Manali,Haryana,2018-11-01,4021,75,3946,93,2
Asthma,Manali,Haryana,2018-12-01,2016,160,1856,130,9
Asthma,Manali,Haryana,2019-01-01,4949,442,4507,132,5
Asthma,Manali,Haryana,2019-02-01,2108,105,2003,114,7
Asthma,Manali,Haryana,2019-03-01,1470,76,1394,48,3
Asthma,Manali,Haryana,2019-04-01,3519,97,3422,89,6
Asthma,Manali,Haryana,2019-05-01,2013,69,1944,115,2
Asthma,Manali,Haryana,2019-06-01,1469,56,1413,112,8
Asthma,Manali,Haryana,2019-07-01,1956,180,1776,54,1
Asthma,Manali,Haryana,2019-08-01,2538,121,2417,172,5
Asthma,Manali,Haryana,2019-09-01,4398,50,4348,11,4
Asthma,Manali,Haryana,2019-10-01,78,0,78,93,1
Asthma,Manali,Haryana,2019-11-01,2628,194,2434,59,2
Asthma,Manali,Haryana,2019-12-01,3436,169,3267,115,6
Asthma,Manali,Haryana,2020-01-01,2857,265,2592,158,2
Asthma,Manali,Haryana,2020-02-01,4355,316,4039,35,3
Asthma,Manali,Haryana,2020-03-01,2498,48,2450,200,6
Asthma,Manali,Haryana,2020-04-01,2350,79,2271,116,7
Asthma,Manali,Haryana,2020-05-01,3392,192,3200,126,7
Asthma,Manali,Haryana,2020-06-01,2731,4,2727,33,5
Asthma,Manali,Haryana,2020-07-01,2074,124,1950,104,5
Asthma,Manali,Haryana,2020-08-01,3290,0,3290,156,5
Asthma,Manali,Haryana,2020-09-01,1722,137,1585,117,2
Asthma,Manali,Haryana,2020-10-01,1778,135,1643,113,6
Asthma,Manali,Haryana,2020-11-01,1889,122,1767,104,2
Asthma,Manali,Haryana,2020-12-01,4413,134,4279,36,7
Asthma,Manali,Haryana,2021-01-01,78,0,78,36,5
Asthma,Manali,Haryana,2021-02-01,3128,109,3019,166,1
Asthma,Manali,Haryana,2021-03-01,2643,53,2590,151,8
Asthma,Manali,Haryana,2021-04-01,343,13,330,159,3
Asthma,Manali,Haryana,2021-05-01,3013,212,2801,64,3
Asthma,Manali,Haryana,2021-06-01,3236,166,3070,98,8
Asthma,Manali,Haryana,2021-07-01,3388,312,3076,169,4
Asthma,Manali,Haryana,2021-08-01,78,0,78,44,7
Asthma,Manali,Haryana,2021-09-01,4430,306,4124,164,3
Asthma,Manali,Haryana,2021-10-01,1608,5,1603,76,7
Asthma,Manali,Haryana,2021-11-01,3518,146,3372,63,5
Asthma,Manali,Haryana,2021-12-01,3592,68,3524,105,6
Asthma,Manali,Haryana,2022-01-01,1421,63,1358,49,4
Asthma,Manali,Haryana,2022-02-01,3483,104,3379,11,10
Asthma,Manali,Haryana,2022-03-01,2080,81,1999,110,10
Asthma,Manali,Haryana,2022-04-01,78,0,78,133,1
Asthma,Manali,Haryana,2022-05-01,4164,266,3898,168,8
Asthma,Manali,Haryana,2022-06-01,1558,123,1435,137,2
Asthma,Manali,Haryana,2022-07-01,1451,5,1446,200,6
Asthma,Manali,Haryana,2022-08-01,2057,106,1951,176,1
Asthma,Manali,Haryana,2022-09-01,2963,231,2732,144,6
Asthma,Manali,Haryana,2022-10-01,2521,236,2285,130,2
Asthma,Manali,Haryana,2022-11-01,3333,16,3317,169,3
Asthma,Manali,Haryana,2022-12-01,800,31,769,11,4
Asthma,Manali,Haryana,2023-01-01,1601,128,1473,82,3
Asthma,Manali,Haryana,2023-02-01,2442,108,2334,12,3
Asthma,Manali,Haryana,2023-03-01,4989,117,4872,140,4
Asthma,Manali,Haryana,2023-04-01,2445,12,2433,68,4
Asthma,Manali,Haryana,2023-05-01,4053,91,3962,200,6
Asthma,Manali,Haryana,2023-06-01,2649,2,2647,80,10
Asthma,Manali,Haryana,2023-07-01,1949,100,1849,112,2
Asthma,Manali,Haryana,2023-08-01,2266,172,2094,86,5
Asthma,Manali,Haryana,2023-09-01,2371,31,2340,81,7
Asthma,Manali,Haryana,2023-10-01,3407,196,3211,43,3
Asthma,Manali,Haryana,2023-11-01,4441,331,4110,41,1
Asthma,Manali,Haryana,2023-12-01,3080,153,2927,11,1
Asthma,Manali,Haryana,2024-01-01,4190,13,4177,134,1
Asthma,Manali,Haryana,2024-02-01,1303,79,1224,85,9
Asthma,Manali,Haryana,2024-03-01,2041,98,1943,200,7
Asthma,Manali,Haryana,2024-04-01,1626,74,1552,43,7
Asthma,Manali,Haryana,2024-05-01,3019,103,2916,181,8
Asthma,Manali,Haryana,2024-06-01,2116,111,2005,186,3
Asthma,Manali,Haryana,2024-07-01,3576,232,3344,171,10
Asthma,Manali,Haryana,2024-08-01,1348,161,1187,118,6
Asthma,Manali,Haryana,2024-09-01,2655,141,2514,89,5
Asthma,Manali,Haryana,2024-10-01,3519,330,3189,171,8
Asthma,Manali,Haryana,2024-11-01,78,0,78,66,7
Asthma,Manali,Haryana,2024-12-01,4989,235,4754,120,9
Asthma,Manali,Haryana,2025-01-01,2218,120,2098,104,9
Asthma,Manali,Haryana,2025-02-01,78,0,78,61,4
Asthma,Manali,Haryana,2025-03-01,2809,165,2644,120,5
Asthma,Manali,Haryana,2025-04-01,2642,0,2642,144,2
Asthma,Manali,Haryana,2025-05-01,2488,62,2426,59,1
Asthma,Manali,Haryana,2025-06-01,3927,209,3718,130,7
Asthma,Manali,Haryana,2025-07-01,3600,305,3295,11,8
Asthma,Manali,Haryana,2025-08-01,2997,274,2723,53,1
Asthma,Manali,Haryana,2025-09-01,3201,138,3063,83,3
Asthma,Manali,Haryana,2025-10-01,2457,134,2323,124,5
Asthma,Manali,Haryana,2025-11-01,4979,391,4588,150,5
Asthma,Manali,Haryana,2025-12-01,613,6,607,110,10
Asthma,Jammu,Punjab,2018-01-01,2785,172,2613,135,3
Asthma,Jammu,Punjab,2018-02-01,2685,69,2616,98,4
Asthma,Jammu,Punjab,2018-03-01,3688,166,3522,127,7
Asthma,Jammu,Punjab,2018-04-01,1465,53,1412,124,4
Asthma,Jammu,Punjab,2018-05-01,258,16,242,80,3
Asthma,Jammu,Punjab,2018-06-01,2808,185,2623,88,3
Asthma,Jammu,Punjab,2018-07-01,2975,226,2749,137,5
Asthma,Jammu,Punjab,2018-08-01,4596,276,4320,199,4
Asthma,Jammu,Punjab,2018-09-01,893,49,844,168,7
Asthma,Jammu,Punjab,2018-10-01,4146,431,3715,49,6
Asthma,Jammu,Punjab,2018-11-01,4989,28,4961,49,1
Asthma,Jammu,Punjab,2018-12-01,2091,207,1884,79,1
Asthma,Jammu,Punjab,2019-01-01,866,36,830,111,3
Asthma,Jammu,Punjab,2019-02-01,2051,136,1915,109,8
Asthma,Jammu,Punjab,2019-03-01,2616,106,2510,169,3
Asthma,Jammu,Punjab,2019-04-01,3354,99,3255,172,6
Asthma,Jammu,Punjab,2019-05-01,1804,115,1689,106,7
Asthma,Jammu,Punjab,2019-06-01,4684,376,4308,95,6
Asthma,Jammu,Punjab,2019-07-01,1102,70,1032,133,3
Asthma,Jammu,Punjab,2019-08-01,264,9,255,160,1
Asthma,Jammu,Punjab,2019-09-01,4082,442,3640,134,1
Asthma,Jammu,Punjab,2019-10-01,78,0,78,84,10
Asthma,Jammu,Punjab,2019-11-01,2324,179,2145,75,6
Asthma,Jammu,Punjab,2019-12-01,4989,198,4791,50,10
Asthma,Jammu,Punjab,2020-01-01,2581,82,2499,116,2
Asthma,Jammu,Punjab,2020-02-01,1094,45,1049,138,8
Asthma,Jammu,Punjab,2020-03-01,2520,205,2315,144,3
Asthma,Jammu,Punjab,2020-04-01,2529,53,2476,165,5
Asthma,Jammu,Punjab,2020-05-01,2813,53,2760,182,4
Asthma,Jammu,Punjab,2020-06-01,3486,229,3257,36,2
Asthma,Jammu,Punjab,2020-07-01,1203,71,1132,127,2
Asthma,Jammu,Punjab,2020-08-01,4861,134,4727,129,5
Asthma,Jammu,Punjab,2020-09-01,2926,53,2873,102,3
Asthma,Jammu,Punjab,2020-10-01,3572,328,3244,64,5
Asthma,Jammu,Punjab,2020-11-01,1755,106,1649,180,2
Asthma,Jammu,Punjab,2020-12-01,4323,44,4279,76,7
Asthma,Jammu,Punjab,2021-01-01,2253,27,2226,11,3
Asthma,Jammu,Punjab,2021-02-01,2970,117,2853,107,10
Asthma,Jammu,Punjab,2021-03-01,1346,96,1250,94,5
Asthma,Jammu,Punjab,2021-04-01,1260,84,1176,200,5
Asthma,Jammu,Punjab,2021-05-01,3521,292,3229,131,9
Asthma,Jammu,Punjab,2021-06-01,2002,13,1989,91,3
Asthma,Jammu,Punjab,2021-07-01,1452,82,1370,96,4
Asthma,Jammu,Punjab,2021-08-01,1735,158,1577,96,3
Asthma,Jammu,Punjab,2021-09-01,3535,314,3221,200,5
Asthma,Jammu,Punjab,2021-10-01,1754,106,1648,141,3
Asthma,Jammu,Punjab,2021-11-01,2440,288,2152,35,7
Asthma,Jammu,Punjab,2021-12-01,2618,177,2441,94,5
Asthma,Jammu,Punjab,2022-01-01,78,0,78,105,7
Asthma,Jammu,Punjab,2022-02-01,624,32,592,50,7
Asthma,Jammu,Punjab,2022-03-01,3049,83,2966,15,3
Asthma,Jammu,Punjab,2022-04-01,1609,39,1570,137,3
Asthma,Jammu,Punjab,2022-05-01,4015,222,3793,65,4
Asthma,Jammu,Punjab,2022-06-01,3894,171,3723,170,5
Asthma,Jammu,Punjab,2022-07-01,3562,0,3562,107,6
Asthma,Jammu,Punjab,2022-08-01,4989,100,4889,82,6
Asthma,Jammu,Punjab,2022-09-01,2486,101,2385,11,5
Asthma,Jammu,Punjab,2022-10-01,3468,247,3221,168,3
Asthma,Jammu,Punjab,2022-11-01,1813,89,1724,121,3
Asthma,Jammu,Punjab,2022-12-01,4989,239,4750,83,6
Asthma,Jammu,Punjab,2023-01-01,4989,106,4883,61,3
Asthma,Jammu,Punjab,2023-02-01,2613,132,2481,188,6
Asthma,Jammu,Punjab,2023-03-01,3116,275,2841,52,7
Asthma,Jammu,Punjab,2023-04-01,4421,241,4180,87,9
Asthma,Jammu,Punjab,2023-05-01,2400,14,2386,135,3
Asthma,Jammu,Punjab,2023-06-01,1717,23,1694,180,4
Asthma,Jammu,Punjab,2023-07-01,3770,253,3517,95,1
Asthma,Jammu,Punjab,2023-08-01,2703,117,2586,69,2
Asthma,Jammu,Punjab,2023-09-01,2843,136,2707,101,2
Asthma,Jammu,Punjab,2023-10-01,1478,47,1431,152,6
Asthma,Jammu,Punjab,2023-11-01,293,18,275,164,10
Asthma,Jammu,Punjab,2023-12-01,2914,120,2794,36,7
Asthma,Jammu,Punjab,2024-01-01,3811,170,3641,112,8
Asthma,Jammu,Punjab,2024-02-01,2294,58,2236,33,3
Asthma,Jammu,Punjab,2024-03-01,4524,347,4177,151,1
Asthma,Jammu,Punjab,2024-04-01,1653,72,1581,128,4
Asthma,Jammu,Punjab,2024-05-01,1183,80,1103,59,3
Asthma,Jammu,Punjab,2024-06-01,2507,38,2469,184,2
Asthma,Jammu,Punjab,2024-07-01,2487,250,2237,123,5
Asthma,Jammu,Punjab,2024-08-01,3630,316,3314,118,1
Asthma,Jammu,Punjab,2024-09-01,1558,0,1558,97,7
Asthma,Jammu,Punjab,2024-10-01,4433,118,4315,106,4
Asthma,Jammu,Punjab,2024-11-01,4989,319,4670,87,5
Asthma,Jammu,Punjab,2024-12-01,2545,29,2516,68,5
Asthma,Jammu,Punjab,2025-01-01,4274,197,4077,169,3
Asthma,Jammu,Punjab,2025-02-01,1180,73,1107,81,8
Asthma,Jammu,Punjab,2025-03-01,4040,180,3860,79,1
Asthma,Jammu,Punjab,2025-04-01,4002,263,3739,100,9
Asthma,Jammu,Punjab,2025-05-01,3756,112,3644,179,4
Asthma,Jammu,Punjab,2025-06-01,2577,0,2577,164,7
Asthma,Jammu,Punjab,2025-07-01,78,0,78,86,5
Asthma,Jammu,Punjab,2025-08-01,1737,136,1601,169,7
Asthma,Jammu,Punjab,2025-09-01,1758,216,1542,112,4
Asthma,Jammu,Punjab,2025-10-01,1285,0,1285,63,6
Asthma,Jammu,Punjab,2025-11-01,2761,198,2563,82,8
Asthma,Jammu,Punjab,2025-12-01,2035,0,2035,176,5
Asthma,Jammu,Chandigarh,2018-01-01,1491,150,1341,200,9
Asthma,Jammu,Chandigarh,2018-02-01,1177,75,1102,123,6
Asthma,Jammu,Chandigarh,2018-03-01,1638,36,1602,77,3
Asthma,Jammu,Chandigarh,2018-04-01,4102,298,3804,100,4
Asthma,Jammu,Chandigarh,2018-05-01,1711,58,1653,67,7
Asthma,Jammu,Chandigarh,2018-06-01,1907,112,1795,75,1
Asthma,Jammu,Chandigarh,2018-07-01,1985,111,1874,70,7
Asthma,Jammu,Chandigarh,2018-08-01,3052,307,2745,102,4
Asthma,Jammu,Chandigarh,2018-09-01,3209,330,2879,112,1
Asthma,Jammu,Chandigarh,2018-10-01,78,0,78,99,5
Asthma,Jammu,Chandigarh,2018-11-01,3968,320,3648,95,3
Asthma,Jammu,Chandigarh,2018-12-01,4524,273,4251,145,3
Asthma,Jammu,Chandigarh,2019-01-01,1189,10,1179,95,3
Asthma,Jammu,Chandigarh,2019-02-01,1293,38,1255,98,5
Asthma,Jammu,Chandigarh,2019-03-01,1993,235,1758,97,4
Asthma,Jammu,Chandigarh,2019-04-01,1583,95,1488,185,6
Asthma,Jammu,Chandigarh,2019-05-01,2898,229,2669,81,8
Asthma,Jammu,Chandigarh,2019-06-01,78,0,78,137,6
Asthma,Jammu,Chandigarh,2019-07-01,1098,37,1061,68,10
Asthma,Jammu,Chandigarh,2019-08-01,4662,237,4425,124,10
Asthma,Jammu,Chandigarh,2019-09-01,1352,57,1295,134,4
Asthma,Jammu,Chandigarh,2019-10-01,4265,28,4237,161,1
Asthma,Jammu,Chandigarh,2019-11-01,3074,64,3010,87,4
Asthma,Jammu,Chandigarh,2019-12-01,170,12,158,49,5
Asthma,Jammu,Chandigarh,2020-01-01,3450,134,3316,66,10
Asthma,Jammu,Chandigarh,2020-02-01,2440,123,2317,155,4
Asthma,Jammu,Chandigarh,2020-03-01,1986,113,1873,200,6
Asthma,Jammu,Chandigarh,2020-04-01,2926,173,2753,149,3
Asthma,Jammu,Chandigarh,2020-05-01,3234,269,2965,42,4
Asthma,Jammu,Chandigarh,2020-06-01,3547,64,3483,147,1
Asthma,Jammu,Chandigarh,2020-07-01,4178,278,3900,58,1
Asthma,Jammu,Chandigarh,2020-08-01,3145,226,2919,88,9
Asthma,Jammu,Chandigarh,2020-09-01,752,59,693,116,8
Asthma,Jammu,Chandigarh,2020-10-01,1962,17,1945,124,4
Asthma,Jammu,Chandigarh,2020-11-01,4989,286,4703,110,8
Asthma,Jammu,Chandigarh,2020-12-01,3569,356,3213,76,1
Asthma,Jammu,Chandigarh,2021-01-01,4989,235,4754,160,4
Asthma,Jammu,Chandigarh,2021-02-01,4469,286,4183,79,5
Asthma,Jammu,Chandigarh,2021-03-01,2922,212,2710,170,8
Asthma,Jammu,Chandigarh,2021-04-01,3002,60,2942,37,5
Asthma,Jammu,Chandigarh,2021-05-01,2548,263,2285,117,6
Asthma,Jammu,Chandigarh,2021-06-01,266,17,249,44,3
Asthma,Jammu,Chandigarh,2021-07-01,2622,170,2452,64,6
Asthma,Jammu,Chandigarh,2021-08-01,4222,7,4215,80,8
Asthma,Jammu,Chandigarh,2021-09-01,1793,131,1662,184,1
Asthma,Jammu,Chandigarh,2021-10-01,3150,204,2946,173,8
Asthma,Jammu,Chandigarh,2021-11-01,3740,364,3376,151,4
Asthma,Jammu,Chandigarh,2021-12-01,1377,56,1321,108,1
Asthma,Jammu,Chandigarh,2022-01-01,1992,42,1950,116,4
Asthma,Jammu,Chandigarh,2022-02-01,1232,37,1195,171,9
Asthma,Jammu,Chandigarh,2022-03-01,1494,52,1442,142,3
Asthma,Jammu,Chandigarh,2022-04-01,870,15,855,107,6
Asthma,Jammu,Chandigarh,2022-05-01,1389,121,1268,182,1
Asthma,Jammu,Chandigarh,2022-06-01,4502,399,4103,148,1
Asthma,Jammu,Chandigarh,2022-07-01,1369,60,1309,119,2
Asthma,Jammu,Chandigarh,2022-08-01,2767,106,2661,83,8
Asthma,Jammu,Chandigarh,2022-09-01,1923,0,1923,78,5
Asthma,Jammu,Chandigarh,2022-10-01,4179,293,3886,89,8
Asthma,Jammu,Chandigarh,2022-11-01,4356,427,3929,129,8
Asthma,Jammu,Chandigarh,2022-12-01,3757,118,3639,149,3
Asthma,Jammu,Chandigarh,2023-01-01,3008,140,2868,33,9
Asthma,Jammu,Chandigarh,2023-02-01,2287,143,2144,11,3
Asthma,Jammu,Chandigarh,2023-03-01,998,100,898,58,8
Asthma,Jammu,Chandigarh,2023-04-01,4989,278,4711,85,8
Asthma,Jammu,Chandigarh,2023-05-01,1578,87,1491,167,5
Asthma,Jammu,Chandigarh,2023-06-01,3488,192,3296,92,5
Asthma,Jammu,Chandigarh,2023-07-01,4019,34,3985,119,6
Asthma,Jammu,Chandigarh,2023-08-01,1852,14,1838,128,5
Asthma,Jammu,Chandigarh,2023-09-01,3990,105,3885,54,4
Asthma,Jammu,Chandigarh,2023-10-01,3623,288,3335,181,3
Asthma,Jammu,Chandigarh,2023-11-01,4915,198,4717,72,4
Asthma,Jammu,Chandigarh,2023-12-01,1968,68,1900,186,8
Asthma,Jammu,Chandigarh,2024-01-01,872,29,843,100,1
Asthma,Jammu,Chandigarh,2024-02-01,1919,88,1831,89,3
Asthma,Jammu,Chandigarh,2024-03-01,2878,286,2592,50,4
Asthma,Jammu,Chandigarh,2024-04-01,2675,122,2553,116,4
Asthma,Jammu,Chandigarh,2024-05-01,2070,56,2014,200,6
Asthma,Jammu,Chandigarh,2024-06-01,78,0,78,127,1
Asthma,Jammu,Chandigarh,2024-07-01,3229,326,2903,120,8
Asthma,Jammu,Chandigarh,2024-08-01,4989,176,4813,72,7
Asthma,Jammu,Chandigarh,2024-09-01,3220,50,3170,136,7
Asthma,Jammu,Chandigarh,2024-10-01,3415,121,3294,114,4
Asthma,Jammu,Chandigarh,2024-11-01,3365,181,3184,103,3
Asthma,Jammu,Chandigarh,2024-12-01,3130,219,2911,131,4
Asthma,Jammu,Chandigarh,2025-01-01,3847,305,3542,14,5
Asthma,Jammu,Chandigarh,2025-02-01,3128,61,3067,101,7
Asthma,Jammu,Chandigarh,2025-03-01,2178,48,2130,45,5
Asthma,Jammu,Chandigarh,2025-04-01,1530,62,1468,108,6
Asthma,Jammu,Chandigarh,2025-05-01,2263,158,2105,69,4
Asthma,Jammu,Chandigarh,2025-06-01,3019,40,2979,73,6
Asthma,Jammu,Chandigarh,2025-07-01,2173,70,2103,38,4
Asthma,Jammu,Chandigarh,2025-08-01,3019,99,2920,163,6
Asthma,Jammu,Chandigarh,2025-09-01,3187,246,2941,72,1
Asthma,Jammu,Chandigarh,2025-10-01,3715,243,3472,74,6
Asthma,Jammu,Chandigarh,2025-11-01,4318,329,3989,184,6
Asthma,Jammu,Chandigarh,2025-12-01,2702,240,2462,135,6
Asthma,Jammu,Himachal Pradesh,2018-01-01,843,34,809,11,2
Asthma,Jammu,Himachal Pradesh,2018-02-01,2134,33,2101,177,3
Asthma,Jammu,Himachal Pradesh,2018-03-01,2657,41,2616,190,2
Asthma,Jammu,Himachal Pradesh,2018-04-01,135,0,135,185,6
Asthma,Jammu,Himachal Pradesh,2018-05-01,4460,163,4297,140,7
Asthma,Jammu,Himachal Pradesh,2018-06-01,2788,108,2680,50,3
Asthma,Jammu,Himachal Pradesh,2018-07-01,3109,226,2883,104,9
Asthma,Jammu,Himachal Pradesh,2018-08-01,4429,223,4206,32,9
Asthma,Jammu,Himachal Pradesh,2018-09-01,1752,62,1690,62,5
Asthma,Jammu,Himachal Pradesh,2018-10-01,3367,157,3210,50,6
Asthma,Jammu,Himachal Pradesh,2018-11-01,2450,48,2402,74,1
Asthma,Jammu,Himachal Pradesh,2018-12-01,2350,187,2163,115,3
Asthma,Jammu,Himachal Pradesh,2019-01-01,1562,42,1520,84,1
Asthma,Jammu,Himachal Pradesh,2019-02-01,4832,81,4751,81,2
Asthma,Jammu,Himachal Pradesh,2019-03-01,2094,154,1940,91,6
Asthma,Jammu,Himachal Pradesh,2019-04-01,3536,236,3300,183,7
Asthma,Jammu,Himachal Pradesh,2019-05-01,82,0,82,200,7
Asthma,Jammu,Himachal Pradesh,2019-06-01,4180,313,3867,83,6
Asthma,Jammu,Himachal Pradesh,2019-07-01,4009,114,3895,123,6
Asthma,Jammu,Himachal Pradesh,2019-08-01,2728,106,2622,63,1
Asthma,Jammu,Himachal Pradesh,2019-09-01,2293,127,2166,145,1
Asthma,Jammu,Himachal Pradesh,2019-10-01,3134,210,2924,82,4
Asthma,Jammu,Himachal Pradesh,2019-11-01,4989,314,4675,70,7
Asthma,Jammu,Himachal Pradesh,2019-12-01,232,11,221,200,4
Asthma,Jammu,Himachal Pradesh,2020-01-01,3646,137,3509,37,1
Asthma,Jammu,Himachal Pradesh,2020-02-01,1374,85,1289,11,3
Asthma,Jammu,Himachal Pradesh,2020-03-01,2571,119,2452,144,2
Asthma,Jammu,Himachal Pradesh,2020-04-01,2265,232,2033,87,1
Asthma,Jammu,Himachal Pradesh,2020-05-01,2023,135,1888,73,10
Asthma,Jammu,Himachal Pradesh,2020-06-01,2583,59,2524,200,8
Asthma,Jammu,Himachal Pradesh,2020-07-01,1076,38,1038,143,1
Asthma,Jammu,Himachal Pradesh,2020-08-01,3978,204,3774,103,1
Asthma,Jammu,Himachal Pradesh,2020-09-01,191,16,175,70,2
Asthma,Jammu,Himachal Pradesh,2020-10-01,3322,302,3020,129,1
Asthma,Jammu,Himachal Pradesh,2020-11-01,2159,83,2076,18,10
Asthma,Jammu,Himachal Pradesh,2020-12-01,1027,23,1004,80,2
Asthma,Jammu,Himachal Pradesh,2021-01-01,2869,55,2814,104,6
Asthma,Jammu,Himachal Pradesh,2021-02-01,509,29,480,117,3
Asthma,Jammu,Himachal Pradesh,2021-03-01,2651,310,2341,99,1
Asthma,Jammu,Himachal Pradesh,2021-04-01,689,45,644,71,8
Asthma,Jammu,Himachal Pradesh,2021-05-01,3216,11,3205,153,7
Asthma,Jammu,Himachal Pradesh,2021-06-01,1357,39,1318,22,5
Asthma,Jammu,Himachal Pradesh,2021-07-01,1992,63,1929,92,10
Asthma,Jammu,Himachal Pradesh,2021-08-01,2992,78,2914,80,6
Asthma,Jammu,Himachal Pradesh,2021-09-01,1561,60,1501,158,3
Asthma,Jammu,Himachal Pradesh,2021-10-01,2520,153,2367,83,10
Asthma,Jammu,Himachal Pradesh,2021-11-01,567,39,528,129,6
Asthma,Jammu,Himachal Pradesh,2021-12-01,3444,281,3163,123,10
Asthma,Jammu,Himachal Pradesh,2022-01-01,4965,324,4641,13,5
Asthma,Jammu,Himachal Pradesh,2022-02-01,4989,20,4969,103,1
Asthma,Jammu,Himachal Pradesh,2022-03-01,2720,52,2668,17,1
Asthma,Jammu,Himachal Pradesh,2022-04-01,3655,166,3489,124,8
Asthma,Jammu,Himachal Pradesh,2022-05-01,209,11,198,69,3
Asthma,Jammu,Himachal Pradesh,2022-06-01,4613,346,4267,167,6
Asthma,Jammu,Himachal Pradesh,2022-07-01,3639,186,3453,97,8
Asthma,Jammu,Himachal Pradesh,2022-08-01,1948,100,1848,67,5
Asthma,Jammu,Himachal Pradesh,2022-09-01,4257,242,4015,167,2
Asthma,Jammu,Himachal Pradesh,2022-10-01,2256,96,2160,62,5
Asthma,Jammu,Himachal Pradesh,2022-11-01,1983,104,1879,152,5
Asthma,Jammu,Himachal Pradesh,2022-12-01,3235,267,2968,130,4
Asthma,Jammu,Himachal Pradesh,2023-01-01,1171,55,1116,88,1
Asthma,Jammu,Himachal Pradesh,2023-02-01,3968,195,3773,38,4
Asthma,Jammu,Himachal Pradesh,2023-03-01,1181,57,1124,169,5
Asthma,Jammu,Himachal Pradesh,2023-04-01,1189,104,1085,132,1
Asthma,Jammu,Himachal Pradesh,2023-05-01,1377,24,1353,67,2
Asthma,Jammu,Himachal Pradesh,2023-06-01,3616,367,3249,119,3
Asthma,Jammu,Himachal Pradesh,2023-07-01,1770,28,1742,157,1
Asthma,Jammu,Himachal Pradesh,2023-08-01,789,24,765,112,5
Asthma,Jammu,Himachal Pradesh,2023-09-01,1785,128,1657,118,6
Asthma,Jammu,Himachal Pradesh,2023-10-01,2554,204,2350,159,3
Asthma,Jammu,Himachal Pradesh,2023-11-01,1013,9,1004,185,1
Asthma,Jammu,Himachal Pradesh,2023-12-01,1052,19,1033,100,6
Asthma,Jammu,Himachal Pradesh,2024-01-01,4989,290,4699,38,6
Asthma,Jammu,Himachal Pradesh,2024-02-01,1443,170,1273,40,5
Asthma,Jammu,Himachal Pradesh,2024-03-01,2164,186,1978,71,5
Asthma,Jammu,Himachal Pradesh,2024-04-01,2105,90,2015,59,7
Asthma,Jammu,Himachal Pradesh,2024-05-01,2032,0,2032,20,5
Asthma,Jammu,Himachal Pradesh,2024-06-01,3431,179,3252,200,2
Asthma,Jammu,Himachal Pradesh,2024-07-01,3869,234,3635,133,5
Asthma,Jammu,Himachal Pradesh,2024-08-01,2187,85,2102,80,4
Asthma,Jammu,Himachal Pradesh,2024-09-01,939,23,916,105,5
Asthma,Jammu,Himachal Pradesh,2024-10-01,4307,235,4072,15,7
Asthma,Jammu,Himachal Pradesh,2024-11-01,2470,55,2415,165,1
Asthma,Jammu,Himachal Pradesh,2024-12-01,4919,442,4477,11,5
Asthma,Jammu,Himachal Pradesh,2025-01-01,78,0,78,132,1
Asthma,Jammu,Himachal Pradesh,2025-02-01,2860,197,2663,13,2
Asthma,Jammu,Himachal Pradesh,2025-03-01,4989,262,4727,85,9
Asthma,Jammu,Himachal Pradesh,2025-04-01,2123,65,2058,170,6
Asthma,Jammu,Himachal Pradesh,2025-05-01,2295,113,2182,23,5
Asthma,Jammu,Himachal Pradesh,2025-06-01,2994,292,2702,99,1
Asthma,Jammu,Himachal Pradesh,2025-07-01,1848,139,1709,138,4
Asthma,Jammu,Himachal Pradesh,2025-08-01,2179,122,2057,130,1
Asthma,Jammu,Himachal Pradesh,2025-09-01,2144,165,1979,110,5
Asthma,Jammu,Himachal Pradesh,2025-10-01,1756,115,1641,131,1
Asthma,Jammu,Himachal Pradesh,2025-11-01,4246,261,3985,75,6
Asthma,Jammu,Himachal Pradesh,2025-12-01,3216,252,2964,200,5
Asthma,Jammu,Jammu & Kashmir,2018-01-01,2934,191,2743,24,1
Asthma,Jammu,Jammu & Kashmir,2018-02-01,3682,276,3406,165,6
Asthma,Jammu,Jammu & Kashmir,2018-03-01,2243,122,2121,116,10
Asthma,Jammu,Jammu & Kashmir,2018-04-01,1559,66,1493,138,4
Asthma,Jammu,Jammu & Kashmir,2018-05-01,1789,61,1728,147,7
Asthma,Jammu,Jammu & Kashmir,2018-06-01,2600,79,2521,135,1
Asthma,Jammu,Jammu & Kashmir,2018-07-01,1176,3,1173,65,6
Asthma,Jammu,Jammu & Kashmir,2018-08-01,1926,45,1881,92,3
Asthma,Jammu,Jammu & Kashmir,2018-09-01,1905,43,1862,32,4
Asthma,Jammu,Jammu & Kashmir,2018-10-01,4989,176,4813,91,7
Asthma,Jammu,Jammu & Kashmir,2018-11-01,78,0,78,123,4
Asthma,Jammu,Jammu & Kashmir,2018-12-01,2356,107,2249,137,1
Asthma,Jammu,Jammu & Kashmir,2019-01-01,4912,280,4632,126,9
Asthma,Jammu,Jammu & Kashmir,2019-02-01,2761,160,2601,17,1
Asthma,Jammu,Jammu & Kashmir,2019-03-01,3608,347,3261,78,2
Asthma,Jammu,Jammu & Kashmir,2019-04-01,2731,90,2641,72,5
Asthma,Jammu,Jammu & Kashmir,2019-05-01,1702,74,1628,39,5
Asthma,Jammu,Jammu & Kashmir,2019-06-01,78,0,78,64,6
Asthma,Jammu,Jammu & Kashmir,2019-07-01,2873,238,2635,106,5
Asthma,Jammu,Jammu & Kashmir,2019-08-01,1557,138,1419,178,8
Asthma,Jammu,Jammu & Kashmir,2019-09-01,1524,97,1427,58,6
Asthma,Jammu,Jammu & Kashmir,2019-10-01,1928,165,1763,49,1
Asthma,Jammu,Jammu & Kashmir,2019-11-01,4938,272,4666,76,1
Asthma,Jammu,Jammu & Kashmir,2019-12-01,4989,224,4765,123,5
Asthma,Jammu,Jammu & Kashmir,2020-01-01,2889,243,2646,169,9
Asthma,Jammu,Jammu & Kashmir,2020-02-01,1974,126,1848,102,1
Asthma,Jammu,Jammu & Kashmir,2020-03-01,1018,29,989,33,2
Asthma,Jammu,Jammu & Kashmir,2020-04-01,3226,255,2971,43,6
Asthma,Jammu,Jammu & Kashmir,2020-05-01,4989,219,4770,116,6
Asthma,Jammu,Jammu & Kashmir,2020-06-01,2266,91,2175,157,8
Asthma,Jammu,Jammu & Kashmir,2020-07-01,78,0,78,199,10
Asthma,Jammu,Jammu & Kashmir,2020-08-01,3496,166,3330,46,6
Asthma,Jammu,Jammu & Kashmir,2020-09-01,3919,240,3679,113,2
Asthma,Jammu,Jammu & Kashmir,2020-10-01,470,32,438,54,2
Asthma,Jammu,Jammu & Kashmir,2020-11-01,2834,77,2757,60,3
Asthma,Jammu,Jammu & Kashmir,2020-12-01,3203,196,3007,56,8
Asthma,Jammu,Jammu & Kashmir,2021-01-01,2499,223,2276,89,3
Asthma,Jammu,Jammu & Kashmir,2021-02-01,1537,34,1503,61,8
Asthma,Jammu,Jammu & Kashmir,2021-03-01,3960,250,3710,200,1
Asthma,Jammu,Jammu & Kashmir,2021-04-01,2056,53,2003,83,6
Asthma,Jammu,Jammu & Kashmir,2021-05-01,605,48,557,157,3
Asthma,Jammu,Jammu & Kashmir,2021-06-01,78,0,78,73,6
Asthma,Jammu,Jammu & Kashmir,2021-07-01,4289,170,4119,200,4
Asthma,Jammu,Jammu & Kashmir,2021-08-01,3425,391,3034,123,7
Asthma,Jammu,Jammu & Kashmir,2021-09-01,2715,223,2492,149,4
Asthma,Jammu,Jammu & Kashmir,2021-10-01,2007,141,1866,76,5
Asthma,Jammu,Jammu & Kashmir,2021-11-01,1888,130,1758,156,7
Asthma,Jammu,Jammu & Kashmir,2021-12-01,1154,90,1064,123,5
Asthma,Jammu,Jammu & Kashmir,2022-01-01,2019,42,1977,87,5
Asthma,Jammu,Jammu & Kashmir,2022-02-01,78,0,78,51,7
Asthma,Jammu,Jammu & Kashmir,2022-03-01,1610,98,1512,94,5
Asthma,Jammu,Jammu & Kashmir,2022-04-01,2180,83,2097,90,1
Asthma,Jammu,Jammu & Kashmir,2022-05-01,3416,217,3199,150,3
Asthma,Jammu,Jammu & Kashmir,2022-06-01,2544,218,2326,94,1
Asthma,Jammu,Jammu & Kashmir,2022-07-01,3664,138,3526,11,4
Asthma,Jammu,Jammu & Kashmir,2022-08-01,4407,213,4194,139,6
Asthma,Jammu,Jammu & Kashmir,2022-09-01,4017,105,3912,172,5
Asthma,Jammu,Jammu & Kashmir,2022-10-01,3229,0,3229,21,9
Asthma,Jammu,Jammu & Kashmir,2022-11-01,2613,190,2423,198,9
Asthma,Jammu,Jammu & Kashmir,2022-12-01,1282,63,1219,177,6
Asthma,Jammu,Jammu & Kashmir,2023-01-01,3590,184,3406,74,1
Asthma,Jammu,Jammu & Kashmir,2023-02-01,4851,103,4748,49,7
Asthma,Jammu,Jammu & Kashmir,2023-03-01,3056,136,2920,160,3
Asthma,Jammu,Jammu & Kashmir,2023-04-01,4989,409,4580,36,7
Asthma,Jammu,Jammu & Kashmir,2023-05-01,551,27,524,72,6
Asthma,Jammu,Jammu & Kashmir,2023-06-01,1049,53,996,39,7
Asthma,Jammu,Jammu & Kashmir,2023-07-01,3745,210,3535,107,6
Asthma,Jammu,Jammu & Kashmir,2023-08-01,2952,41,2911,181,10
Asthma,Jammu,Jammu & Kashmir,2023-09-01,4360,297,4063,125,6
Asthma,Jammu,Jammu & Kashmir,2023-10-01,2577,34,2543,158,1
Asthma,Jammu,Jammu & Kashmir,2023-11-01,1433,32,1401,88,8
Asthma,Jammu,Jammu & Kashmir,2023-12-01,2311,45,2266,111,4
Asthma,Jammu,Jammu & Kashmir,2024-01-01,541,24,517,44,9
Asthma,Jammu,Jammu & Kashmir,2024-02-01,1083,43,1040,101,9
Asthma,Jammu,Jammu & Kashmir,2024-03-01,3902,195,3707,68,7
Asthma,Jammu,Jammu & Kashmir,2024-04-01,3768,89,3679,98,1
Asthma,Jammu,Jammu & Kashmir,2024-05-01,3084,244,2840,95,3
Asthma,Jammu,Jammu & Kashmir,2024-06-01,289,21,268,90,9
Asthma,Jammu,Jammu & Kashmir,2024-07-01,2117,95,2022,200,10
Asthma,Jammu,Jammu & Kashmir,2024-08-01,954,34,920,196,5
Asthma,Jammu,Jammu & Kashmir,2024-09-01,4176,138,4038,178,4
Asthma,Jammu,Jammu & Kashmir,2024-10-01,1814,74,1740,198,1
Asthma,Jammu,Jammu & Kashmir,2024-11-01,1141,10,1131,179,1
Asthma,Jammu,Jammu & Kashmir,2024-12-01,2637,58,2579,105,5
Asthma,Jammu,Jammu & Kashmir,2025-01-01,1739,130,1609,100,7
Asthma,Jammu,Jammu & Kashmir,2025-02-01,4588,270,4318,118,1
Asthma,Jammu,Jammu & Kashmir,2025-03-01,1612,157,1455,95,7
Asthma,Jammu,Jammu & Kashmir,2025-04-01,720,29,691,53,9
Asthma,Jammu,Jammu & Kashmir,2025-05-01,78,0,78,121,7
Asthma,Jammu,Jammu & Kashmir,2025-06-01,2556,97,2459,26,10
Asthma,Jammu,Jammu & Kashmir,2025-07-01,1844,75,1769,113,6
Asthma,Jammu,Jammu & Kashmir,2025-08-01,681,21,660,56,6
Asthma,Jammu,Jammu & Kashmir,2025-09-01,4193,243,3950,102,6
Asthma,Jammu,Jammu & Kashmir,2025-10-01,3493,177,3316,116,9
Asthma,Jammu,Jammu & Kashmir,2025-11-01,2560,90,2470,88,6
Asthma,Jammu,Jammu & Kashmir,2025-12-01,4428,382,4046,23,3
Asthma,Jammu,Haryana,2018-01-01,3486,366,3120,46,6
Asthma,Jammu,Haryana,2018-02-01,1494,125,1369,130,6
Asthma,Jammu,Haryana,2018-03-01,1203,79,1124,78,4
Asthma,Jammu,Haryana,2018-04-01,3695,266,3429,135,8
Asthma,Jammu,Haryana,2018-05-01,3129,325,2804,107,5
Asthma,Jammu,Haryana,2018-06-01,2825,203,2622,96,7
Asthma,Jammu,Haryana,2018-07-01,1462,48,1414,124,6
Asthma,Jammu,Haryana,2018-08-01,3413,209,3204,72,3
Asthma,Jammu,Haryana,2018-09-01,1584,108,1476,127,2
Asthma,Jammu,Haryana,2018-10-01,2461,51,2410,85,3
Asthma,Jammu,Haryana,2018-11-01,4538,189,4349,200,5
Asthma,Jammu,Haryana,2018-12-01,1711,140,1571,48,9
Asthma,Jammu,Haryana,2019-01-01,487,0,487,88,5
Asthma,Jammu,Haryana,2019-02-01,1185,16,1169,90,6
Asthma,Jammu,Haryana,2019-03-01,3931,176,3755,37,7
Asthma,Jammu,Haryana,2019-04-01,2939,177,2762,143,4
Asthma,Jammu,Haryana,2019-05-01,2425,25,2400,84,4
Asthma,Jammu,Haryana,2019-06-01,1914,88,1826,11,8
Asthma,Jammu,Haryana,2019-07-01,3249,271,2978,142,6
Asthma,Jammu,Haryana,2019-08-01,1458,75,1383,74,3
Asthma,Jammu,Haryana,2019-09-01,3007,232,2775,101,4
Asthma,Jammu,Haryana,2019-10-01,1616,53,1563,141,5
Asthma,Jammu,Haryana,2019-11-01,1393,36,1357,88,6
Asthma,Jammu,Haryana,2019-12-01,1742,130,1612,87,8
Asthma,Jammu,Haryana,2020-01-01,2094,127,1967,200,6
Asthma,Jammu,Haryana,2020-02-01,2532,39,2493,11,2
Asthma,Jammu,Haryana,2020-03-01,2913,77,2836,41,3
Asthma,Jammu,Haryana,2020-04-01,78,0,78,51,6
Asthma,Jammu,Haryana,2020-05-01,1514,35,1479,197,5
Asthma,Jammu,Haryana,2020-06-01,2072,160,1912,73,2
Asthma,Jammu,Haryana,2020-07-01,4616,166,4450,118,8
Asthma,Jammu,Haryana,2020-08-01,1149,57,1092,82,1
Asthma,Jammu,Haryana,2020-09-01,2816,165,2651,137,6
Asthma,Jammu,Haryana,2020-10-01,4603,0,4603,106,1
Asthma,Jammu,Haryana,2020-11-01,836,6,830,119,7
Asthma,Jammu,Haryana,2020-12-01,3126,164,2962,172,4
Asthma,Jammu,Haryana,2021-01-01,1521,44,1477,129,7
Asthma,Jammu,Haryana,2021-02-01,1920,151,1769,69,4
Asthma,Jammu,Haryana,2021-03-01,1520,5,1515,122,9
Asthma,Jammu,Haryana,2021-04-01,1616,107,1509,200,1
Asthma,Jammu,Haryana,2021-05-01,4989,49,4940,135,7
Asthma,Jammu,Haryana,2021-06-01,3730,148,3582,114,3
Asthma,Jammu,Haryana,2021-07-01,4075,77,3998,36,6
Asthma,Jammu,Haryana,2021-08-01,3257,343,2914,143,6
Asthma,Jammu,Haryana,2021-09-01,443,4,439,151,1
Asthma,Jammu,Haryana,2021-10-01,3127,145,2982,122,8
Asthma,Jammu,Haryana,2021-11-01,4037,0,4037,112,6
Asthma,Jammu,Haryana,2021-12-01,1453,140,1313,200,5
Asthma,Jammu,Haryana,2022-01-01,3892,240,3652,150,6
Asthma,Jammu,Haryana,2022-02-01,3542,191,3351,169,5
Asthma,Jammu,Haryana,2022-03-01,4989,442,4547,110,7
Asthma,Jammu,Haryana,2022-04-01,2037,110,1927,100,3
Asthma,Jammu,Haryana,2022-05-01,1125,63,1062,138,7
Asthma,Jammu,Haryana,2022-06-01,2112,113,1999,99,6
Asthma,Jammu,Haryana,2022-07-01,4523,300,4223,104,4
Asthma,Jammu,Haryana,2022-08-01,145,5,140,130,10
Asthma,Jammu,Haryana,2022-09-01,78,0,78,80,6
Asthma,Jammu,Haryana,2022-10-01,2717,200,2517,117,5
Asthma,Jammu,Haryana,2022-11-01,2004,116,1888,110,6
Asthma,Jammu,Haryana,2022-12-01,2608,121,2487,155,5
Asthma,Jammu,Haryana,2023-01-01,3866,35,3831,75,8
Asthma,Jammu,Haryana,2023-02-01,1856,173,1683,11,5
Asthma,Jammu,Haryana,2023-03-01,85,2,83,90,7
Asthma,Jammu,Haryana,2023-04-01,4989,393,4596,126,2
Asthma,Jammu,Haryana,2023-05-01,1260,69,1191,155,1
Asthma,Jammu,Haryana,2023-06-01,1177,14,1163,71,6
Asthma,Jammu,Haryana,2023-07-01,4078,352,3726,134,4
Asthma,Jammu,Haryana,2023-08-01,2082,119,1963,164,4
Asthma,Jammu,Haryana,2023-09-01,2512,223,2289,144,1
Asthma,Jammu,Haryana,2023-10-01,3245,145,3100,66,10
Asthma,Jammu,Haryana,2023-11-01,4051,285,3766,71,5
Asthma,Jammu,Haryana,2023-12-01,2150,0,2150,128,9
Asthma,Jammu,Haryana,2024-01-01,4636,164,4472,189,1
Asthma,Jammu,Haryana,2024-02-01,78,0,78,107,5
Asthma,Jammu,Haryana,2024-03-01,3617,141,3476,98,6
Asthma,Jammu,Haryana,2024-04-01,1471,93,1378,36,5
Asthma,Jammu,Haryana,2024-05-01,4438,144,4294,88,5
Asthma,Jammu,Haryana,2024-06-01,2788,209,2579,70,1
Asthma,Jammu,Haryana,2024-07-01,1695,42,1653,108,6
Asthma,Jammu,Haryana,2024-08-01,3487,264,3223,29,2
Asthma,Jammu,Haryana,2024-09-01,3796,334,3462,89,3
Asthma,Jammu,Haryana,2024-10-01,3459,275,3184,55,5
Asthma,Jammu,Haryana,2024-11-01,1216,48,1168,154,4
Asthma,Jammu,Haryana,2024-12-01,1948,0,1948,62,4
Asthma,Jammu,Haryana,2025-01-01,2592,173,2419,77,8
Asthma,Jammu,Haryana,2025-02-01,2542,118,2424,121,4
Asthma,Jammu,Haryana,2025-03-01,3603,77,3526,83,4
Asthma,Jammu,Haryana,2025-04-01,78,0,78,200,4
Asthma,Jammu,Haryana,2025-05-01,3046,279,2767,154,2
Asthma,Jammu,Haryana,2025-06-01,2208,37,2171,107,5
Asthma,Jammu,Haryana,2025-07-01,1473,93,1380,125,7
Asthma,Jammu,Haryana,2025-08-01,1601,90,1511,11,6
Asthma,Jammu,Haryana,2025-09-01,2310,91,2219,169,5
Asthma,Jammu,Haryana,2025-10-01,78,0,78,132,7
Asthma,Jammu,Haryana,2025-11-01,1657,161,1496,102,3
Asthma,Jammu,Haryana,2025-12-01,1422,58,1364,135,5
Asthma,Srinagar,Punjab,2018-01-01,3312,142,3170,141,9
Asthma,Srinagar,Punjab,2018-02-01,1517,103,1414,85,4
Asthma,Srinagar,Punjab,2018-03-01,2309,177,2132,126,7
Asthma,Srinagar,Punjab,2018-04-01,4666,216,4450,160,7
Asthma,Srinagar,Punjab,2018-05-01,3931,161,3770,129,3
Asthma,Srinagar,Punjab,2018-06-01,3808,0,3808,93,7
Asthma,Srinagar,Punjab,2018-07-01,1927,52,1875,121,3
Asthma,Srinagar,Punjab,2018-08-01,3326,56,3270,177,6
Asthma,Srinagar,Punjab,2018-09-01,2284,159,2125,146,3
Asthma,Srinagar,Punjab,2018-10-01,2334,100,2234,47,6
Asthma,Srinagar,Punjab,2018-11-01,3147,131,3016,136,5
Asthma,Srinagar,Punjab,2018-12-01,1797,89,1708,129,5
Asthma,Srinagar,Punjab,2019-01-01,4600,113,4487,166,6
Asthma,Srinagar,Punjab,2019-02-01,2383,227,2156,108,3
Asthma,Srinagar,Punjab,2019-03-01,3427,301,3126,87,1
Asthma,Srinagar,Punjab,2019-04-01,4550,442,4108,37,5
Asthma,Srinagar,Punjab,2019-05-01,3981,278,3703,71,8
Asthma,Srinagar,Punjab,2019-06-01,707,34,673,168,7
Asthma,Srinagar,Punjab,2019-07-01,3194,310,2884,116,6
Asthma,Srinagar,Punjab,2019-08-01,3739,113,3626,101,3
Asthma,Srinagar,Punjab,2019-09-01,3794,93,3701,172,5
Asthma,Srinagar,Punjab,2019-10-01,1104,35,1069,162,2
Asthma,Srinagar,Punjab,2019-11-01,1716,112,1604,69,4
Asthma,Srinagar,Punjab,2019-12-01,3932,109,3823,167,6
Asthma,Srinagar,Punjab,2020-01-01,1575,71,1504,22,1
Asthma,Srinagar,Punjab,2020-02-01,2195,7,2188,130,10
Asthma,Srinagar,Punjab,2020-03-01,4711,301,4410,124,1
Asthma,Srinagar,Punjab,2020-04-01,2533,14,2519,165,10
Asthma,Srinagar,Punjab,2020-05-01,1622,37,1585,126,2
Asthma,Srinagar,Punjab,2020-06-01,1420,121,1299,94,2
Asthma,Srinagar,Punjab,2020-07-01,3044,256,2788,98,4
Asthma,Srinagar,Punjab,2020-08-01,809,49,760,200,4
Asthma,Srinagar,Punjab,2020-09-01,2266,131,2135,110,3
Asthma,Srinagar,Punjab,2020-10-01,3044,105,2939,137,4
Asthma,Srinagar,Punjab,2020-11-01,4340,119,4221,11,5
Asthma,Srinagar,Punjab,2020-12-01,3493,138,3355,64,2
Asthma,Srinagar,Punjab,2021-01-01,1639,9,1630,133,7
Asthma,Srinagar,Punjab,2021-02-01,4178,239,3939,24,9
Asthma,Srinagar,Punjab,2021-03-01,2196,113,2083,134,1
Asthma,Srinagar,Punjab,2021-04-01,940,21,919,69,10
Asthma,Srinagar,Punjab,2021-05-01,2367,226,2141,54,7
Asthma,Srinagar,Punjab,2021-06-01,4527,306,4221,69,6
Asthma,Srinagar,Punjab,2021-07-01,2819,197,2622,184,3
Asthma,Srinagar,Punjab,2021-08-01,2614,93,2521,123,5
Asthma,Srinagar,Punjab,2021-09-01,4794,239,4555,60,7
Asthma,Srinagar,Punjab,2021-10-01,677,46,631,146,10
Asthma,Srinagar,Punjab,2021-11-01,873,47,826,148,10
Asthma,Srinagar,Punjab,2021-12-01,430,41,389,87,1
Asthma,Srinagar,Punjab,2022-01-01,3097,136,2961,155,4
Asthma,Srinagar,Punjab,2022-02-01,2821,99,2722,158,5
Asthma,Srinagar,Punjab,2022-03-01,4667,319,4348,150,9
Asthma,Srinagar,Punjab,2022-04-01,2924,38,2886,72,5
Asthma,Srinagar,Punjab,2022-05-01,2055,158,1897,46,3
Asthma,Srinagar,Punjab,2022-06-01,2600,31,2569,20,5
Asthma,Srinagar,Punjab,2022-07-01,2755,189,2566,73,4
Asthma,Srinagar,Punjab,2022-08-01,355,11,344,87,8
Asthma,Srinagar,Punjab,2022-09-01,4989,319,4670,92,10
Asthma,Srinagar,Punjab,2022-10-01,3295,251,3044,104,7
Asthma,Srinagar,Punjab,2022-11-01,2879,157,2722,194,8
Asthma,Srinagar,Punjab,2022-12-01,3423,51,3372,89,8
Asthma,Srinagar,Punjab,2023-01-01,3549,85,3464,104,6
Asthma,Srinagar,Punjab,2023-02-01,2409,69,2340,14,4
Asthma,Srinagar,Punjab,2023-03-01,1751,0,1751,200,4
Asthma,Srinagar,Punjab,2023-04-01,3402,281,3121,39,8
Asthma,Srinagar,Punjab,2023-05-01,3115,165,2950,70,6
Asthma,Srinagar,Punjab,2023-06-01,1511,25,1486,142,2
Asthma,Srinagar,Punjab,2023-07-01,4501,416,4085,119,9
Asthma,Srinagar,Punjab,2023-08-01,2991,88,2903,190,3
Asthma,Srinagar,Punjab,2023-09-01,3576,205,3371,143,2
Asthma,Srinagar,Punjab,2023-10-01,4465,116,4349,102,2
Asthma,Srinagar,Punjab,2023-11-01,2627,0,2627,159,6
Asthma,Srinagar,Punjab,2023-12-01,3023,31,2992,165,8
Asthma,Srinagar,Punjab,2024-01-01,3684,136,3548,73,6
Asthma,Srinagar,Punjab,2024-02-01,1625,123,1502,155,3
Asthma,Srinagar,Punjab,2024-03-01,2670,160,2510,95,2
Asthma,Srinagar,Punjab,2024-04-01,2766,149,2617,101,7
Asthma,Srinagar,Punjab,2024-05-01,1315,0,1315,113,5
Asthma,Srinagar,Punjab,2024-06-01,4989,434,4555,87,6
Asthma,Srinagar,Punjab,2024-07-01,710,40,670,84,4
Asthma,Srinagar,Punjab,2024-08-01,856,39,817,156,6
Asthma,Srinagar,Punjab,2024-09-01,4360,362,3998,28,6
Asthma,Srinagar,Punjab,2024-10-01,3554,306,3248,52,10
Asthma,Srinagar,Punjab,2024-11-01,1221,102,1119,141,6
Asthma,Srinagar,Punjab,2024-12-01,3412,146,3266,102,4
Asthma,Srinagar,Punjab,2025-01-01,4567,95,4472,157,5
Asthma,Srinagar,Punjab,2025-02-01,2557,201,2356,124,2
Asthma,Srinagar,Punjab,2025-03-01,4989,51,4938,38,2
Asthma,Srinagar,Punjab,2025-04-01,285,30,255,109,8
Asthma,Srinagar,Punjab,2025-05-01,3528,179,3349,133,6
Asthma,Srinagar,Punjab,2025-06-01,4162,79,4083,118,8
Asthma,Srinagar,Punjab,2025-07-01,3793,53,3740,82,1
Asthma,Srinagar,Punjab,2025-08-01,2323,29,2294,92,2
Asthma,Srinagar,Punjab,2025-09-01,2208,119,2089,78,6
Asthma,Srinagar,Punjab,2025-10-01,3193,159,3034,39,2
Asthma,Srinagar,Punjab,2025-11-01,3692,52,3640,32,1
Asthma,Srinagar,Punjab,2025-12-01,3406,135,3271,126,2
Asthma,Srinagar,Chandigarh,2018-01-01,3993,40,3953,62,4
Asthma,Srinagar,Chandigarh,2018-02-01,1231,82,1149,136,6
Asthma,Srinagar,Chandigarh,2018-03-01,2292,111,2181,76,10
Asthma,Srinagar,Chandigarh,2018-04-01,1336,52,1284,39,2
Asthma,Srinagar,Chandigarh,2018-05-01,2079,26,2053,85,2
Asthma,Srinagar,Chandigarh,2018-06-01,3959,163,3796,200,1
Asthma,Srinagar,Chandigarh,2018-07-01,2742,104,2638,101,6
Asthma,Srinagar,Chandigarh,2018-08-01,4989,295,4694,139,5
Asthma,Srinagar,Chandigarh,2018-09-01,2857,156,2701,115,2
Asthma,Srinagar,Chandigarh,2018-10-01,2677,195,2482,35,2
Asthma,Srinagar,Chandigarh,2018-11-01,2740,98,2642,180,4
Asthma,Srinagar,Chandigarh,2018-12-01,1742,0,1742,94,5
Asthma,Srinagar,Chandigarh,2019-01-01,2520,198,2322,39,2
Asthma,Srinagar,Chandigarh,2019-02-01,4110,93,4017,80,5
Asthma,Srinagar,Chandigarh,2019-03-01,2750,49,2701,96,1
Asthma,Srinagar,Chandigarh,2019-04-01,1533,74,1459,144,5
Asthma,Srinagar,Chandigarh,2019-05-01,1356,79,1277,72,4
Asthma,Srinagar,Chandigarh,2019-06-01,1993,69,1924,200,6
Asthma,Srinagar,Chandigarh,2019-07-01,2696,92,2604,58,8
Asthma,Srinagar,Chandigarh,2019-08-01,4199,162,4037,137,4
Asthma,Srinagar,Chandigarh,2019-09-01,799,72,727,11,5
Asthma,Srinagar,Chandigarh,2019-10-01,2168,108,2060,100,1
Asthma,Srinagar,Chandigarh,2019-11-01,2791,61,2730,125,10
Asthma,Srinagar,Chandigarh,2019-12-01,137,3,134,49,1
Asthma,Srinagar,Chandigarh,2020-01-01,1479,63,1416,183,5
Asthma,Srinagar,Chandigarh,2020-02-01,1685,96,1589,128,1
Asthma,Srinagar,Chandigarh,2020-03-01,1530,98,1432,90,2
Asthma,Srinagar,Chandigarh,2020-04-01,2855,153,2702,128,10
Asthma,Srinagar,Chandigarh,2020-05-01,2382,60,2322,76,8
Asthma,Srinagar,Chandigarh,2020-06-01,1852,69,1783,170,8
Asthma,Srinagar,Chandigarh,2020-07-01,3172,226,2946,158,4
Asthma,Srinagar,Chandigarh,2020-08-01,4909,82,4827,125,10
Asthma,Srinagar,Chandigarh,2020-09-01,4796,175,4621,137,6
Asthma,Srinagar,Chandigarh,2020-10-01,78,0,78,31,7
Asthma,Srinagar,Chandigarh,2020-11-01,3372,254,3118,181,10
Asthma,Srinagar,Chandigarh,2020-12-01,2359,104,2255,101,8
Asthma,Srinagar,Chandigarh,2021-01-01,2806,106,2700,158,5
Asthma,Srinagar,Chandigarh,2021-02-01,2063,23,2040,144,6
Asthma,Srinagar,Chandigarh,2021-03-01,2755,180,2575,158,9
Asthma,Srinagar,Chandigarh,2021-04-01,2801,247,2554,53,7
Asthma,Srinagar,Chandigarh,2021-05-01,1821,227,1594,59,7
Asthma,Srinagar,Chandigarh,2021-06-01,1395,85,1310,200,9
Asthma,Srinagar,Chandigarh,2021-07-01,1995,96,1899,29,10
Asthma,Srinagar,Chandigarh,2021-08-01,2912,67,2845,50,2
Asthma,Srinagar,Chandigarh,2021-09-01,3401,0,3401,108,7
Asthma,Srinagar,Chandigarh,2021-10-01,3742,206,3536,109,6
Asthma,Srinagar,Chandigarh,2021-11-01,1934,229,1705,79,4
Asthma,Srinagar,Chandigarh,2021-12-01,2978,259,2719,138,3
Asthma,Srinagar,Chandigarh,2022-01-01,3889,321,3568,152,10
Asthma,Srinagar,Chandigarh,2022-02-01,4161,238,3923,105,2
Asthma,Srinagar,Chandigarh,2022-03-01,2518,152,2366,93,1
Asthma,Srinagar,Chandigarh,2022-04-01,2301,0,2301,105,3
Asthma,Srinagar,Chandigarh,2022-05-01,2854,206,2648,81,1
Asthma,Srinagar,Chandigarh,2022-06-01,1055,35,1020,20,2
Asthma,Srinagar,Chandigarh,2022-07-01,2338,69,2269,122,2
Asthma,Srinagar,Chandigarh,2022-08-01,3596,146,3450,145,5
Asthma,Srinagar,Chandigarh,2022-09-01,3459,137,3322,98,9
Asthma,Srinagar,Chandigarh,2022-10-01,2235,65,2170,11,3
Asthma,Srinagar,Chandigarh,2022-11-01,2889,145,2744,77,7
Asthma,Srinagar,Chandigarh,2022-12-01,1491,50,1441,152,7
Asthma,Srinagar,Chandigarh,2023-01-01,3541,187,3354,33,1
Asthma,Srinagar,Chandigarh,2023-02-01,2493,16,2477,142,3
Asthma,Srinagar,Chandigarh,2023-03-01,2227,97,2130,84,4
Asthma,Srinagar,Chandigarh,2023-04-01,2112,38,2074,105,6
Asthma,Srinagar,Chandigarh,2023-05-01,2513,78,2435,71,6
Asthma,Srinagar,Chandigarh,2023-06-01,1997,108,1889,48,6
Asthma,Srinagar,Chandigarh,2023-07-01,3480,11,3469,179,2
Asthma,Srinagar,Chandigarh,2023-08-01,2067,54,2013,148,3
Asthma,Srinagar,Chandigarh,2023-09-01,4734,315,4419,139,1
Asthma,Srinagar,Chandigarh,2023-10-01,4563,40,4523,152,5
Asthma,Srinagar,Chandigarh,2023-11-01,1401,142,1259,132,4
Asthma,Srinagar,Chandigarh,2023-12-01,2691,229,2462,154,6
Asthma,Srinagar,Chandigarh,2024-01-01,1725,61,1664,72,7
Asthma,Srinagar,Chandigarh,2024-02-01,2159,58,2101,176,4
Asthma,Srinagar,Chandigarh,2024-03-01,4989,279,4710,172,6
Asthma,Srinagar,Chandigarh,2024-04-01,2185,17,2168,126,4
Asthma,Srinagar,Chandigarh,2024-05-01,3081,0,3081,92,2
Asthma,Srinagar,Chandigarh,2024-06-01,3324,121,3203,44,2
Asthma,Srinagar,Chandigarh,2024-07-01,1255,57,1198,118,1
Asthma,Srinagar,Chandigarh,2024-08-01,1450,76,1374,192,4
Asthma,Srinagar,Chandigarh,2024-09-01,980,31,949,47,3
Asthma,Srinagar,Chandigarh,2024-10-01,1409,122,1287,158,2
Asthma,Srinagar,Chandigarh,2024-11-01,78,0,78,82,7
Asthma,Srinagar,Chandigarh,2024-12-01,3328,56,3272,87,6
Asthma,Srinagar,Chandigarh,2025-01-01,4989,320,4669,46,6
Asthma,Srinagar,Chandigarh,2025-02-01,2796,45,2751,68,7
Asthma,Srinagar,Chandigarh,2025-03-01,697,10,687,139,5
Asthma,Srinagar,Chandigarh,2025-04-01,1735,93,1642,145,5
Asthma,Srinagar,Chandigarh,2025-05-01,1982,38,1944,118,7
Asthma,Srinagar,Chandigarh,2025-06-01,1232,56,1176,81,7
Asthma,Srinagar,Chandigarh,2025-07-01,3751,111,3640,50,8
Asthma,Srinagar,Chandigarh,2025-08-01,3684,92,3592,109,5
Asthma,Srinagar,Chandigarh,2025-09-01,1047,0,1047,88,2
Asthma,Srinagar,Chandigarh,2025-10-01,3570,193,3377,117,6
Asthma,Srinagar,Chandigarh,2025-11-01,4646,63,4583,90,3
Asthma,Srinagar,Chandigarh,2025-12-01,4989,225,4764,91,7
Asthma,Srinagar,Himachal Pradesh,2018-01-01,4989,175,4814,114,6
Asthma,Srinagar,Himachal Pradesh,2018-02-01,1387,61,1326,124,5
Asthma,Srinagar,Himachal Pradesh,2018-03-01,4989,228,4761,169,4
Asthma,Srinagar,Himachal Pradesh,2018-04-01,2122,118,2004,89,8
Asthma,Srinagar,Himachal Pradesh,2018-05-01,1803,52,1751,134,8
Asthma,Srinagar,Himachal Pradesh,2018-06-01,3036,261,2775,198,3
Asthma,Srinagar,Himachal Pradesh,2018-07-01,1817,0,1817,135,1
Asthma,Srinagar,Himachal Pradesh,2018-08-01,3133,136,2997,166,5
Asthma,Srinagar,Himachal Pradesh,2018-09-01,827,61,766,75,8
Asthma,Srinagar,Himachal Pradesh,2018-10-01,2277,145,2132,70,1
Asthma,Srinagar,Himachal Pradesh,2018-11-01,4322,93,4229,98,6
Asthma,Srinagar,Himachal Pradesh,2018-12-01,2521,66,2455,104,2
Asthma,Srinagar,Himachal Pradesh,2019-01-01,2787,57,2730,161,2
Asthma,Srinagar,Himachal Pradesh,2019-02-01,3235,218,3017,69,8
Asthma,Srinagar,Himachal Pradesh,2019-03-01,4168,118,4050,102,7
Asthma,Srinagar,Himachal Pradesh,2019-04-01,377,21,356,161,4
Asthma,Srinagar,Himachal Pradesh,2019-05-01,3382,195,3187,117,7
Asthma,Srinagar,Himachal Pradesh,2019-06-01,2238,266,1972,106,7
Asthma,Srinagar,Himachal Pradesh,2019-07-01,2821,166,2655,118,1
Asthma,Srinagar,Himachal Pradesh,2019-08-01,4019,106,3913,49,5
Asthma,Srinagar,Himachal Pradesh,2019-09-01,995,7,988,48,9
Asthma,Srinagar,Himachal Pradesh,2019-10-01,1239,52,1187,25,6
Asthma,Srinagar,Himachal Pradesh,2019-11-01,78,0,78,117,1
Asthma,Srinagar,Himachal Pradesh,2019-12-01,1861,0,1861,153,2
Asthma,Srinagar,Himachal Pradesh,2020-01-01,4382,128,4254,145,8
Asthma,Srinagar,Himachal Pradesh,2020-02-01,2436,143,2293,164,3
Asthma,Srinagar,Himachal Pradesh,2020-03-01,800,27,773,180,8
Asthma,Srinagar,Himachal Pradesh,2020-04-01,1946,152,1794,114,10
Asthma,Srinagar,Himachal Pradesh,2020-05-01,601,2,599,103,4
Asthma,Srinagar,Himachal Pradesh,2020-06-01,1088,75,1013,181,3
Asthma,Srinagar,Himachal Pradesh,2020-07-01,3119,239,2880,70,2
Asthma,Srinagar,Himachal Pradesh,2020-08-01,1023,79,944,46,7
Asthma,Srinagar,Himachal Pradesh,2020-09-01,4090,18,4072,89,3
Asthma,Srinagar,Himachal Pradesh,2020-10-01,2502,148,2354,83,4
Asthma,Srinagar,Himachal Pradesh,2020-11-01,2712,83,2629,109,2
Asthma,Srinagar,Himachal Pradesh,2020-12-01,2224,20,2204,63,4
Asthma,Srinagar,Himachal Pradesh,2021-01-01,3634,138,3496,125,3
Asthma,Srinagar,Himachal Pradesh,2021-02-01,3648,86,3562,77,1
Asthma,Srinagar,Himachal Pradesh,2021-03-01,3047,234,2813,169,2
Asthma,Srinagar,Himachal Pradesh,2021-04-01,3355,218,3137,45,7
Asthma,Srinagar,Himachal Pradesh,2021-05-01,2313,38,2275,99,9
Asthma,Srinagar,Himachal Pradesh,2021-06-01,3325,96,3229,89,5
Asthma,Srinagar,Himachal Pradesh,2021-07-01,2144,83,2061,118,5
Asthma,Srinagar,Himachal Pradesh,2021-08-01,2600,124,2476,153,6
Asthma,Srinagar,Himachal Pradesh,2021-09-01,2229,176,2053,120,10
Asthma,Srinagar,Himachal Pradesh,2021-10-01,1984,139,1845,100,2
Asthma,Srinagar,Himachal Pradesh,2021-11-01,1673,86,1587,141,1
Asthma,Srinagar,Himachal Pradesh,2021-12-01,3225,137,3088,149,5
Asthma,Srinagar,Himachal Pradesh,2022-01-01,4356,0,4356,120,6
Asthma,Srinagar,Himachal Pradesh,2022-02-01,4168,365,3803,126,5
Asthma,Srinagar,Himachal Pradesh,2022-03-01,912,33,879,139,1
Asthma,Srinagar,Himachal Pradesh,2022-04-01,4327,412,3915,22,7
Asthma,Srinagar,Himachal Pradesh,2022-05-01,2171,121,2050,88,4
Asthma,Srinagar,Himachal Pradesh,2022-06-01,3403,370,3033,125,6
Asthma,Srinagar,Himachal Pradesh,2022-07-01,1382,93,1289,91,9
Asthma,Srinagar,Himachal Pradesh,2022-08-01,2788,23,2765,92,1
Asthma,Srinagar,Himachal Pradesh,2022-09-01,3018,97,2921,125,1
Asthma,Srinagar,Himachal Pradesh,2022-10-01,606,27,579,126,6
Asthma,Srinagar,Himachal Pradesh,2022-11-01,3413,84,3329,130,1
Asthma,Srinagar,Himachal Pradesh,2022-12-01,4403,172,4231,66,4
Asthma,Srinagar,Himachal Pradesh,2023-01-01,2363,24,2339,34,3
Asthma,Srinagar,Himachal Pradesh,2023-02-01,4422,222,4200,147,6
Asthma,Srinagar,Himachal Pradesh,2023-03-01,2343,133,2210,68,3
Asthma,Srinagar,Himachal Pradesh,2023-04-01,3737,77,3660,65,6
Asthma,Srinagar,Himachal Pradesh,2023-05-01,78,0,78,60,2
Asthma,Srinagar,Himachal Pradesh,2023-06-01,4989,259,4730,165,1
Asthma,Srinagar,Himachal Pradesh,2023-07-01,4604,121,4483,117,5
Asthma,Srinagar,Himachal Pradesh,2023-08-01,2216,5,2211,124,5
Asthma,Srinagar,Himachal Pradesh,2023-09-01,78,0,78,141,6
Asthma,Srinagar,Himachal Pradesh,2023-10-01,2984,126,2858,104,9
Asthma,Srinagar,Himachal Pradesh,2023-11-01,660,48,612,158,9
Asthma,Srinagar,Himachal Pradesh,2023-12-01,3194,146,3048,45,6
Asthma,Srinagar,Himachal Pradesh,2024-01-01,3150,48,3102,51,7
Asthma,Srinagar,Himachal Pradesh,2024-02-01,1335,131,1204,48,6
Asthma,Srinagar,Himachal Pradesh,2024-03-01,4101,257,3844,128,8
Asthma,Srinagar,Himachal Pradesh,2024-04-01,3678,156,3522,132,6
Asthma,Srinagar,Himachal Pradesh,2024-05-01,3906,214,3692,82,3
Asthma,Srinagar,Himachal Pradesh,2024-06-01,2609,166,2443,94,3
Asthma,Srinagar,Himachal Pradesh,2024-07-01,698,5,693,171,8
Asthma,Srinagar,Himachal Pradesh,2024-08-01,3909,213,3696,71,4
Asthma,Srinagar,Himachal Pradesh,2024-09-01,2235,82,2153,121,10
Asthma,Srinagar,Himachal Pradesh,2024-10-01,733,47,686,71,2
Asthma,Srinagar,Himachal Pradesh,2024-11-01,4411,125,4286,162,8
Asthma,Srinagar,Himachal Pradesh,2024-12-01,4989,162,4827,138,4
Asthma,Srinagar,Himachal Pradesh,2025-01-01,2542,250,2292,35,6
Asthma,Srinagar,Himachal Pradesh,2025-02-01,4989,428,4561,93,1
Asthma,Srinagar,Himachal Pradesh,2025-03-01,2720,0,2720,11,1
Asthma,Srinagar,Himachal Pradesh,2025-04-01,2087,174,1913,152,9
Asthma,Srinagar,Himachal Pradesh,2025-05-01,1752,83,1669,200,4
Asthma,Srinagar,Himachal Pradesh,2025-06-01,4794,141,4653,11,8
Asthma,Srinagar,Himachal Pradesh,2025-07-01,1551,32,1519,34,3
Asthma,Srinagar,Himachal Pradesh,2025-08-01,3584,80,3504,115,8
Asthma,Srinagar,Himachal Pradesh,2025-09-01,1847,55,1792,105,4
Asthma,Srinagar,Himachal Pradesh,2025-10-01,1980,34,1946,85,1
Asthma,Srinagar,Himachal Pradesh,2025-11-01,3979,42,3937,18,7
Asthma,Srinagar,Himachal Pradesh,2025-12-01,2088,41,2047,123,8
Asthma,Srinagar,Jammu & Kashmir,2018-01-01,2054,122,1932,151,7
Asthma,Srinagar,Jammu & Kashmir,2018-02-01,4117,212,3905,200,4
Asthma,Srinagar,Jammu & Kashmir,2018-03-01,4740,314,4426,173,1
Asthma,Srinagar,Jammu & Kashmir,2018-04-01,3462,166,3296,40,2
Asthma,Srinagar,Jammu & Kashmir,2018-05-01,1719,20,1699,106,3
Asthma,Srinagar,Jammu & Kashmir,2018-06-01,1912,123,1789,136,4
Asthma,Srinagar,Jammu & Kashmir,2018-07-01,2705,56,2649,71,8
Asthma,Srinagar,Jammu & Kashmir,2018-08-01,3028,208,2820,146,4
Asthma,Srinagar,Jammu & Kashmir,2018-09-01,1272,20,1252,142,1
Asthma,Srinagar,Jammu & Kashmir,2018-10-01,3567,107,3460,169,1
Asthma,Srinagar,Jammu & Kashmir,2018-11-01,2712,107,2605,147,3
Asthma,Srinagar,Jammu & Kashmir,2018-12-01,296,20,276,121,3
Asthma,Srinagar,Jammu & Kashmir,2019-01-01,1351,74,1277,74,6
Asthma,Srinagar,Jammu & Kashmir,2019-02-01,1921,97,1824,40,1
Asthma,Srinagar,Jammu & Kashmir,2019-03-01,2500,262,2238,117,1
Asthma,Srinagar,Jammu & Kashmir,2019-04-01,4989,20,4969,86,6
Asthma,Srinagar,Jammu & Kashmir,2019-05-01,2917,57,2860,91,9
Asthma,Srinagar,Jammu & Kashmir,2019-06-01,1470,27,1443,163,1
Asthma,Srinagar,Jammu & Kashmir,2019-07-01,2893,0,2893,176,3
Asthma,Srinagar,Jammu & Kashmir,2019-08-01,2125,61,2064,43,8
Asthma,Srinagar,Jammu & Kashmir,2019-09-01,3033,212,2821,95,8
Asthma,Srinagar,Jammu & Kashmir,2019-10-01,3376,110,3266,84,2
Asthma,Srinagar,Jammu & Kashmir,2019-11-01,4220,170,4050,122,8
Asthma,Srinagar,Jammu & Kashmir,2019-12-01,2565,0,2565,11,5
Asthma,Srinagar,Jammu & Kashmir,2020-01-01,4796,128,4668,32,7
Asthma,Srinagar,Jammu & Kashmir,2020-02-01,3816,139,3677,100,3
Asthma,Srinagar,Jammu & Kashmir,2020-03-01,1648,113,1535,146,6
Asthma,Srinagar,Jammu & Kashmir,2020-04-01,4989,20,4969,110,1
Asthma,Srinagar,Jammu & Kashmir,2020-05-01,3036,111,2925,140,3
Asthma,Srinagar,Jammu & Kashmir,2020-06-01,1477,120,1357,116,4
Asthma,Srinagar,Jammu & Kashmir,2020-07-01,4815,178,4637,171,5
Asthma,Srinagar,Jammu & Kashmir,2020-08-01,4989,20,4969,182,10
Asthma,Srinagar,Jammu & Kashmir,2020-09-01,2553,222,2331,67,10
Asthma,Srinagar,Jammu & Kashmir,2020-10-01,1922,137,1785,151,4
Asthma,Srinagar,Jammu & Kashmir,2020-11-01,2366,178,2188,132,9
Asthma,Srinagar,Jammu & Kashmir,2020-12-01,3556,0,3556,200,2
Asthma,Srinagar,Jammu & Kashmir,2021-01-01,4312,405,3907,66,6
Asthma,Srinagar,Jammu & Kashmir,2021-02-01,3363,92,3271,100,3
Asthma,Srinagar,Jammu & Kashmir,2021-03-01,2734,96,2638,54,4
Asthma,Srinagar,Jammu & Kashmir,2021-04-01,4607,136,4471,57,10
Asthma,Srinagar,Jammu & Kashmir,2021-05-01,2178,169,2009,126,4
Asthma,Srinagar,Jammu & Kashmir,2021-06-01,3980,178,3802,117,3
Asthma,Srinagar,Jammu & Kashmir,2021-07-01,2211,141,2070,134,2
Asthma,Srinagar,Jammu & Kashmir,2021-08-01,3176,166,3010,133,3
Asthma,Srinagar,Jammu & Kashmir,2021-09-01,2445,115,2330,94,1
Asthma,Srinagar,Jammu & Kashmir,2021-10-01,2522,56,2466,94,5
Asthma,Srinagar,Jammu & Kashmir,2021-11-01,2091,214,1877,57,5
Asthma,Srinagar,Jammu & Kashmir,2021-12-01,4402,32,4370,70,6
Asthma,Srinagar,Jammu & Kashmir,2022-01-01,1614,100,1514,103,5
Asthma,Srinagar,Jammu & Kashmir,2022-02-01,1604,97,1507,116,3
Asthma,Srinagar,Jammu & Kashmir,2022-03-01,4989,417,4572,142,3
Asthma,Srinagar,Jammu & Kashmir,2022-04-01,3909,353,3556,137,5
Asthma,Srinagar,Jammu & Kashmir,2022-05-01,78,0,78,186,5
Asthma,Srinagar,Jammu & Kashmir,2022-06-01,1839,120,1719,57,3
Asthma,Srinagar,Jammu & Kashmir,2022-07-01,167,16,151,94,4
Asthma,Srinagar,Jammu & Kashmir,2022-08-01,1322,63,1259,61,9
Asthma,Srinagar,Jammu & Kashmir,2022-09-01,78,0,78,171,10
Asthma,Srinagar,Jammu & Kashmir,2022-10-01,2414,93,2321,81,4
Asthma,Srinagar,Jammu & Kashmir,2022-11-01,1065,12,1053,165,3
Asthma,Srinagar,Jammu & Kashmir,2022-12-01,2678,163,2515,180,5
Asthma,Srinagar,Jammu & Kashmir,2023-01-01,417,33,384,127,8
Asthma,Srinagar,Jammu & Kashmir,2023-02-01,2709,126,2583,121,5
Asthma,Srinagar,Jammu & Kashmir,2023-03-01,2041,5,2036,108,6
Asthma,Srinagar,Jammu & Kashmir,2023-04-01,4612,368,4244,90,3
Asthma,Srinagar,Jammu & Kashmir,2023-05-01,4491,0,4491,84,1
Asthma,Srinagar,Jammu & Kashmir,2023-06-01,3651,18,3633,99,7
Asthma,Srinagar,Jammu & Kashmir,2023-07-01,2159,96,2063,199,5
Asthma,Srinagar,Jammu & Kashmir,2023-08-01,4989,286,4703,53,7
Asthma,Srinagar,Jammu & Kashmir,2023-09-01,514,32,482,117,1
Asthma,Srinagar,Jammu & Kashmir,2023-10-01,715,34,681,142,10
Asthma,Srinagar,Jammu & Kashmir,2023-11-01,2485,251,2234,92,6
Asthma,Srinagar,Jammu & Kashmir,2023-12-01,4989,259,4730,127,1
Asthma,Srinagar,Jammu & Kashmir,2024-01-01,2326,186,2140,30,8
Asthma,Srinagar,Jammu & Kashmir,2024-02-01,2352,171,2181,174,4
Asthma,Srinagar,Jammu & Kashmir,2024-03-01,663,8,655,164,5
Asthma,Srinagar,Jammu & Kashmir,2024-04-01,3866,174,3692,101,3
Asthma,Srinagar,Jammu & Kashmir,2024-05-01,3876,433,3443,61,5
Asthma,Srinagar,Jammu & Kashmir,2024-06-01,3656,129,3527,147,5
Asthma,Srinagar,Jammu & Kashmir,2024-07-01,1753,53,1700,48,1
Asthma,Srinagar,Jammu & Kashmir,2024-08-01,1649,90,1559,55,7
Asthma,Srinagar,Jammu & Kashmir,2024-09-01,863,31,832,103,5
Asthma,Srinagar,Jammu & Kashmir,2024-10-01,2710,73,2637,184,6
Asthma,Srinagar,Jammu & Kashmir,2024-11-01,1148,41,1107,139,7
Asthma,Srinagar,Jammu & Kashmir,2024-12-01,1018,93,925,73,5
Asthma,Srinagar,Jammu & Kashmir,2025-01-01,2029,93,1936,21,6
Asthma,Srinagar,Jammu & Kashmir,2025-02-01,1941,22,1919,108,1
Asthma,Srinagar,Jammu & Kashmir,2025-03-01,1876,11,1865,119,2
Asthma,Srinagar,Jammu & Kashmir,2025-04-01,3223,368,2855,103,5
Asthma,Srinagar,Jammu & Kashmir,2025-05-01,2703,117,2586,198,5
Asthma,Srinagar,Jammu & Kashmir,2025-06-01,2211,138,2073,99,6
Asthma,Srinagar,Jammu & Kashmir,2025-07-01,2843,78,2765,11,9
Asthma,Srinagar,Jammu & Kashmir,2025-08-01,1267,75,1192,85,5
Asthma,Srinagar,Jammu & Kashmir,2025-09-01,2739,253,2486,129,6
Asthma,Srinagar,Jammu & Kashmir,2025-10-01,2799,87,2712,126,5
Asthma,Srinagar,Jammu & Kashmir,2025-11-01,581,36,545,97,4
Asthma,Srinagar,Jammu & Kashmir,2025-12-01,3933,36,3897,89,4
Asthma,Srinagar,Haryana,2018-01-01,1415,154,1261,11,3
Asthma,Srinagar,Haryana,2018-02-01,2719,157,2562,111,4
Asthma,Srinagar,Haryana,2018-03-01,4159,158,4001,89,4
Asthma,Srinagar,Haryana,2018-04-01,3839,158,3681,119,4
Asthma,Srinagar,Haryana,2018-05-01,2643,93,2550,131,1
Asthma,Srinagar,Haryana,2018-06-01,2111,77,2034,169,5
Asthma,Srinagar,Haryana,2018-07-01,3868,0,3868,58,2
Asthma,Srinagar,Haryana,2018-08-01,3503,165,3338,40,5
Asthma,Srinagar,Haryana,2018-09-01,1768,81,1687,77,2
Asthma,Srinagar,Haryana,2018-10-01,1531,98,1433,69,5
Asthma,Srinagar,Haryana,2018-11-01,78,0,78,64,4
Asthma,Srinagar,Haryana,2018-12-01,2804,77,2727,180,3
Asthma,Srinagar,Haryana,2019-01-01,2486,123,2363,114,6
Asthma,Srinagar,Haryana,2019-02-01,4122,12,4110,200,6
Asthma,Srinagar,Haryana,2019-03-01,3079,167,2912,106,5
Asthma,Srinagar,Haryana,2019-04-01,4387,0,4387,47,6
Asthma,Srinagar,Haryana,2019-05-01,1662,137,1525,65,4
Asthma,Srinagar,Haryana,2019-06-01,4124,288,3836,158,6
Asthma,Srinagar,Haryana,2019-07-01,1888,43,1845,48,5
Asthma,Srinagar,Haryana,2019-08-01,3641,252,3389,135,2
Asthma,Srinagar,Haryana,2019-09-01,640,34,606,88,2
Asthma,Srinagar,Haryana,2019-10-01,2913,60,2853,59,8
Asthma,Srinagar,Haryana,2019-11-01,78,0,78,177,9
Asthma,Srinagar,Haryana,2019-12-01,2239,132,2107,76,7
Asthma,Srinagar,Haryana,2020-01-01,3188,85,3103,64,3
Asthma,Srinagar,Haryana,2020-02-01,1899,155,1744,102,9
Asthma,Srinagar,Haryana,2020-03-01,1188,59,1129,80,7
Asthma,Srinagar,Haryana,2020-04-01,3732,110,3622,200,6
Asthma,Srinagar,Haryana,2020-05-01,2459,251,2208,160,10
Asthma,Srinagar,Haryana,2020-06-01,1941,129,1812,76,2
Asthma,Srinagar,Haryana,2020-07-01,2654,0,2654,82,7
Asthma,Srinagar,Haryana,2020-08-01,4989,179,4810,11,2
Asthma,Srinagar,Haryana,2020-09-01,4145,40,4105,113,3
Asthma,Srinagar,Haryana,2020-10-01,4157,111,4046,68,10
Asthma,Srinagar,Haryana,2020-11-01,3182,145,3037,111,6
Asthma,Srinagar,Haryana,2020-12-01,2821,170,2651,11,10
Asthma,Srinagar,Haryana,2021-01-01,78,0,78,105,6
Asthma,Srinagar,Haryana,2021-02-01,1687,137,1550,193,6
Asthma,Srinagar,Haryana,2021-03-01,1953,133,1820,109,3
Asthma,Srinagar,Haryana,2021-04-01,82,4,78,67,8
Asthma,Srinagar,Haryana,2021-05-01,1045,58,987,105,5
Asthma,Srinagar,Haryana,2021-06-01,78,0,78,103,5
Asthma,Srinagar,Haryana,2021-07-01,2546,104,2442,200,4
Asthma,Srinagar,Haryana,2021-08-01,3696,153,3543,89,5
Asthma,Srinagar,Haryana,2021-09-01,4082,0,4082,45,5
Asthma,Srinagar,Haryana,2021-10-01,3154,254,2900,107,5
Asthma,Srinagar,Haryana,2021-11-01,1305,62,1243,116,5
Asthma,Srinagar,Haryana,2021-12-01,78,0,78,135,1
Asthma,Srinagar,Haryana,2022-01-01,241,9,232,145,6
Asthma,Srinagar,Haryana,2022-02-01,895,47,848,200,4
Asthma,Srinagar,Haryana,2022-03-01,1405,92,1313,76,1
Asthma,Srinagar,Haryana,2022-04-01,2383,42,2341,71,1
Asthma,Srinagar,Haryana,2022-05-01,1237,74,1163,12,3
Asthma,Srinagar,Haryana,2022-06-01,3052,155,2897,140,9
Asthma,Srinagar,Haryana,2022-07-01,2286,94,2192,61,7
Asthma,Srinagar,Haryana,2022-08-01,2612,219,2393,152,3
Asthma,Srinagar,Haryana,2022-09-01,4127,98,4029,81,4
Asthma,Srinagar,Haryana,2022-10-01,1014,58,956,194,8
Asthma,Srinagar,Haryana,2022-11-01,3159,291,2868,33,3
Asthma,Srinagar,Haryana,2022-12-01,2579,76,2503,158,2
Asthma,Srinagar,Haryana,2023-01-01,2150,89,2061,152,7
Asthma,Srinagar,Haryana,2023-02-01,3785,442,3343,133,8
Asthma,Srinagar,Haryana,2023-03-01,3777,241,3536,49,3
Asthma,Srinagar,Haryana,2023-04-01,1328,46,1282,133,6
Asthma,Srinagar,Haryana,2023-05-01,2353,172,2181,113,5
Asthma,Srinagar,Haryana,2023-06-01,2975,99,2876,13,3
Asthma,Srinagar,Haryana,2023-07-01,2231,10,2221,186,8
Asthma,Srinagar,Haryana,2023-08-01,3382,304,3078,89,3
Asthma,Srinagar,Haryana,2023-09-01,2975,53,2922,182,7
Asthma,Srinagar,Haryana,2023-10-01,4989,442,4547,103,5
Asthma,Srinagar,Haryana,2023-11-01,545,19,526,156,4
Asthma,Srinagar,Haryana,2023-12-01,2433,272,2161,62,3
Asthma,Srinagar,Haryana,2024-01-01,1379,14,1365,117,2
Asthma,Srinagar,Haryana,2024-02-01,3408,272,3136,114,4
Asthma,Srinagar,Haryana,2024-03-01,428,27,401,90,3
Asthma,Srinagar,Haryana,2024-04-01,3062,227,2835,62,5
Asthma,Srinagar,Haryana,2024-05-01,1752,137,1615,11,1
Asthma,Srinagar,Haryana,2024-06-01,1613,57,1556,63,4
Asthma,Srinagar,Haryana,2024-07-01,657,7,650,142,6
Asthma,Srinagar,Haryana,2024-08-01,1974,95,1879,35,3
Asthma,Srinagar,Haryana,2024-09-01,4052,229,3823,46,7
Asthma,Srinagar,Haryana,2024-10-01,2564,93,2471,33,7
Asthma,Srinagar,Haryana,2024-11-01,3439,199,3240,117,1
Asthma,Srinagar,Haryana,2024-12-01,4831,288,4543,61,3
Asthma,Srinagar,Haryana,2025-01-01,2951,69,2882,168,1
Asthma,Srinagar,Haryana,2025-02-01,1848,113,1735,144,6
Asthma,Srinagar,Haryana,2025-03-01,3224,136,3088,116,5
Asthma,Srinagar,Haryana,2025-04-01,1867,55,1812,122,1
Asthma,Srinagar,Haryana,2025-05-01,1921,140,1781,67,3
Asthma,Srinagar,Haryana,2025-06-01,558,15,543,67,6
Asthma,Srinagar,Haryana,2025-07-01,3840,141,3699,142,5
Asthma,Srinagar,Haryana,2025-08-01,2080,108,1972,153,8
Asthma,Srinagar,Haryana,2025-09-01,2842,255,2587,142,1
Asthma,Srinagar,Haryana,2025-10-01,1208,67,1141,82,5
Asthma,Srinagar,Haryana,2025-11-01,3182,208,2974,86,2
Asthma,Srinagar,Haryana,2025-12-01,1575,65,1510,59,5
Asthma,Gurugram,Punjab,2018-01-01,2407,115,2292,145,4
Asthma,Gurugram,Punjab,2018-02-01,3775,183,3592,11,6
Asthma,Gurugram,Punjab,2018-03-01,3658,214,3444,11,4
Asthma,Gurugram,Punjab,2018-04-01,2568,106,2462,11,7
Asthma,Gurugram,Punjab,2018-05-01,225,20,205,11,3
Asthma,Gurugram,Punjab,2018-06-01,4989,195,4794,175,2
Asthma,Gurugram,Punjab,2018-07-01,4939,1,4938,146,5
Asthma,Gurugram,Punjab,2018-08-01,3567,442,3125,45,10
Asthma,Gurugram,Punjab,2018-09-01,1587,64,1523,101,1
Asthma,Gurugram,Punjab,2018-10-01,2445,215,2230,181,1
Asthma,Gurugram,Punjab,2018-11-01,1868,169,1699,132,5
Asthma,Gurugram,Punjab,2018-12-01,4293,333,3960,200,8
Asthma,Gurugram,Punjab,2019-01-01,2950,130,2820,100,6
Asthma,Gurugram,Punjab,2019-02-01,1545,90,1455,73,3
Asthma,Gurugram,Punjab,2019-03-01,1966,25,1941,51,6
Asthma,Gurugram,Punjab,2019-04-01,4101,442,3659,107,6
Asthma,Gurugram,Punjab,2019-05-01,4744,119,4625,154,3
Asthma,Gurugram,Punjab,2019-06-01,4648,198,4450,111,7
Asthma,Gurugram,Punjab,2019-07-01,3613,191,3422,88,5
Asthma,Gurugram,Punjab,2019-08-01,2259,106,2153,170,1
Asthma,Gurugram,Punjab,2019-09-01,78,0,78,133,4
Asthma,Gurugram,Punjab,2019-10-01,2996,271,2725,100,3
Asthma,Gurugram,Punjab,2019-11-01,2595,201,2394,67,9
Asthma,Gurugram,Punjab,2019-12-01,2785,165,2620,93,1
Asthma,Gurugram,Punjab,2020-01-01,2670,102,2568,130,3
Asthma,Gurugram,Punjab,2020-02-01,818,66,752,66,6
Asthma,Gurugram,Punjab,2020-03-01,3345,122,3223,43,10
Asthma,Gurugram,Punjab,2020-04-01,3446,330,3116,82,10
Asthma,Gurugram,Punjab,2020-05-01,3513,187,3326,104,5
Asthma,Gurugram,Punjab,2020-06-01,3867,332,3535,176,6
Asthma,Gurugram,Punjab,2020-07-01,3408,159,3249,47,7
Asthma,Gurugram,Punjab,2020-08-01,2047,106,1941,118,2
Asthma,Gurugram,Punjab,2020-09-01,2502,214,2288,92,5
Asthma,Gurugram,Punjab,2020-10-01,2720,309,2411,95,9
Asthma,Gurugram,Punjab,2020-11-01,2742,261,2481,185,5
Asthma,Gurugram,Punjab,2020-12-01,3937,297,3640,110,10
Asthma,Gurugram,Punjab,2021-01-01,3461,232,3229,60,4
Asthma,Gurugram,Punjab,2021-02-01,4989,176,4813,151,5
Asthma,Gurugram,Punjab,2021-03-01,4989,292,4697,148,5
Asthma,Gurugram,Punjab,2021-04-01,2704,63,2641,55,1
Asthma,Gurugram,Punjab,2021-05-01,78,0,78,45,8
Asthma,Gurugram,Punjab,2021-06-01,4257,267,3990,127,4
Asthma,Gurugram,Punjab,2021-07-01,1872,0,1872,105,6
Asthma,Gurugram,Punjab,2021-08-01,1522,77,1445,82,3
Asthma,Gurugram,Punjab,2021-09-01,2063,128,1935,160,10
Asthma,Gurugram,Punjab,2021-10-01,1998,95,1903,76,8
Asthma,Gurugram,Punjab,2021-11-01,3419,206,3213,128,5
Asthma,Gurugram,Punjab,2021-12-01,505,5,500,166,1
Asthma,Gurugram,Punjab,2022-01-01,1152,31,1121,89,7
Asthma,Gurugram,Punjab,2022-02-01,3058,245,2813,13,8
Asthma,Gurugram,Punjab,2022-03-01,3433,171,3262,86,2
Asthma,Gurugram,Punjab,2022-04-01,3458,207,3251,116,4
Asthma,Gurugram,Punjab,2022-05-01,1542,52,1490,157,5
Asthma,Gurugram,Punjab,2022-06-01,1285,65,1220,80,8
Asthma,Gurugram,Punjab,2022-07-01,1918,0,1918,194,4
Asthma,Gurugram,Punjab,2022-08-01,2919,218,2701,40,8
Asthma,Gurugram,Punjab,2022-09-01,4590,442,4148,115,3
Asthma,Gurugram,Punjab,2022-10-01,78,0,78,94,2
Asthma,Gurugram,Punjab,2022-11-01,2301,52,2249,175,10
Asthma,Gurugram,Punjab,2022-12-01,810,50,760,31,1
Asthma,Gurugram,Punjab,2023-01-01,381,35,346,128,3
Asthma,Gurugram,Punjab,2023-02-01,3895,194,3701,94,7
Asthma,Gurugram,Punjab,2023-03-01,3328,47,3281,184,3
Asthma,Gurugram,Punjab,2023-04-01,3200,140,3060,64,3
Asthma,Gurugram,Punjab,2023-05-01,3833,77,3756,127,4
Asthma,Gurugram,Punjab,2023-06-01,1954,59,1895,64,1
Asthma,Gurugram,Punjab,2023-07-01,2017,83,1934,116,8
Asthma,Gurugram,Punjab,2023-08-01,4989,114,4875,87,5
Asthma,Gurugram,Punjab,2023-09-01,2267,62,2205,87,2
Asthma,Gurugram,Punjab,2023-10-01,3584,187,3397,11,1
Asthma,Gurugram,Punjab,2023-11-01,2606,146,2460,127,1
Asthma,Gurugram,Punjab,2023-12-01,118,1,117,51,1
Asthma,Gurugram,Punjab,2024-01-01,78,0,78,49,5
Asthma,Gurugram,Punjab,2024-02-01,1821,70,1751,27,6
Asthma,Gurugram,Punjab,2024-03-01,4014,285,3729,52,7
Asthma,Gurugram,Punjab,2024-04-01,3655,266,3389,132,7
Asthma,Gurugram,Punjab,2024-05-01,3824,130,3694,129,7
Asthma,Gurugram,Punjab,2024-06-01,1273,86,1187,140,9
Asthma,Gurugram,Punjab,2024-07-01,4765,122,4643,54,8
Asthma,Gurugram,Punjab,2024-08-01,1303,115,1188,117,8
Asthma,Gurugram,Punjab,2024-09-01,2883,77,2806,75,6
Asthma,Gurugram,Punjab,2024-10-01,2584,155,2429,155,7
Asthma,Gurugram,Punjab,2024-11-01,2364,105,2259,128,4
Asthma,Gurugram,Punjab,2024-12-01,4393,89,4304,73,4
Asthma,Gurugram,Punjab,2025-01-01,1651,125,1526,159,10
Asthma,Gurugram,Punjab,2025-02-01,787,25,762,132,3
Asthma,Gurugram,Punjab,2025-03-01,2624,1,2623,36,3
Asthma,Gurugram,Punjab,2025-04-01,2061,0,2061,21,4
Asthma,Gurugram,Punjab,2025-05-01,4989,122,4867,38,3
Asthma,Gurugram,Punjab,2025-06-01,3505,315,3190,190,3
Asthma,Gurugram,Punjab,2025-07-01,2048,177,1871,54,6
Asthma,Gurugram,Punjab,2025-08-01,1181,34,1147,200,6
Asthma,Gurugram,Punjab,2025-09-01,78,0,78,52,7
Asthma,Gurugram,Punjab,2025-10-01,1222,44,1178,46,10
Asthma,Gurugram,Punjab,2025-11-01,2752,30,2722,151,4
Asthma,Gurugram,Punjab,2025-12-01,4512,101,4411,153,5
Asthma,Gurugram,Chandigarh,2018-01-01,4102,322,3780,135,1
Asthma,Gurugram,Chandigarh,2018-02-01,2905,188,2717,141,1
Asthma,Gurugram,Chandigarh,2018-03-01,2164,125,2039,65,4
Asthma,Gurugram,Chandigarh,2018-04-01,2958,33,2925,149,6
Asthma,Gurugram,Chandigarh,2018-05-01,1902,100,1802,118,6
Asthma,Gurugram,Chandigarh,2018-06-01,4903,0,4903,88,7
Asthma,Gurugram,Chandigarh,2018-07-01,2344,174,2170,111,8
Asthma,Gurugram,Chandigarh,2018-08-01,2482,142,2340,160,10
Asthma,Gurugram,Chandigarh,2018-09-01,78,0,78,126,4
Asthma,Gurugram,Chandigarh,2018-10-01,2335,226,2109,11,2
Asthma,Gurugram,Chandigarh,2018-11-01,3720,0,3720,152,7
Asthma,Gurugram,Chandigarh,2018-12-01,1165,76,1089,148,8
Asthma,Gurugram,Chandigarh,2019-01-01,1590,105,1485,87,5
Asthma,Gurugram,Chandigarh,2019-02-01,3661,51,3610,112,4
Asthma,Gurugram,Chandigarh,2019-03-01,616,30,586,112,3
Asthma,Gurugram,Chandigarh,2019-04-01,4016,9,4007,11,5
Asthma,Gurugram,Chandigarh,2019-05-01,1884,0,1884,86,7
Asthma,Gurugram,Chandigarh,2019-06-01,2076,39,2037,88,3
Asthma,Gurugram,Chandigarh,2019-07-01,1090,35,1055,98,2
Asthma,Gurugram,Chandigarh,2019-08-01,3105,213,2892,79,7
Asthma,Gurugram,Chandigarh,2019-09-01,4989,259,4730,140,2
Asthma,Gurugram,Chandigarh,2019-10-01,3646,192,3454,65,5
Asthma,Gurugram,Chandigarh,2019-11-01,1438,29,1409,153,5
Asthma,Gurugram,Chandigarh,2019-12-01,4121,142,3979,138,5
Asthma,Gurugram,Chandigarh,2020-01-01,2173,49,2124,176,3
Asthma,Gurugram,Chandigarh,2020-02-01,4441,64,4377,195,10
Asthma,Gurugram,Chandigarh,2020-03-01,3680,120,3560,195,6
Asthma,Gurugram,Chandigarh,2020-04-01,78,0,78,46,3
Asthma,Gurugram,Chandigarh,2020-05-01,1250,41,1209,124,6
Asthma,Gurugram,Chandigarh,2020-06-01,3864,157,3707,70,10
Asthma,Gurugram,Chandigarh,2020-07-01,2801,196,2605,200,5
Asthma,Gurugram,Chandigarh,2020-08-01,1224,43,1181,137,9
Asthma,Gurugram,Chandigarh,2020-09-01,1747,19,1728,178,1
Asthma,Gurugram,Chandigarh,2020-10-01,78,0,78,128,2
Asthma,Gurugram,Chandigarh,2020-11-01,2479,143,2336,11,1
Asthma,Gurugram,Chandigarh,2020-12-01,4989,297,4692,66,10
Asthma,Gurugram,Chandigarh,2021-01-01,3677,251,3426,71,1
Asthma,Gurugram,Chandigarh,2021-02-01,4989,316,4673,86,5
Asthma,Gurugram,Chandigarh,2021-03-01,3781,192,3589,125,10
Asthma,Gurugram,Chandigarh,2021-04-01,3976,442,3534,132,8
Asthma,Gurugram,Chandigarh,2021-05-01,4989,63,4926,11,6
Asthma,Gurugram,Chandigarh,2021-06-01,3104,102,3002,94,9
Asthma,Gurugram,Chandigarh,2021-07-01,2346,183,2163,81,3
Asthma,Gurugram,Chandigarh,2021-08-01,3983,215,3768,177,6
Asthma,Gurugram,Chandigarh,2021-09-01,4548,328,4220,136,4
Asthma,Gurugram,Chandigarh,2021-10-01,1954,107,1847,97,4
Asthma,Gurugram,Chandigarh,2021-11-01,1629,146,1483,118,5
Asthma,Gurugram,Chandigarh,2021-12-01,2784,57,2727,20,8
Asthma,Gurugram,Chandigarh,2022-01-01,3713,330,3383,140,9
Asthma,Gurugram,Chandigarh,2022-02-01,3668,308,3360,86,4
Asthma,Gurugram,Chandigarh,2022-03-01,687,10,677,65,2
Asthma,Gurugram,Chandigarh,2022-04-01,4989,341,4648,173,2
Asthma,Gurugram,Chandigarh,2022-05-01,1737,84,1653,120,10
Asthma,Gurugram,Chandigarh,2022-06-01,2242,72,2170,72,9
Asthma,Gurugram,Chandigarh,2022-07-01,1386,0,1386,75,2
Asthma,Gurugram,Chandigarh,2022-08-01,4989,103,4886,125,10
Asthma,Gurugram,Chandigarh,2022-09-01,2922,206,2716,121,3
Asthma,Gurugram,Chandigarh,2022-10-01,1456,107,1349,108,7
Asthma,Gurugram,Chandigarh,2022-11-01,3756,165,3591,45,3
Asthma,Gurugram,Chandigarh,2022-12-01,3629,267,3362,52,10
Asthma,Gurugram,Chandigarh,2023-01-01,2346,182,2164,68,3
Asthma,Gurugram,Chandigarh,2023-02-01,3725,203,3522,96,2
Asthma,Gurugram,Chandigarh,2023-03-01,1490,43,1447,104,3
Asthma,Gurugram,Chandigarh,2023-04-01,1936,121,1815,98,10
Asthma,Gurugram,Chandigarh,2023-05-01,78,0,78,100,6
Asthma,Gurugram,Chandigarh,2023-06-01,821,57,764,200,2
Asthma,Gurugram,Chandigarh,2023-07-01,4989,375,4614,149,3
Asthma,Gurugram,Chandigarh,2023-08-01,4799,50,4749,167,1
Asthma,Gurugram,Chandigarh,2023-09-01,2686,94,2592,130,6
Asthma,Gurugram,Chandigarh,2023-10-01,4828,0,4828,110,1
Asthma,Gurugram,Chandigarh,2023-11-01,2383,171,2212,127,8
Asthma,Gurugram,Chandigarh,2023-12-01,2271,99,2172,118,7
Asthma,Gurugram,Chandigarh,2024-01-01,2673,167,2506,147,5
Asthma,Gurugram,Chandigarh,2024-02-01,2430,17,2413,57,8
Asthma,Gurugram,Chandigarh,2024-03-01,2309,209,2100,143,8
Asthma,Gurugram,Chandigarh,2024-04-01,4131,63,4068,115,5
Asthma,Gurugram,Chandigarh,2024-05-01,2799,203,2596,14,3
Asthma,Gurugram,Chandigarh,2024-06-01,3553,190,3363,111,6
Asthma,Gurugram,Chandigarh,2024-07-01,3981,177,3804,40,6
Asthma,Gurugram,Chandigarh,2024-08-01,3118,131,2987,79,6
Asthma,Gurugram,Chandigarh,2024-09-01,1296,40,1256,98,5
Asthma,Gurugram,Chandigarh,2024-10-01,783,68,715,29,6
Asthma,Gurugram,Chandigarh,2024-11-01,2797,141,2656,103,6
Asthma,Gurugram,Chandigarh,2024-12-01,2368,31,2337,110,9
Asthma,Gurugram,Chandigarh,2025-01-01,2715,105,2610,145,1
Asthma,Gurugram,Chandigarh,2025-02-01,2576,138,2438,83,2
Asthma,Gurugram,Chandigarh,2025-03-01,4989,380,4609,120,5
Asthma,Gurugram,Chandigarh,2025-04-01,813,26,787,101,3
Asthma,Gurugram,Chandigarh,2025-05-01,78,0,78,85,5
Asthma,Gurugram,Chandigarh,2025-06-01,3043,154,2889,21,2
Asthma,Gurugram,Chandigarh,2025-07-01,2092,157,1935,101,2
Asthma,Gurugram,Chandigarh,2025-08-01,3021,30,2991,144,10
Asthma,Gurugram,Chandigarh,2025-09-01,3381,219,3162,59,4
Asthma,Gurugram,Chandigarh,2025-10-01,4320,157,4163,95,1
Asthma,Gurugram,Chandigarh,2025-11-01,575,23,552,103,4
Asthma,Gurugram,Chandigarh,2025-12-01,1851,200,1651,162,8
Asthma,Gurugram,Himachal Pradesh,2018-01-01,3173,140,3033,108,8
Asthma,Gurugram,Himachal Pradesh,2018-02-01,3631,261,3370,121,1
Asthma,Gurugram,Himachal Pradesh,2018-03-01,4989,354,4635,106,3
Asthma,Gurugram,Himachal Pradesh,2018-04-01,3879,61,3818,81,5
Asthma,Gurugram,Himachal Pradesh,2018-05-01,2521,0,2521,48,5
Asthma,Gurugram,Himachal Pradesh,2018-06-01,1403,103,1300,92,1
Asthma,Gurugram,Himachal Pradesh,2018-07-01,1840,34,1806,126,1
Asthma,Gurugram,Himachal Pradesh,2018-08-01,1802,2,1800,112,2
Asthma,Gurugram,Himachal Pradesh,2018-09-01,3476,277,3199,182,1
Asthma,Gurugram,Himachal Pradesh,2018-10-01,2942,60,2882,154,3
Asthma,Gurugram,Himachal Pradesh,2018-11-01,822,22,800,169,8
Asthma,Gurugram,Himachal Pradesh,2018-12-01,2013,216,1797,11,3
Asthma,Gurugram,Himachal Pradesh,2019-01-01,3775,6,3769,187,8
Asthma,Gurugram,Himachal Pradesh,2019-02-01,3069,41,3028,120,5
Asthma,Gurugram,Himachal Pradesh,2019-03-01,3360,123,3237,127,4
Asthma,Gurugram,Himachal Pradesh,2019-04-01,3111,134,2977,152,1
Asthma,Gurugram,Himachal Pradesh,2019-05-01,4779,114,4665,107,8
Asthma,Gurugram,Himachal Pradesh,2019-06-01,2914,47,2867,52,5
Asthma,Gurugram,Himachal Pradesh,2019-07-01,2080,195,1885,180,1
Asthma,Gurugram,Himachal Pradesh,2019-08-01,1369,79,1290,67,6
Asthma,Gurugram,Himachal Pradesh,2019-09-01,2932,196,2736,56,3
Asthma,Gurugram,Himachal Pradesh,2019-10-01,78,0,78,94,5
Asthma,Gurugram,Himachal Pradesh,2019-11-01,2350,137,2213,87,6
Asthma,Gurugram,Himachal Pradesh,2019-12-01,2321,179,2142,106,8
Asthma,Gurugram,Himachal Pradesh,2020-01-01,767,16,751,101,2
Asthma,Gurugram,Himachal Pradesh,2020-02-01,1352,78,1274,175,6
Asthma,Gurugram,Himachal Pradesh,2020-03-01,3684,259,3425,130,9
Asthma,Gurugram,Himachal Pradesh,2020-04-01,2907,276,2631,63,10
Asthma,Gurugram,Himachal Pradesh,2020-05-01,2734,291,2443,70,8
Asthma,Gurugram,Himachal Pradesh,2020-06-01,3008,156,2852,86,6
Asthma,Gurugram,Himachal Pradesh,2020-07-01,2722,226,2496,87,6
Asthma,Gurugram,Himachal Pradesh,2020-08-01,4265,0,4265,80,9
Asthma,Gurugram,Himachal Pradesh,2020-09-01,2763,263,2500,50,4
Asthma,Gurugram,Himachal Pradesh,2020-10-01,641,18,623,121,7
Asthma,Gurugram,Himachal Pradesh,2020-11-01,4784,205,4579,83,10
Asthma,Gurugram,Himachal Pradesh,2020-12-01,3094,194,2900,58,5
Asthma,Gurugram,Himachal Pradesh,2021-01-01,1807,82,1725,131,1
Asthma,Gurugram,Himachal Pradesh,2021-02-01,916,51,865,149,2
Asthma,Gurugram,Himachal Pradesh,2021-03-01,3129,301,2828,94,6
Asthma,Gurugram,Himachal Pradesh,2021-04-01,2440,94,2346,197,2
Asthma,Gurugram,Himachal Pradesh,2021-05-01,4709,86,4623,200,4
Asthma,Gurugram,Himachal Pradesh,2021-06-01,2133,219,1914,132,4
Asthma,Gurugram,Himachal Pradesh,2021-07-01,1474,96,1378,82,6
Asthma,Gurugram,Himachal Pradesh,2021-08-01,3799,402,3397,120,2
Asthma,Gurugram,Himachal Pradesh,2021-09-01,3839,288,3551,44,3
Asthma,Gurugram,Himachal Pradesh,2021-10-01,2824,32,2792,62,9
Asthma,Gurugram,Himachal Pradesh,2021-11-01,3505,241,3264,20,3
Asthma,Gurugram,Himachal Pradesh,2021-12-01,2547,54,2493,74,7
Asthma,Gurugram,Himachal Pradesh,2022-01-01,2911,146,2765,43,5
Asthma,Gurugram,Himachal Pradesh,2022-02-01,4160,199,3961,138,5
Asthma,Gurugram,Himachal Pradesh,2022-03-01,3436,10,3426,68,7
Asthma,Gurugram,Himachal Pradesh,2022-04-01,2370,62,2308,120,1
Asthma,Gurugram,Himachal Pradesh,2022-05-01,4412,442,3970,144,6
Asthma,Gurugram,Himachal Pradesh,2022-06-01,78,0,78,166,6
Asthma,Gurugram,Himachal Pradesh,2022-07-01,4989,224,4765,88,7
Asthma,Gurugram,Himachal Pradesh,2022-08-01,309,31,278,122,4
Asthma,Gurugram,Himachal Pradesh,2022-09-01,1756,67,1689,124,5
Asthma,Gurugram,Himachal Pradesh,2022-10-01,2543,120,2423,171,1
Asthma,Gurugram,Himachal Pradesh,2022-11-01,2401,189,2212,146,3
Asthma,Gurugram,Himachal Pradesh,2022-12-01,3948,151,3797,173,5
Asthma,Gurugram,Himachal Pradesh,2023-01-01,1178,33,1145,21,9
Asthma,Gurugram,Himachal Pradesh,2023-02-01,2947,0,2947,72,10
Asthma,Gurugram,Himachal Pradesh,2023-03-01,1822,41,1781,159,4
Asthma,Gurugram,Himachal Pradesh,2023-04-01,2993,67,2926,136,7
Asthma,Gurugram,Himachal Pradesh,2023-05-01,2511,137,2374,100,4
Asthma,Gurugram,Himachal Pradesh,2023-06-01,2722,87,2635,82,1
Asthma,Gurugram,Himachal Pradesh,2023-07-01,1860,209,1651,146,7
Asthma,Gurugram,Himachal Pradesh,2023-08-01,1913,36,1877,11,10
Asthma,Gurugram,Himachal Pradesh,2023-09-01,2983,270,2713,147,4
Asthma,Gurugram,Himachal Pradesh,2023-10-01,3863,218,3645,111,2
Asthma,Gurugram,Himachal Pradesh,2023-11-01,1795,132,1663,81,5
Asthma,Gurugram,Himachal Pradesh,2023-12-01,1432,102,1330,132,4
Asthma,Gurugram,Himachal Pradesh,2024-01-01,3420,0,3420,87,10
Asthma,Gurugram,Himachal Pradesh,2024-02-01,2554,127,2427,108,8
Asthma,Gurugram,Himachal Pradesh,2024-03-01,3712,157,3555,104,5
Asthma,Gurugram,Himachal Pradesh,2024-04-01,1382,23,1359,144,1
Asthma,Gurugram,Himachal Pradesh,2024-05-01,210,13,197,114,4
Asthma,Gurugram,Himachal Pradesh,2024-06-01,1882,188,1694,11,10
Asthma,Gurugram,Himachal Pradesh,2024-07-01,1569,0,1569,35,5
Asthma,Gurugram,Himachal Pradesh,2024-08-01,2492,86,2406,51,7
Asthma,Gurugram,Himachal Pradesh,2024-09-01,1743,24,1719,129,6
Asthma,Gurugram,Himachal Pradesh,2024-10-01,3591,187,3404,135,3
Asthma,Gurugram,Himachal Pradesh,2024-11-01,2211,89,2122,191,10
Asthma,Gurugram,Himachal Pradesh,2024-12-01,2799,90,2709,55,5
Asthma,Gurugram,Himachal Pradesh,2025-01-01,2809,197,2612,173,3
Asthma,Gurugram,Himachal Pradesh,2025-02-01,2859,279,2580,11,5
Asthma,Gurugram,Himachal Pradesh,2025-03-01,2565,327,2238,107,9
Asthma,Gurugram,Himachal Pradesh,2025-04-01,3282,93,3189,119,1
Asthma,Gurugram,Himachal Pradesh,2025-05-01,1530,0,1530,119,6
Asthma,Gurugram,Himachal Pradesh,2025-06-01,4475,296,4179,90,5
Asthma,Gurugram,Himachal Pradesh,2025-07-01,2280,221,2059,112,1
Asthma,Gurugram,Himachal Pradesh,2025-08-01,838,61,777,43,7
Asthma,Gurugram,Himachal Pradesh,2025-09-01,2850,275,2575,150,6
Asthma,Gurugram,Himachal Pradesh,2025-10-01,1456,63,1393,119,7
Asthma,Gurugram,Himachal Pradesh,2025-11-01,3490,112,3378,125,8
Asthma,Gurugram,Himachal Pradesh,2025-12-01,4989,266,4723,92,5
Asthma,Gurugram,Jammu & Kashmir,2018-01-01,1542,62,1480,90,3
Asthma,Gurugram,Jammu & Kashmir,2018-02-01,3043,211,2832,133,1
Asthma,Gurugram,Jammu & Kashmir,2018-03-01,242,18,224,187,3
Asthma,Gurugram,Jammu & Kashmir,2018-04-01,3206,258,2948,35,5
Asthma,Gurugram,Jammu & Kashmir,2018-05-01,1409,91,1318,33,2
Asthma,Gurugram,Jammu & Kashmir,2018-06-01,1759,100,1659,120,7
Asthma,Gurugram,Jammu & Kashmir,2018-07-01,1120,81,1039,89,2
Asthma,Gurugram,Jammu & Kashmir,2018-08-01,3580,0,3580,113,1
Asthma,Gurugram,Jammu & Kashmir,2018-09-01,3949,221,3728,105,3
Asthma,Gurugram,Jammu & Kashmir,2018-10-01,2629,135,2494,138,5
Asthma,Gurugram,Jammu & Kashmir,2018-11-01,1438,80,1358,92,1
Asthma,Gurugram,Jammu & Kashmir,2018-12-01,4730,224,4506,45,2
Asthma,Gurugram,Jammu & Kashmir,2019-01-01,1591,99,1492,66,3
Asthma,Gurugram,Jammu & Kashmir,2019-02-01,78,0,78,98,3
Asthma,Gurugram,Jammu & Kashmir,2019-03-01,3212,266,2946,42,6
Asthma,Gurugram,Jammu & Kashmir,2019-04-01,1115,71,1044,104,7
Asthma,Gurugram,Jammu & Kashmir,2019-05-01,3924,213,3711,109,3
Asthma,Gurugram,Jammu & Kashmir,2019-06-01,2086,62,2024,88,2
Asthma,Gurugram,Jammu & Kashmir,2019-07-01,3407,251,3156,117,5
Asthma,Gurugram,Jammu & Kashmir,2019-08-01,4478,251,4227,24,6
Asthma,Gurugram,Jammu & Kashmir,2019-09-01,976,27,949,58,10
Asthma,Gurugram,Jammu & Kashmir,2019-10-01,1838,88,1750,48,8
Asthma,Gurugram,Jammu & Kashmir,2019-11-01,2496,170,2326,151,1
Asthma,Gurugram,Jammu & Kashmir,2019-12-01,4660,308,4352,200,4
Asthma,Gurugram,Jammu & Kashmir,2020-01-01,1714,110,1604,61,6
Asthma,Gurugram,Jammu & Kashmir,2020-02-01,1800,94,1706,94,2
Asthma,Gurugram,Jammu & Kashmir,2020-03-01,3239,258,2981,71,4
Asthma,Gurugram,Jammu & Kashmir,2020-04-01,1823,156,1667,117,7
Asthma,Gurugram,Jammu & Kashmir,2020-05-01,2802,200,2602,75,6
Asthma,Gurugram,Jammu & Kashmir,2020-06-01,516,17,499,121,5
Asthma,Gurugram,Jammu & Kashmir,2020-07-01,4989,96,4893,140,3
Asthma,Gurugram,Jammu & Kashmir,2020-08-01,789,27,762,44,1
Asthma,Gurugram,Jammu & Kashmir,2020-09-01,2166,231,1935,120,4
Asthma,Gurugram,Jammu & Kashmir,2020-10-01,2554,148,2406,15,5
Asthma,Gurugram,Jammu & Kashmir,2020-11-01,4989,442,4547,93,1
Asthma,Gurugram,Jammu & Kashmir,2020-12-01,820,38,782,90,5
Asthma,Gurugram,Jammu & Kashmir,2021-01-01,4989,212,4777,95,6
Asthma,Gurugram,Jammu & Kashmir,2021-02-01,3613,173,3440,90,3
Asthma,Gurugram,Jammu & Kashmir,2021-03-01,3157,149,3008,81,6
Asthma,Gurugram,Jammu & Kashmir,2021-04-01,1277,35,1242,93,6
Asthma,Gurugram,Jammu & Kashmir,2021-05-01,3364,55,3309,118,4
Asthma,Gurugram,Jammu & Kashmir,2021-06-01,1627,105,1522,120,4
Asthma,Gurugram,Jammu & Kashmir,2021-07-01,4297,347,3950,112,4
Asthma,Gurugram,Jammu & Kashmir,2021-08-01,1295,156,1139,77,2
Asthma,Gurugram,Jammu & Kashmir,2021-09-01,2446,91,2355,161,6
Asthma,Gurugram,Jammu & Kashmir,2021-10-01,1853,73,1780,184,2
Asthma,Gurugram,Jammu & Kashmir,2021-11-01,1273,35,1238,41,3
Asthma,Gurugram,Jammu & Kashmir,2021-12-01,3592,297,3295,115,6
Asthma,Gurugram,Jammu & Kashmir,2022-01-01,3316,244,3072,82,4
Asthma,Gurugram,Jammu & Kashmir,2022-02-01,4219,103,4116,153,5
Asthma,Gurugram,Jammu & Kashmir,2022-03-01,210,5,205,106,1
Asthma,Gurugram,Jammu & Kashmir,2022-04-01,4025,313,3712,109,3
Asthma,Gurugram,Jammu & Kashmir,2022-05-01,4989,305,4684,131,10
Asthma,Gurugram,Jammu & Kashmir,2022-06-01,1992,143,1849,91,1
Asthma,Gurugram,Jammu & Kashmir,2022-07-01,4989,121,4868,192,10
Asthma,Gurugram,Jammu & Kashmir,2022-08-01,2244,0,2244,132,6
Asthma,Gurugram,Jammu & Kashmir,2022-09-01,756,18,738,154,3
Asthma,Gurugram,Jammu & Kashmir,2022-10-01,2187,153,2034,95,4
Asthma,Gurugram,Jammu & Kashmir,2022-11-01,4004,442,3562,100,8
Asthma,Gurugram,Jammu & Kashmir,2022-12-01,1473,55,1418,148,1
Asthma,Gurugram,Jammu & Kashmir,2023-01-01,1792,208,1584,142,9
Asthma,Gurugram,Jammu & Kashmir,2023-02-01,3394,251,3143,43,6
Asthma,Gurugram,Jammu & Kashmir,2023-03-01,2602,24,2578,113,8
Asthma,Gurugram,Jammu & Kashmir,2023-04-01,3382,190,3192,130,1
Asthma,Gurugram,Jammu & Kashmir,2023-05-01,2916,219,2697,100,4
Asthma,Gurugram,Jammu & Kashmir,2023-06-01,3241,0,3241,126,1
Asthma,Gurugram,Jammu & Kashmir,2023-07-01,2017,138,1879,102,8
Asthma,Gurugram,Jammu & Kashmir,2023-08-01,2908,244,2664,11,2
Asthma,Gurugram,Jammu & Kashmir,2023-09-01,1353,83,1270,39,2
Asthma,Gurugram,Jammu & Kashmir,2023-10-01,4326,208,4118,156,1
Asthma,Gurugram,Jammu & Kashmir,2023-11-01,1747,78,1669,94,6
Asthma,Gurugram,Jammu & Kashmir,2023-12-01,4112,178,3934,116,5
Asthma,Gurugram,Jammu & Kashmir,2024-01-01,2284,36,2248,106,3
Asthma,Gurugram,Jammu & Kashmir,2024-02-01,2868,86,2782,64,6
Asthma,Gurugram,Jammu & Kashmir,2024-03-01,1933,73,1860,82,3
Asthma,Gurugram,Jammu & Kashmir,2024-04-01,1234,65,1169,123,1
Asthma,Gurugram,Jammu & Kashmir,2024-05-01,257,8,249,128,4
Asthma,Gurugram,Jammu & Kashmir,2024-06-01,1182,29,1153,200,10
Asthma,Gurugram,Jammu & Kashmir,2024-07-01,2163,156,2007,82,8
Asthma,Gurugram,Jammu & Kashmir,2024-08-01,2882,175,2707,191,6
Asthma,Gurugram,Jammu & Kashmir,2024-09-01,3953,135,3818,62,6
Asthma,Gurugram,Jammu & Kashmir,2024-10-01,1999,129,1870,131,4
Asthma,Gurugram,Jammu & Kashmir,2024-11-01,1414,52,1362,115,7
Asthma,Gurugram,Jammu & Kashmir,2024-12-01,662,34,628,100,6
Asthma,Gurugram,Jammu & Kashmir,2025-01-01,3241,254,2987,106,5
Asthma,Gurugram,Jammu & Kashmir,2025-02-01,4453,144,4309,74,5
Asthma,Gurugram,Jammu & Kashmir,2025-03-01,4296,68,4228,152,1
Asthma,Gurugram,Jammu & Kashmir,2025-04-01,3550,162,3388,63,3
Asthma,Gurugram,Jammu & Kashmir,2025-05-01,3454,35,3419,122,1
Asthma,Gurugram,Jammu & Kashmir,2025-06-01,4875,204,4671,145,1
Asthma,Gurugram,Jammu & Kashmir,2025-07-01,3043,127,2916,177,6
Asthma,Gurugram,Jammu & Kashmir,2025-08-01,3464,0,3464,156,1
Asthma,Gurugram,Jammu & Kashmir,2025-09-01,2167,141,2026,135,7
Asthma,Gurugram,Jammu & Kashmir,2025-10-01,770,34,736,74,8
Asthma,Gurugram,Jammu & Kashmir,2025-11-01,1680,141,1539,66,5
Asthma,Gurugram,Jammu & Kashmir,2025-12-01,2585,145,2440,48,3
Asthma,Gurugram,Haryana,2018-01-01,2679,191,2488,43,8
Asthma,Gurugram,Haryana,2018-02-01,4989,422,4567,106,6
Asthma,Gurugram,Haryana,2018-03-01,2706,125,2581,69,8
Asthma,Gurugram,Haryana,2018-04-01,4179,209,3970,167,2
Asthma,Gurugram,Haryana,2018-05-01,2014,8,2006,77,4
Asthma,Gurugram,Haryana,2018-06-01,2179,187,1992,111,4
Asthma,Gurugram,Haryana,2018-07-01,815,37,778,93,5
Asthma,Gurugram,Haryana,2018-08-01,1602,33,1569,35,7
Asthma,Gurugram,Haryana,2018-09-01,3304,236,3068,162,5
Asthma,Gurugram,Haryana,2018-10-01,2608,0,2608,142,9
Asthma,Gurugram,Haryana,2018-11-01,3862,145,3717,148,4
Asthma,Gurugram,Haryana,2018-12-01,2841,217,2624,137,2
Asthma,Gurugram,Haryana,2019-01-01,2125,79,2046,68,3
Asthma,Gurugram,Haryana,2019-02-01,4989,145,4844,69,3
Asthma,Gurugram,Haryana,2019-03-01,2471,93,2378,129,3
Asthma,Gurugram,Haryana,2019-04-01,4158,0,4158,185,4
Asthma,Gurugram,Haryana,2019-05-01,2059,145,1914,126,4
Asthma,Gurugram,Haryana,2019-06-01,3549,165,3384,156,5
Asthma,Gurugram,Haryana,2019-07-01,3842,161,3681,79,3
Asthma,Gurugram,Haryana,2019-08-01,2877,121,2756,162,8
Asthma,Gurugram,Haryana,2019-09-01,78,0,78,85,1
Asthma,Gurugram,Haryana,2019-10-01,2622,181,2441,118,1
Asthma,Gurugram,Haryana,2019-11-01,4248,206,4042,88,8
Asthma,Gurugram,Haryana,2019-12-01,3305,34,3271,152,8
Asthma,Gurugram,Haryana,2020-01-01,3196,213,2983,152,8
Asthma,Gurugram,Haryana,2020-02-01,287,18,269,31,7
Asthma,Gurugram,Haryana,2020-03-01,1631,91,1540,174,5
Asthma,Gurugram,Haryana,2020-04-01,3149,256,2893,200,4
Asthma,Gurugram,Haryana,2020-05-01,3148,160,2988,88,1
Asthma,Gurugram,Haryana,2020-06-01,4227,348,3879,100,5
Asthma,Gurugram,Haryana,2020-07-01,2403,218,2185,169,1
Asthma,Gurugram,Haryana,2020-08-01,3142,210,2932,110,10
Asthma,Gurugram,Haryana,2020-09-01,2619,74,2545,106,2
Asthma,Gurugram,Haryana,2020-10-01,1273,58,1215,200,5
Asthma,Gurugram,Haryana,2020-11-01,78,0,78,37,9
Asthma,Gurugram,Haryana,2020-12-01,3176,20,3156,66,4
Asthma,Gurugram,Haryana,2021-01-01,2831,109,2722,127,4
Asthma,Gurugram,Haryana,2021-02-01,1768,70,1698,24,1
Asthma,Gurugram,Haryana,2021-03-01,425,10,415,87,1
Asthma,Gurugram,Haryana,2021-04-01,3442,259,3183,87,6
Asthma,Gurugram,Haryana,2021-05-01,2241,136,2105,155,10
Asthma,Gurugram,Haryana,2021-06-01,3344,98,3246,142,2
Asthma,Gurugram,Haryana,2021-07-01,4989,337,4652,20,5
Asthma,Gurugram,Haryana,2021-08-01,78,0,78,71,10
Asthma,Gurugram,Haryana,2021-09-01,1659,40,1619,71,6
Asthma,Gurugram,Haryana,2021-10-01,2317,67,2250,95,8
Asthma,Gurugram,Haryana,2021-11-01,4549,285,4264,50,3
Asthma,Gurugram,Haryana,2021-12-01,402,31,371,129,9
Asthma,Gurugram,Haryana,2022-01-01,4989,179,4810,71,3
Asthma,Gurugram,Haryana,2022-02-01,2780,183,2597,136,2
Asthma,Gurugram,Haryana,2022-03-01,2469,237,2232,106,9
Asthma,Gurugram,Haryana,2022-04-01,2332,31,2301,57,3
Asthma,Gurugram,Haryana,2022-05-01,2012,121,1891,177,5
Asthma,Gurugram,Haryana,2022-06-01,4003,297,3706,178,10
Asthma,Gurugram,Haryana,2022-07-01,1164,55,1109,121,2
Asthma,Gurugram,Haryana,2022-08-01,3061,263,2798,94,4
Asthma,Gurugram,Haryana,2022-09-01,2082,237,1845,52,3
Asthma,Gurugram,Haryana,2022-10-01,1575,94,1481,161,4
Asthma,Gurugram,Haryana,2022-11-01,4989,215,4774,148,5
Asthma,Gurugram,Haryana,2022-12-01,3160,248,2912,65,9
Asthma,Gurugram,Haryana,2023-01-01,3420,255,3165,71,10
Asthma,Gurugram,Haryana,2023-02-01,4124,0,4124,129,5
Asthma,Gurugram,Haryana,2023-03-01,691,34,657,46,3
Asthma,Gurugram,Haryana,2023-04-01,4948,190,4758,74,7
Asthma,Gurugram,Haryana,2023-05-01,78,0,78,53,5
Asthma,Gurugram,Haryana,2023-06-01,1566,69,1497,55,5
Asthma,Gurugram,Haryana,2023-07-01,1982,94,1888,70,2
Asthma,Gurugram,Haryana,2023-08-01,3378,84,3294,152,1
Asthma,Gurugram,Haryana,2023-09-01,2891,206,2685,17,5
Asthma,Gurugram,Haryana,2023-10-01,2374,233,2141,128,2
Asthma,Gurugram,Haryana,2023-11-01,2581,65,2516,119,3
Asthma,Gurugram,Haryana,2023-12-01,1285,12,1273,156,9
Asthma,Gurugram,Haryana,2024-01-01,589,29,560,119,5
Asthma,Gurugram,Haryana,2024-02-01,3572,175,3397,87,8
Asthma,Gurugram,Haryana,2024-03-01,3528,296,3232,65,6
Asthma,Gurugram,Haryana,2024-04-01,4723,67,4656,157,7
Asthma,Gurugram,Haryana,2024-05-01,1538,52,1486,132,3
Asthma,Gurugram,Haryana,2024-06-01,3527,0,3527,81,8
Asthma,Gurugram,Haryana,2024-07-01,2217,199,2018,153,6
Asthma,Gurugram,Haryana,2024-08-01,4194,240,3954,83,4
Asthma,Gurugram,Haryana,2024-09-01,3968,145,3823,106,6
Asthma,Gurugram,Haryana,2024-10-01,2881,33,2848,75,3
Asthma,Gurugram,Haryana,2024-11-01,2142,30,2112,133,4
Asthma,Gurugram,Haryana,2024-12-01,3887,241,3646,56,5
Asthma,Gurugram,Haryana,2025-01-01,3465,61,3404,91,3
Asthma,Gurugram,Haryana,2025-02-01,1679,89,1590,73,9
Asthma,Gurugram,Haryana,2025-03-01,816,89,727,120,4
Asthma,Gurugram,Haryana,2025-04-01,2210,88,2122,126,10
Asthma,Gurugram,Haryana,2025-05-01,4630,102,4528,50,5
Asthma,Gurugram,Haryana,2025-06-01,4135,253,3882,127,4
Asthma,Gurugram,Haryana,2025-07-01,1105,15,1090,31,3
Asthma,Gurugram,Haryana,2025-08-01,1031,103,928,200,6
Asthma,Gurugram,Haryana,2025-09-01,4307,391,3916,80,7
Asthma,Gurugram,Haryana,2025-10-01,1074,48,1026,160,1
Asthma,Gurugram,Haryana,2025-11-01,3281,78,3203,116,5
Asthma,Gurugram,Haryana,2025-12-01,1771,66,1705,119,1
Asthma,Faridabad,Punjab,2018-01-01,4767,197,4570,47,8
Asthma,Faridabad,Punjab,2018-02-01,1564,95,1469,149,8
Asthma,Faridabad,Punjab,2018-03-01,4131,331,3800,109,5
Asthma,Faridabad,Punjab,2018-04-01,2845,56,2789,130,5
Asthma,Faridabad,Punjab,2018-05-01,2936,233,2703,102,1
Asthma,Faridabad,Punjab,2018-06-01,78,0,78,113,3
Asthma,Faridabad,Punjab,2018-07-01,78,0,78,61,3
Asthma,Faridabad,Punjab,2018-08-01,2302,42,2260,98,4
Asthma,Faridabad,Punjab,2018-09-01,2929,156,2773,85,7
Asthma,Faridabad,Punjab,2018-10-01,1088,20,1068,70,9
Asthma,Faridabad,Punjab,2018-11-01,1137,90,1047,113,7
Asthma,Faridabad,Punjab,2018-12-01,3351,58,3293,125,4
Asthma,Faridabad,Punjab,2019-01-01,3352,221,3131,119,3
Asthma,Faridabad,Punjab,2019-02-01,2413,115,2298,101,5
Asthma,Faridabad,Punjab,2019-03-01,3644,123,3521,127,6
Asthma,Faridabad,Punjab,2019-04-01,1022,48,974,119,4
Asthma,Faridabad,Punjab,2019-05-01,2120,172,1948,111,3
Asthma,Faridabad,Punjab,2019-06-01,4808,73,4735,115,7
Asthma,Faridabad,Punjab,2019-07-01,2689,102,2587,166,7
Asthma,Faridabad,Punjab,2019-08-01,2767,78,2689,45,1
Asthma,Faridabad,Punjab,2019-09-01,4989,244,4745,90,4
Asthma,Faridabad,Punjab,2019-10-01,720,21,699,123,7
Asthma,Faridabad,Punjab,2019-11-01,3666,0,3666,26,8
Asthma,Faridabad,Punjab,2019-12-01,4830,93,4737,177,5
Asthma,Faridabad,Punjab,2020-01-01,2162,211,1951,119,6
Asthma,Faridabad,Punjab,2020-02-01,3751,214,3537,155,6
Asthma,Faridabad,Punjab,2020-03-01,1280,72,1208,163,8
Asthma,Faridabad,Punjab,2020-04-01,1676,70,1606,127,2
Asthma,Faridabad,Punjab,2020-05-01,3114,151,2963,11,6
Asthma,Faridabad,Punjab,2020-06-01,3669,137,3532,114,2
Asthma,Faridabad,Punjab,2020-07-01,4101,268,3833,117,8
Asthma,Faridabad,Punjab,2020-08-01,4703,249,4454,51,2
Asthma,Faridabad,Punjab,2020-09-01,2507,40,2467,15,6
Asthma,Faridabad,Punjab,2020-10-01,4199,241,3958,130,2
Asthma,Faridabad,Punjab,2020-11-01,2138,0,2138,43,7
Asthma,Faridabad,Punjab,2020-12-01,3808,236,3572,200,6
Asthma,Faridabad,Punjab,2021-01-01,2876,26,2850,120,6
Asthma,Faridabad,Punjab,2021-02-01,3195,151,3044,175,10
Asthma,Faridabad,Punjab,2021-03-01,3166,48,3118,108,3
Asthma,Faridabad,Punjab,2021-04-01,445,22,423,144,8
Asthma,Faridabad,Punjab,2021-05-01,1089,72,1017,109,8
Asthma,Faridabad,Punjab,2021-06-01,2735,256,2479,157,8
Asthma,Faridabad,Punjab,2021-07-01,334,1,333,11,3
Asthma,Faridabad,Punjab,2021-08-01,3712,291,3421,151,4
Asthma,Faridabad,Punjab,2021-09-01,3767,202,3565,140,3
Asthma,Faridabad,Punjab,2021-10-01,3036,112,2924,98,4
Asthma,Faridabad,Punjab,2021-11-01,1093,78,1015,85,2
Asthma,Faridabad,Punjab,2021-12-01,4449,192,4257,91,4
Asthma,Faridabad,Punjab,2022-01-01,4989,353,4636,121,9
Asthma,Faridabad,Punjab,2022-02-01,2795,59,2736,168,4
Asthma,Faridabad,Punjab,2022-03-01,3282,103,3179,79,5
Asthma,Faridabad,Punjab,2022-04-01,2868,222,2646,20,3
Asthma,Faridabad,Punjab,2022-05-01,3309,308,3001,200,5
Asthma,Faridabad,Punjab,2022-06-01,2437,119,2318,140,7
Asthma,Faridabad,Punjab,2022-07-01,2551,0,2551,86,6
Asthma,Faridabad,Punjab,2022-08-01,3812,168,3644,167,9
Asthma,Faridabad,Punjab,2022-09-01,4989,254,4735,154,1
Asthma,Faridabad,Punjab,2022-10-01,719,31,688,131,3
Asthma,Faridabad,Punjab,2022-11-01,2458,147,2311,82,4
Asthma,Faridabad,Punjab,2022-12-01,1014,36,978,140,9
Asthma,Faridabad,Punjab,2023-01-01,4733,352,4381,162,6
Asthma,Faridabad,Punjab,2023-02-01,1809,29,1780,19,1
Asthma,Faridabad,Punjab,2023-03-01,661,56,605,118,8
Asthma,Faridabad,Punjab,2023-04-01,3454,328,3126,121,5
Asthma,Faridabad,Punjab,2023-05-01,4937,116,4821,120,7
Asthma,Faridabad,Punjab,2023-06-01,3488,81,3407,109,9
Asthma,Faridabad,Punjab,2023-07-01,2872,178,2694,167,2
Asthma,Faridabad,Punjab,2023-08-01,3146,48,3098,95,9
Asthma,Faridabad,Punjab,2023-09-01,4495,160,4335,106,5
Asthma,Faridabad,Punjab,2023-10-01,1425,117,1308,122,4
Asthma,Faridabad,Punjab,2023-11-01,2447,175,2272,97,5
Asthma,Faridabad,Punjab,2023-12-01,1990,214,1776,36,1
Asthma,Faridabad,Punjab,2024-01-01,1031,56,975,117,5
Asthma,Faridabad,Punjab,2024-02-01,2157,69,2088,118,4
Asthma,Faridabad,Punjab,2024-03-01,4083,210,3873,88,2
Asthma,Faridabad,Punjab,2024-04-01,3358,153,3205,99,3
Asthma,Faridabad,Punjab,2024-05-01,3462,159,3303,11,8
Asthma,Faridabad,Punjab,2024-06-01,2794,137,2657,168,4
Asthma,Faridabad,Punjab,2024-07-01,3299,75,3224,152,2
Asthma,Faridabad,Punjab,2024-08-01,1523,88,1435,38,6
Asthma,Faridabad,Punjab,2024-09-01,2182,19,2163,72,7
Asthma,Faridabad,Punjab,2024-10-01,2855,83,2772,180,5
Asthma,Faridabad,Punjab,2024-11-01,2970,138,2832,47,1
Asthma,Faridabad,Punjab,2024-12-01,3027,0,3027,131,1
Asthma,Faridabad,Punjab,2025-01-01,2412,174,2238,81,2
Asthma,Faridabad,Punjab,2025-02-01,2091,0,2091,127,8
Asthma,Faridabad,Punjab,2025-03-01,4989,347,4642,109,8
Asthma,Faridabad,Punjab,2025-04-01,3814,47,3767,92,3
Asthma,Faridabad,Punjab,2025-05-01,3152,120,3032,126,4
Asthma,Faridabad,Punjab,2025-06-01,2285,148,2137,81,7
Asthma,Faridabad,Punjab,2025-07-01,1992,227,1765,15,4
Asthma,Faridabad,Punjab,2025-08-01,2422,129,2293,59,8
Asthma,Faridabad,Punjab,2025-09-01,2990,0,2990,53,5
Asthma,Faridabad,Punjab,2025-10-01,78,0,78,24,6
Asthma,Faridabad,Punjab,2025-11-01,492,21,471,125,4
Asthma,Faridabad,Punjab,2025-12-01,1743,90,1653,97,3
Asthma,Faridabad,Chandigarh,2018-01-01,2875,190,2685,124,8
Asthma,Faridabad,Chandigarh,2018-02-01,2276,0,2276,133,1
Asthma,Faridabad,Chandigarh,2018-03-01,4580,230,4350,145,3
Asthma,Faridabad,Chandigarh,2018-04-01,609,23,586,127,5
Asthma,Faridabad,Chandigarh,2018-05-01,1589,136,1453,56,7
Asthma,Faridabad,Chandigarh,2018-06-01,4637,330,4307,136,2
Asthma,Faridabad,Chandigarh,2018-07-01,2773,7,2766,118,5
Asthma,Faridabad,Chandigarh,2018-08-01,3784,328,3456,200,1
Asthma,Faridabad,Chandigarh,2018-09-01,4989,315,4674,107,6
Asthma,Faridabad,Chandigarh,2018-10-01,1667,8,1659,126,10
Asthma,Faridabad,Chandigarh,2018-11-01,2464,127,2337,101,1
Asthma,Faridabad,Chandigarh,2018-12-01,2232,178,2054,109,3
Asthma,Faridabad,Chandigarh,2019-01-01,78,0,78,105,7
Asthma,Faridabad,Chandigarh,2019-02-01,2181,196,1985,84,10
Asthma,Faridabad,Chandigarh,2019-03-01,3779,22,3757,115,7
Asthma,Faridabad,Chandigarh,2019-04-01,3323,89,3234,138,3
Asthma,Faridabad,Chandigarh,2019-05-01,3428,77,3351,85,4
Asthma,Faridabad,Chandigarh,2019-06-01,2094,188,1906,149,1
Asthma,Faridabad,Chandigarh,2019-07-01,1717,61,1656,143,7
Asthma,Faridabad,Chandigarh,2019-08-01,4300,69,4231,61,8
Asthma,Faridabad,Chandigarh,2019-09-01,1930,121,1809,57,9
Asthma,Faridabad,Chandigarh,2019-10-01,2992,207,2785,129,4
Asthma,Faridabad,Chandigarh,2019-11-01,2817,195,2622,76,2
Asthma,Faridabad,Chandigarh,2019-12-01,4558,192,4366,53,9
Asthma,Faridabad,Chandigarh,2020-01-01,3901,224,3677,194,9
Asthma,Faridabad,Chandigarh,2020-02-01,860,26,834,57,2
Asthma,Faridabad,Chandigarh,2020-03-01,1004,99,905,29,4
Asthma,Faridabad,Chandigarh,2020-04-01,3374,281,3093,66,7
Asthma,Faridabad,Chandigarh,2020-05-01,2511,204,2307,118,4
Asthma,Faridabad,Chandigarh,2020-06-01,1987,145,1842,110,5
Asthma,Faridabad,Chandigarh,2020-07-01,3960,258,3702,200,1
Asthma,Faridabad,Chandigarh,2020-08-01,2849,39,2810,67,2
Asthma,Faridabad,Chandigarh,2020-09-01,2668,182,2486,118,5
Asthma,Faridabad,Chandigarh,2020-10-01,3644,194,3450,164,3
Asthma,Faridabad,Chandigarh,2020-11-01,2094,181,1913,73,1
Asthma,Faridabad,Chandigarh,2020-12-01,4702,345,4357,142,4
Asthma,Faridabad,Chandigarh,2021-01-01,1540,101,1439,13,2
Asthma,Faridabad,Chandigarh,2021-02-01,3479,3,3476,196,5
Asthma,Faridabad,Chandigarh,2021-03-01,4521,214,4307,157,8
Asthma,Faridabad,Chandigarh,2021-04-01,750,25,725,72,4
Asthma,Faridabad,Chandigarh,2021-05-01,2137,122,2015,148,4
Asthma,Faridabad,Chandigarh,2021-06-01,4130,156,3974,173,8
Asthma,Faridabad,Chandigarh,2021-07-01,4150,174,3976,41,7
Asthma,Faridabad,Chandigarh,2021-08-01,2367,150,2217,76,7
Asthma,Faridabad,Chandigarh,2021-09-01,1612,60,1552,175,1
Asthma,Faridabad,Chandigarh,2021-10-01,3880,208,3672,110,4
Asthma,Faridabad,Chandigarh,2021-11-01,4185,24,4161,128,3
Asthma,Faridabad,Chandigarh,2021-12-01,1035,26,1009,110,2
Asthma,Faridabad,Chandigarh,2022-01-01,982,67,915,152,8
Asthma,Faridabad,Chandigarh,2022-02-01,2900,41,2859,132,3
Asthma,Faridabad,Chandigarh,2022-03-01,3442,297,3145,112,1
Asthma,Faridabad,Chandigarh,2022-04-01,2196,172,2024,11,6
Asthma,Faridabad,Chandigarh,2022-05-01,3509,148,3361,139,5
Asthma,Faridabad,Chandigarh,2022-06-01,1645,225,1420,143,2
Asthma,Faridabad,Chandigarh,2022-07-01,78,0,78,43,8
Asthma,Faridabad,Chandigarh,2022-08-01,2029,45,1984,47,6
Asthma,Faridabad,Chandigarh,2022-09-01,2682,192,2490,133,6
Asthma,Faridabad,Chandigarh,2022-10-01,2227,115,2112,116,6
Asthma,Faridabad,Chandigarh,2022-11-01,1043,28,1015,11,8
Asthma,Faridabad,Chandigarh,2022-12-01,162,3,159,64,4
Asthma,Faridabad,Chandigarh,2023-01-01,1908,150,1758,122,1
Asthma,Faridabad,Chandigarh,2023-02-01,3802,124,3678,141,4
Asthma,Faridabad,Chandigarh,2023-03-01,4283,201,4082,76,1
Asthma,Faridabad,Chandigarh,2023-04-01,4191,97,4094,99,2
Asthma,Faridabad,Chandigarh,2023-05-01,1503,42,1461,61,10
Asthma,Faridabad,Chandigarh,2023-06-01,1050,48,1002,174,2
Asthma,Faridabad,Chandigarh,2023-07-01,3264,200,3064,115,1
Asthma,Faridabad,Chandigarh,2023-08-01,3449,0,3449,72,7
Asthma,Faridabad,Chandigarh,2023-09-01,3134,158,2976,47,7
Asthma,Faridabad,Chandigarh,2023-10-01,78,0,78,42,1
Asthma,Faridabad,Chandigarh,2023-11-01,1434,130,1304,199,6
Asthma,Faridabad,Chandigarh,2023-12-01,2558,347,2211,97,3
Asthma,Faridabad,Chandigarh,2024-01-01,3251,128,3123,86,6
Asthma,Faridabad,Chandigarh,2024-02-01,3627,0,3627,95,4
Asthma,Faridabad,Chandigarh,2024-03-01,2791,149,2642,74,1
Asthma,Faridabad,Chandigarh,2024-04-01,3041,134,2907,101,3
Asthma,Faridabad,Chandigarh,2024-05-01,2711,291,2420,108,7
Asthma,Faridabad,Chandigarh,2024-06-01,3517,346,3171,107,10
Asthma,Faridabad,Chandigarh,2024-07-01,3017,227,2790,42,6
Asthma,Faridabad,Chandigarh,2024-08-01,2686,88,2598,152,4
Asthma,Faridabad,Chandigarh,2024-09-01,2237,156,2081,78,1
Asthma,Faridabad,Chandigarh,2024-10-01,2706,156,2550,73,4
Asthma,Faridabad,Chandigarh,2024-11-01,3247,185,3062,70,4
Asthma,Faridabad,Chandigarh,2024-12-01,2956,13,2943,53,6
Asthma,Faridabad,Chandigarh,2025-01-01,3108,251,2857,120,5
Asthma,Faridabad,Chandigarh,2025-02-01,4399,234,4165,152,6
Asthma,Faridabad,Chandigarh,2025-03-01,2953,139,2814,69,4
Asthma,Faridabad,Chandigarh,2025-04-01,1727,56,1671,12,10
Asthma,Faridabad,Chandigarh,2025-05-01,3783,102,3681,54,7
Asthma,Faridabad,Chandigarh,2025-06-01,765,45,720,83,3
Asthma,Faridabad,Chandigarh,2025-07-01,1147,0,1147,43,8
Asthma,Faridabad,Chandigarh,2025-08-01,3048,222,2826,76,1
Asthma,Faridabad,Chandigarh,2025-09-01,3290,63,3227,78,2
Asthma,Faridabad,Chandigarh,2025-10-01,927,0,927,105,2
Asthma,Faridabad,Chandigarh,2025-11-01,2084,214,1870,32,9
Asthma,Faridabad,Chandigarh,2025-12-01,1784,44,1740,136,4
Asthma,Faridabad,Himachal Pradesh,2018-01-01,1945,56,1889,191,3
Asthma,Faridabad,Himachal Pradesh,2018-02-01,3863,320,3543,179,5
Asthma,Faridabad,Himachal Pradesh,2018-03-01,3545,368,3177,76,6
Asthma,Faridabad,Himachal Pradesh,2018-04-01,2572,14,2558,140,9
Asthma,Faridabad,Himachal Pradesh,2018-05-01,1865,41,1824,134,1
Asthma,Faridabad,Himachal Pradesh,2018-06-01,787,19,768,104,8
Asthma,Faridabad,Himachal Pradesh,2018-07-01,4503,347,4156,115,1
Asthma,Faridabad,Himachal Pradesh,2018-08-01,3392,331,3061,141,7
Asthma,Faridabad,Himachal Pradesh,2018-09-01,1649,30,1619,151,8
Asthma,Faridabad,Himachal Pradesh,2018-10-01,3563,325,3238,65,8
Asthma,Faridabad,Himachal Pradesh,2018-11-01,2503,73,2430,144,6
Asthma,Faridabad,Himachal Pradesh,2018-12-01,2212,132,2080,191,2
Asthma,Faridabad,Himachal Pradesh,2019-01-01,3181,41,3140,151,7
Asthma,Faridabad,Himachal Pradesh,2019-02-01,1603,74,1529,184,2
Asthma,Faridabad,Himachal Pradesh,2019-03-01,2136,100,2036,11,2
Asthma,Faridabad,Himachal Pradesh,2019-04-01,2760,112,2648,137,3
Asthma,Faridabad,Himachal Pradesh,2019-05-01,1927,118,1809,120,4
Asthma,Faridabad,Himachal Pradesh,2019-06-01,3495,72,3423,159,6
Asthma,Faridabad,Himachal Pradesh,2019-07-01,4989,121,4868,49,3
Asthma,Faridabad,Himachal Pradesh,2019-08-01,1586,99,1487,80,6
Asthma,Faridabad,Himachal Pradesh,2019-09-01,364,32,332,152,1
Asthma,Faridabad,Himachal Pradesh,2019-10-01,78,0,78,52,5
Asthma,Faridabad,Himachal Pradesh,2019-11-01,2396,155,2241,119,4
Asthma,Faridabad,Himachal Pradesh,2019-12-01,1708,123,1585,105,8
Asthma,Faridabad,Himachal Pradesh,2020-01-01,2876,213,2663,96,8
Asthma,Faridabad,Himachal Pradesh,2020-02-01,2775,61,2714,135,4
Asthma,Faridabad,Himachal Pradesh,2020-03-01,447,12,435,49,1
Asthma,Faridabad,Himachal Pradesh,2020-04-01,163,4,159,66,1
Asthma,Faridabad,Himachal Pradesh,2020-05-01,2994,317,2677,99,8
Asthma,Faridabad,Himachal Pradesh,2020-06-01,2779,180,2599,45,4
Asthma,Faridabad,Himachal Pradesh,2020-07-01,2026,128,1898,169,10
Asthma,Faridabad,Himachal Pradesh,2020-08-01,374,22,352,66,7
Asthma,Faridabad,Himachal Pradesh,2020-09-01,3230,37,3193,146,6
Asthma,Faridabad,Himachal Pradesh,2020-10-01,4304,442,3862,62,5
Asthma,Faridabad,Himachal Pradesh,2020-11-01,2970,190,2780,142,1
Asthma,Faridabad,Himachal Pradesh,2020-12-01,1461,103,1358,24,3
Asthma,Faridabad,Himachal Pradesh,2021-01-01,2657,0,2657,178,6
Asthma,Faridabad,Himachal Pradesh,2021-02-01,765,55,710,164,4
Asthma,Faridabad,Himachal Pradesh,2021-03-01,4017,159,3858,78,6
Asthma,Faridabad,Himachal Pradesh,2021-04-01,2707,31,2676,64,8
Asthma,Faridabad,Himachal Pradesh,2021-05-01,225,5,220,130,4
Asthma,Faridabad,Himachal Pradesh,2021-06-01,2194,29,2165,28,4
Asthma,Faridabad,Himachal Pradesh,2021-07-01,3219,41,3178,108,2
Asthma,Faridabad,Himachal Pradesh,2021-08-01,2151,111,2040,65,7
Asthma,Faridabad,Himachal Pradesh,2021-09-01,2227,86,2141,93,7
Asthma,Faridabad,Himachal Pradesh,2021-10-01,955,57,898,73,10
Asthma,Faridabad,Himachal Pradesh,2021-11-01,3357,331,3026,66,5
Asthma,Faridabad,Himachal Pradesh,2021-12-01,1727,79,1648,193,5
Asthma,Faridabad,Himachal Pradesh,2022-01-01,78,0,78,146,6
Asthma,Faridabad,Himachal Pradesh,2022-02-01,2099,90,2009,31,4
Asthma,Faridabad,Himachal Pradesh,2022-03-01,3914,331,3583,62,2
Asthma,Faridabad,Himachal Pradesh,2022-04-01,2078,98,1980,150,5
Asthma,Faridabad,Himachal Pradesh,2022-05-01,4929,442,4487,156,6
Asthma,Faridabad,Himachal Pradesh,2022-06-01,3173,200,2973,36,6
Asthma,Faridabad,Himachal Pradesh,2022-07-01,3052,0,3052,142,6
Asthma,Faridabad,Himachal Pradesh,2022-08-01,2425,129,2296,120,8
Asthma,Faridabad,Himachal Pradesh,2022-09-01,2506,147,2359,11,6
Asthma,Faridabad,Himachal Pradesh,2022-10-01,2244,182,2062,86,6
Asthma,Faridabad,Himachal Pradesh,2022-11-01,2192,225,1967,99,1
Asthma,Faridabad,Himachal Pradesh,2022-12-01,3310,253,3057,109,6
Asthma,Faridabad,Himachal Pradesh,2023-01-01,1342,84,1258,39,4
Asthma,Faridabad,Himachal Pradesh,2023-02-01,1154,80,1074,67,2
Asthma,Faridabad,Himachal Pradesh,2023-03-01,1091,49,1042,74,6
Asthma,Faridabad,Himachal Pradesh,2023-04-01,4989,37,4952,79,6
Asthma,Faridabad,Himachal Pradesh,2023-05-01,3309,169,3140,80,6
Asthma,Faridabad,Himachal Pradesh,2023-06-01,3006,182,2824,99,6
Asthma,Faridabad,Himachal Pradesh,2023-07-01,1179,17,1162,122,5
Asthma,Faridabad,Himachal Pradesh,2023-08-01,3434,304,3130,197,4
Asthma,Faridabad,Himachal Pradesh,2023-09-01,2441,193,2248,151,10
Asthma,Faridabad,Himachal Pradesh,2023-10-01,2885,29,2856,173,5
Asthma,Faridabad,Himachal Pradesh,2023-11-01,1287,115,1172,82,1
Asthma,Faridabad,Himachal Pradesh,2023-12-01,2812,115,2697,55,1
Asthma,Faridabad,Himachal Pradesh,2024-01-01,2029,55,1974,147,8
Asthma,Faridabad,Himachal Pradesh,2024-02-01,1570,127,1443,105,1
Asthma,Faridabad,Himachal Pradesh,2024-03-01,3582,174,3408,143,3
Asthma,Faridabad,Himachal Pradesh,2024-04-01,535,56,479,61,1
Asthma,Faridabad,Himachal Pradesh,2024-05-01,3355,84,3271,139,4
Asthma,Faridabad,Himachal Pradesh,2024-06-01,3516,0,3516,97,6
Asthma,Faridabad,Himachal Pradesh,2024-07-01,1417,59,1358,83,3
Asthma,Faridabad,Himachal Pradesh,2024-08-01,1497,109,1388,88,2
Asthma,Faridabad,Himachal Pradesh,2024-09-01,2298,53,2245,131,7
Asthma,Faridabad,Himachal Pradesh,2024-10-01,2976,33,2943,146,10
Asthma,Faridabad,Himachal Pradesh,2024-11-01,2392,135,2257,88,6
Asthma,Faridabad,Himachal Pradesh,2024-12-01,3179,23,3156,124,2
Asthma,Faridabad,Himachal Pradesh,2025-01-01,4962,292,4670,124,7
Asthma,Faridabad,Himachal Pradesh,2025-02-01,1916,76,1840,144,10
Asthma,Faridabad,Himachal Pradesh,2025-03-01,296,19,277,156,8
Asthma,Faridabad,Himachal Pradesh,2025-04-01,3705,36,3669,198,1
Asthma,Faridabad,Himachal Pradesh,2025-05-01,4856,426,4430,83,6
Asthma,Faridabad,Himachal Pradesh,2025-06-01,3124,139,2985,181,3
Asthma,Faridabad,Himachal Pradesh,2025-07-01,1138,82,1056,112,5
Asthma,Faridabad,Himachal Pradesh,2025-08-01,2431,189,2242,50,4
Asthma,Faridabad,Himachal Pradesh,2025-09-01,1097,17,1080,73,7
Asthma,Faridabad,Himachal Pradesh,2025-10-01,3460,262,3198,130,4
Asthma,Faridabad,Himachal Pradesh,2025-11-01,785,6,779,143,9
Asthma,Faridabad,Himachal Pradesh,2025-12-01,2195,22,2173,54,5
Asthma,Faridabad,Jammu & Kashmir,2018-01-01,1250,134,1116,67,4
Asthma,Faridabad,Jammu & Kashmir,2018-02-01,2768,228,2540,79,6
Asthma,Faridabad,Jammu & Kashmir,2018-03-01,2106,232,1874,62,6
Asthma,Faridabad,Jammu & Kashmir,2018-04-01,2835,111,2724,11,7
Asthma,Faridabad,Jammu & Kashmir,2018-05-01,2627,139,2488,11,4
Asthma,Faridabad,Jammu & Kashmir,2018-06-01,1274,83,1191,87,9
Asthma,Faridabad,Jammu & Kashmir,2018-07-01,3438,170,3268,119,8
Asthma,Faridabad,Jammu & Kashmir,2018-08-01,2532,71,2461,140,5
Asthma,Faridabad,Jammu & Kashmir,2018-09-01,1271,30,1241,37,7
Asthma,Faridabad,Jammu & Kashmir,2018-10-01,4989,280,4709,38,4
Asthma,Faridabad,Jammu & Kashmir,2018-11-01,3237,61,3176,79,6
Asthma,Faridabad,Jammu & Kashmir,2018-12-01,2392,43,2349,106,7
Asthma,Faridabad,Jammu & Kashmir,2019-01-01,4496,276,4220,158,6
Asthma,Faridabad,Jammu & Kashmir,2019-02-01,4989,235,4754,143,2
Asthma,Faridabad,Jammu & Kashmir,2019-03-01,2402,185,2217,87,1
Asthma,Faridabad,Jammu & Kashmir,2019-04-01,3063,115,2948,125,6
Asthma,Faridabad,Jammu & Kashmir,2019-05-01,1272,42,1230,63,3
Asthma,Faridabad,Jammu & Kashmir,2019-06-01,2400,149,2251,110,8
Asthma,Faridabad,Jammu & Kashmir,2019-07-01,2330,61,2269,103,1
Asthma,Faridabad,Jammu & Kashmir,2019-08-01,2845,87,2758,178,9
Asthma,Faridabad,Jammu & Kashmir,2019-09-01,3044,97,2947,131,5
Asthma,Faridabad,Jammu & Kashmir,2019-10-01,3348,147,3201,67,2
Asthma,Faridabad,Jammu & Kashmir,2019-11-01,2916,296,2620,67,4
Asthma,Faridabad,Jammu & Kashmir,2019-12-01,973,9,964,89,4
Asthma,Faridabad,Jammu & Kashmir,2020-01-01,1338,117,1221,27,6
Asthma,Faridabad,Jammu & Kashmir,2020-02-01,1864,133,1731,94,1
Asthma,Faridabad,Jammu & Kashmir,2020-03-01,2219,212,2007,99,2
Asthma,Faridabad,Jammu & Kashmir,2020-04-01,4007,442,3565,130,4
Asthma,Faridabad,Jammu & Kashmir,2020-05-01,1037,95,942,137,5
Asthma,Faridabad,Jammu & Kashmir,2020-06-01,2118,163,1955,111,7
Asthma,Faridabad,Jammu & Kashmir,2020-07-01,3876,46,3830,23,6
Asthma,Faridabad,Jammu & Kashmir,2020-08-01,2195,34,2161,44,4
Asthma,Faridabad,Jammu & Kashmir,2020-09-01,3215,194,3021,75,6
Asthma,Faridabad,Jammu & Kashmir,2020-10-01,2410,1,2409,139,5
Asthma,Faridabad,Jammu & Kashmir,2020-11-01,2942,200,2742,138,4
Asthma,Faridabad,Jammu & Kashmir,2020-12-01,2291,0,2291,94,5
Asthma,Faridabad,Jammu & Kashmir,2021-01-01,3492,291,3201,200,1
Asthma,Faridabad,Jammu & Kashmir,2021-02-01,525,21,504,186,8
Asthma,Faridabad,Jammu & Kashmir,2021-03-01,2110,113,1997,169,6
Asthma,Faridabad,Jammu & Kashmir,2021-04-01,2995,84,2911,142,9
Asthma,Faridabad,Jammu & Kashmir,2021-05-01,3313,0,3313,130,2
Asthma,Faridabad,Jammu & Kashmir,2021-06-01,4600,395,4205,126,6
Asthma,Faridabad,Jammu & Kashmir,2021-07-01,2073,184,1889,14,1
Asthma,Faridabad,Jammu & Kashmir,2021-08-01,4582,182,4400,53,1
Asthma,Faridabad,Jammu & Kashmir,2021-09-01,1713,118,1595,95,4
Asthma,Faridabad,Jammu & Kashmir,2021-10-01,4380,169,4211,113,3
Asthma,Faridabad,Jammu & Kashmir,2021-11-01,3694,215,3479,100,8
Asthma,Faridabad,Jammu & Kashmir,2021-12-01,1372,99,1273,120,8
Asthma,Faridabad,Jammu & Kashmir,2022-01-01,3009,199,2810,11,9
Asthma,Faridabad,Jammu & Kashmir,2022-02-01,2529,225,2304,132,7
Asthma,Faridabad,Jammu & Kashmir,2022-03-01,3437,223,3214,109,7
Asthma,Faridabad,Jammu & Kashmir,2022-04-01,2298,116,2182,97,1
Asthma,Faridabad,Jammu & Kashmir,2022-05-01,2185,60,2125,153,9
Asthma,Faridabad,Jammu & Kashmir,2022-06-01,4434,160,4274,53,8
Asthma,Faridabad,Jammu & Kashmir,2022-07-01,2465,181,2284,94,1
Asthma,Faridabad,Jammu & Kashmir,2022-08-01,3706,23,3683,121,6
Asthma,Faridabad,Jammu & Kashmir,2022-09-01,2295,188,2107,63,3
Asthma,Faridabad,Jammu & Kashmir,2022-10-01,4833,202,4631,11,10
Asthma,Faridabad,Jammu & Kashmir,2022-11-01,1687,44,1643,47,2
Asthma,Faridabad,Jammu & Kashmir,2022-12-01,1774,32,1742,103,5
Asthma,Faridabad,Jammu & Kashmir,2023-01-01,4643,323,4320,94,5
Asthma,Faridabad,Jammu & Kashmir,2023-02-01,2001,99,1902,105,5
Asthma,Faridabad,Jammu & Kashmir,2023-03-01,4745,442,4303,73,10
Asthma,Faridabad,Jammu & Kashmir,2023-04-01,3794,50,3744,39,10
Asthma,Faridabad,Jammu & Kashmir,2023-05-01,2390,79,2311,113,1
Asthma,Faridabad,Jammu & Kashmir,2023-06-01,165,7,158,98,6
Asthma,Faridabad,Jammu & Kashmir,2023-07-01,2571,72,2499,139,5
Asthma,Faridabad,Jammu & Kashmir,2023-08-01,2734,137,2597,68,7
Asthma,Faridabad,Jammu & Kashmir,2023-09-01,4163,247,3916,11,5
Asthma,Faridabad,Jammu & Kashmir,2023-10-01,4728,303,4425,11,2
Asthma,Faridabad,Jammu & Kashmir,2023-11-01,1678,157,1521,86,2
Asthma,Faridabad,Jammu & Kashmir,2023-12-01,3672,44,3628,113,4
Asthma,Faridabad,Jammu & Kashmir,2024-01-01,3624,217,3407,94,4
Asthma,Faridabad,Jammu & Kashmir,2024-02-01,4037,126,3911,77,5
Asthma,Faridabad,Jammu & Kashmir,2024-03-01,3266,204,3062,25,3
Asthma,Faridabad,Jammu & Kashmir,2024-04-01,78,0,78,11,10
Asthma,Faridabad,Jammu & Kashmir,2024-05-01,2389,50,2339,125,6
Asthma,Faridabad,Jammu & Kashmir,2024-06-01,1047,24,1023,95,7
Asthma,Faridabad,Jammu & Kashmir,2024-07-01,2326,151,2175,88,4
Asthma,Faridabad,Jammu & Kashmir,2024-08-01,3912,198,3714,28,2
Asthma,Faridabad,Jammu & Kashmir,2024-09-01,3007,131,2876,57,7
Asthma,Faridabad,Jammu & Kashmir,2024-10-01,4138,286,3852,109,2
Asthma,Faridabad,Jammu & Kashmir,2024-11-01,3056,218,2838,121,1
Asthma,Faridabad,Jammu & Kashmir,2024-12-01,856,29,827,98,6
Asthma,Faridabad,Jammu & Kashmir,2025-01-01,78,0,78,176,3
Asthma,Faridabad,Jammu & Kashmir,2025-02-01,2797,37,2760,77,4
Asthma,Faridabad,Jammu & Kashmir,2025-03-01,2310,117,2193,172,7
Asthma,Faridabad,Jammu & Kashmir,2025-04-01,1287,11,1276,117,2
Asthma,Faridabad,Jammu & Kashmir,2025-05-01,316,16,300,112,1
Asthma,Faridabad,Jammu & Kashmir,2025-06-01,1612,137,1475,154,8
Asthma,Faridabad,Jammu & Kashmir,2025-07-01,2336,92,2244,74,5
Asthma,Faridabad,Jammu & Kashmir,2025-08-01,3491,120,3371,89,8
Asthma,Faridabad,Jammu & Kashmir,2025-09-01,2850,308,2542,44,7
Asthma,Faridabad,Jammu & Kashmir,2025-10-01,4755,442,4313,154,7
Asthma,Faridabad,Jammu & Kashmir,2025-11-01,1208,33,1175,123,5
Asthma,Faridabad,Jammu & Kashmir,2025-12-01,3779,204,3575,162,5
Asthma,Faridabad,Haryana,2018-01-01,2661,158,2503,117,8
Asthma,Faridabad,Haryana,2018-02-01,3529,197,3332,162,7
Asthma,Faridabad,Haryana,2018-03-01,2012,207,1805,68,3
Asthma,Faridabad,Haryana,2018-04-01,4035,212,3823,157,6
Asthma,Faridabad,Haryana,2018-05-01,2993,170,2823,86,3
Asthma,Faridabad,Haryana,2018-06-01,1686,118,1568,106,4
Asthma,Faridabad,Haryana,2018-07-01,2581,218,2363,143,6
Asthma,Faridabad,Haryana,2018-08-01,2276,176,2100,200,3
Asthma,Faridabad,Haryana,2018-09-01,3254,213,3041,148,5
Asthma,Faridabad,Haryana,2018-10-01,1015,4,1011,153,6
Asthma,Faridabad,Haryana,2018-11-01,2558,91,2467,78,4
Asthma,Faridabad,Haryana,2018-12-01,3128,231,2897,114,7
Asthma,Faridabad,Haryana,2019-01-01,2642,151,2491,101,4
Asthma,Faridabad,Haryana,2019-02-01,4404,326,4078,178,8
Asthma,Faridabad,Haryana,2019-03-01,3636,381,3255,99,5
Asthma,Faridabad,Haryana,2019-04-01,2587,40,2547,174,5
Asthma,Faridabad,Haryana,2019-05-01,2888,240,2648,40,2
Asthma,Faridabad,Haryana,2019-06-01,2994,121,2873,177,4
Asthma,Faridabad,Haryana,2019-07-01,3138,242,2896,62,5
Asthma,Faridabad,Haryana,2019-08-01,148,7,141,150,8
Asthma,Faridabad,Haryana,2019-09-01,2193,245,1948,62,4
Asthma,Faridabad,Haryana,2019-10-01,606,32,574,138,8
Asthma,Faridabad,Haryana,2019-11-01,4312,135,4177,57,3
Asthma,Faridabad,Haryana,2019-12-01,2516,156,2360,159,6
Asthma,Faridabad,Haryana,2020-01-01,2338,139,2199,149,3
Asthma,Faridabad,Haryana,2020-02-01,3800,316,3484,76,9
Asthma,Faridabad,Haryana,2020-03-01,3164,199,2965,136,9
Asthma,Faridabad,Haryana,2020-04-01,1083,132,951,154,6
Asthma,Faridabad,Haryana,2020-05-01,2502,117,2385,59,3
Asthma,Faridabad,Haryana,2020-06-01,2148,101,2047,54,1
Asthma,Faridabad,Haryana,2020-07-01,257,8,249,52,6
Asthma,Faridabad,Haryana,2020-08-01,1671,87,1584,44,5
Asthma,Faridabad,Haryana,2020-09-01,2351,133,2218,51,7
Asthma,Faridabad,Haryana,2020-10-01,2443,142,2301,153,1
Asthma,Faridabad,Haryana,2020-11-01,609,31,578,135,5
Asthma,Faridabad,Haryana,2020-12-01,4142,133,4009,20,6
Asthma,Faridabad,Haryana,2021-01-01,2460,60,2400,80,2
Asthma,Faridabad,Haryana,2021-02-01,2648,103,2545,47,5
Asthma,Faridabad,Haryana,2021-03-01,3135,261,2874,150,3
Asthma,Faridabad,Haryana,2021-04-01,1540,137,1403,83,2
Asthma,Faridabad,Haryana,2021-05-01,3210,153,3057,28,3
Asthma,Faridabad,Haryana,2021-06-01,2105,47,2058,115,4
Asthma,Faridabad,Haryana,2021-07-01,1395,66,1329,137,8
Asthma,Faridabad,Haryana,2021-08-01,3367,373,2994,58,4
Asthma,Faridabad,Haryana,2021-09-01,4598,363,4235,93,2
Asthma,Faridabad,Haryana,2021-10-01,3570,235,3335,60,7
Asthma,Faridabad,Haryana,2021-11-01,3836,299,3537,170,8
Asthma,Faridabad,Haryana,2021-12-01,1899,180,1719,84,7
Asthma,Faridabad,Haryana,2022-01-01,454,7,447,69,9
Asthma,Faridabad,Haryana,2022-02-01,4596,177,4419,104,5
Asthma,Faridabad,Haryana,2022-03-01,4989,173,4816,96,5
Asthma,Faridabad,Haryana,2022-04-01,4667,313,4354,141,3
Asthma,Faridabad,Haryana,2022-05-01,2147,117,2030,168,9
Asthma,Faridabad,Haryana,2022-06-01,1048,75,973,169,5
Asthma,Faridabad,Haryana,2022-07-01,1168,41,1127,87,4
Asthma,Faridabad,Haryana,2022-08-01,339,30,309,122,4
Asthma,Faridabad,Haryana,2022-09-01,2453,117,2336,182,7
Asthma,Faridabad,Haryana,2022-10-01,4751,333,4418,184,5
Asthma,Faridabad,Haryana,2022-11-01,2407,204,2203,62,5
Asthma,Faridabad,Haryana,2022-12-01,3003,247,2756,136,4
Asthma,Faridabad,Haryana,2023-01-01,4443,269,4174,128,4
Asthma,Faridabad,Haryana,2023-02-01,2055,151,1904,153,4
Asthma,Faridabad,Haryana,2023-03-01,4989,442,4547,170,9
Asthma,Faridabad,Haryana,2023-04-01,4989,324,4665,53,1
Asthma,Faridabad,Haryana,2023-05-01,2422,69,2353,71,6
Asthma,Faridabad,Haryana,2023-06-01,1823,122,1701,152,8
Asthma,Faridabad,Haryana,2023-07-01,3533,173,3360,114,1
Asthma,Faridabad,Haryana,2023-08-01,2131,0,2131,11,5
Asthma,Faridabad,Haryana,2023-09-01,1046,66,980,21,8
Asthma,Faridabad,Haryana,2023-10-01,4316,230,4086,140,3
Asthma,Faridabad,Haryana,2023-11-01,4229,354,3875,149,6
Asthma,Faridabad,Haryana,2023-12-01,2806,79,2727,37,2
Asthma,Faridabad,Haryana,2024-01-01,903,5,898,162,5
Asthma,Faridabad,Haryana,2024-02-01,948,52,896,96,9
Asthma,Faridabad,Haryana,2024-03-01,2741,167,2574,54,10
Asthma,Faridabad,Haryana,2024-04-01,1927,101,1826,78,6
Asthma,Faridabad,Haryana,2024-05-01,2140,108,2032,44,1
Asthma,Faridabad,Haryana,2024-06-01,3968,75,3893,75,4
Asthma,Faridabad,Haryana,2024-07-01,3581,164,3417,11,1
Asthma,Faridabad,Haryana,2024-08-01,4446,177,4269,102,4
Asthma,Faridabad,Haryana,2024-09-01,1268,103,1165,136,8
Asthma,Faridabad,Haryana,2024-10-01,2137,130,2007,38,1
Asthma,Faridabad,Haryana,2024-11-01,3616,151,3465,107,4
Asthma,Faridabad,Haryana,2024-12-01,3199,320,2879,65,2
Asthma,Faridabad,Haryana,2025-01-01,4653,196,4457,140,10
Asthma,Faridabad,Haryana,2025-02-01,3162,209,2953,11,6
Asthma,Faridabad,Haryana,2025-03-01,4989,225,4764,142,7
Asthma,Faridabad,Haryana,2025-04-01,3322,324,2998,14,6
Asthma,Faridabad,Haryana,2025-05-01,4022,211,3811,96,7
Asthma,Faridabad,Haryana,2025-06-01,2163,115,2048,70,8
Asthma,Faridabad,Haryana,2025-07-01,2617,120,2497,88,5
Asthma,Faridabad,Haryana,2025-08-01,3819,213,3606,28,3
Asthma,Faridabad,Haryana,2025-09-01,4761,404,4357,191,2
Asthma,Faridabad,Haryana,2025-10-01,3576,267,3309,41,10
Asthma,Faridabad,Haryana,2025-11-01,2486,126,2360,45,7
Asthma,Faridabad,Haryana,2025-12-01,4445,442,4003,198,1
Asthma,Panchkula,Punjab,2018-01-01,78,0,78,123,4
Asthma,Panchkula,Punjab,2018-02-01,689,25,664,42,6
Asthma,Panchkula,Punjab,2018-03-01,3512,34,3478,100,10
Asthma,Panchkula,Punjab,2018-04-01,2616,99,2517,94,2
Asthma,Panchkula,Punjab,2018-05-01,3410,211,3199,20,6
Asthma,Panchkula,Punjab,2018-06-01,2684,181,2503,68,4
Asthma,Panchkula,Punjab,2018-07-01,3363,301,3062,105,1
Asthma,Panchkula,Punjab,2018-08-01,1505,27,1478,171,9
Asthma,Panchkula,Punjab,2018-09-01,3363,125,3238,97,2
Asthma,Panchkula,Punjab,2018-10-01,3931,62,3869,100,8
Asthma,Panchkula,Punjab,2018-11-01,4235,47,4188,65,1
Asthma,Panchkula,Punjab,2018-12-01,4989,158,4831,162,3
Asthma,Panchkula,Punjab,2019-01-01,2925,177,2748,152,6
Asthma,Panchkula,Punjab,2019-02-01,2965,215,2750,146,7
Asthma,Panchkula,Punjab,2019-03-01,554,12,542,112,6
Asthma,Panchkula,Punjab,2019-04-01,1885,49,1836,25,8
Asthma,Panchkula,Punjab,2019-05-01,2338,0,2338,162,4
Asthma,Panchkula,Punjab,2019-06-01,4006,225,3781,109,9
Asthma,Panchkula,Punjab,2019-07-01,1778,51,1727,90,6
Asthma,Panchkula,Punjab,2019-08-01,3666,361,3305,129,7
Asthma,Panchkula,Punjab,2019-09-01,2595,160,2435,118,6
Asthma,Panchkula,Punjab,2019-10-01,2360,106,2254,52,6
Asthma,Panchkula,Punjab,2019-11-01,2931,92,2839,90,2
Asthma,Panchkula,Punjab,2019-12-01,2073,13,2060,11,2
Asthma,Panchkula,Punjab,2020-01-01,2022,20,2002,111,3
Asthma,Panchkula,Punjab,2020-02-01,310,9,301,174,6
Asthma,Panchkula,Punjab,2020-03-01,2265,67,2198,15,3
Asthma,Panchkula,Punjab,2020-04-01,1954,41,1913,113,4
Asthma,Panchkula,Punjab,2020-05-01,1905,116,1789,140,5
Asthma,Panchkula,Punjab,2020-06-01,3157,205,2952,148,9
Asthma,Panchkula,Punjab,2020-07-01,3481,127,3354,68,7
Asthma,Panchkula,Punjab,2020-08-01,2909,309,2600,50,1
Asthma,Panchkula,Punjab,2020-09-01,3933,0,3933,76,5
Asthma,Panchkula,Punjab,2020-10-01,3370,174,3196,167,4
Asthma,Panchkula,Punjab,2020-11-01,2202,96,2106,19,4
Asthma,Panchkula,Punjab,2020-12-01,1976,67,1909,44,5
Asthma,Panchkula,Punjab,2021-01-01,3017,89,2928,83,8
Asthma,Panchkula,Punjab,2021-02-01,3367,167,3200,57,2
Asthma,Panchkula,Punjab,2021-03-01,4473,194,4279,104,5
Asthma,Panchkula,Punjab,2021-04-01,4195,162,4033,178,6
Asthma,Panchkula,Punjab,2021-05-01,1871,22,1849,45,4
Asthma,Panchkula,Punjab,2021-06-01,2461,7,2454,99,3
Asthma,Panchkula,Punjab,2021-07-01,3498,145,3353,106,3
Asthma,Panchkula,Punjab,2021-08-01,4030,154,3876,89,4
Asthma,Panchkula,Punjab,2021-09-01,3857,171,3686,26,7
Asthma,Panchkula,Punjab,2021-10-01,2512,117,2395,74,4
Asthma,Panchkula,Punjab,2021-11-01,915,31,884,74,5
Asthma,Panchkula,Punjab,2021-12-01,1257,55,1202,138,1
Asthma,Panchkula,Punjab,2022-01-01,2963,74,2889,128,3
Asthma,Panchkula,Punjab,2022-02-01,3057,288,2769,27,5
Asthma,Panchkula,Punjab,2022-03-01,1124,30,1094,86,1
Asthma,Panchkula,Punjab,2022-04-01,2657,104,2553,81,8
Asthma,Panchkula,Punjab,2022-05-01,3444,99,3345,200,3
Asthma,Panchkula,Punjab,2022-06-01,1053,30,1023,121,10
Asthma,Panchkula,Punjab,2022-07-01,4080,207,3873,51,6
Asthma,Panchkula,Punjab,2022-08-01,2091,98,1993,67,1
Asthma,Panchkula,Punjab,2022-09-01,4285,157,4128,87,6
Asthma,Panchkula,Punjab,2022-10-01,1882,78,1804,125,4
Asthma,Panchkula,Punjab,2022-11-01,1220,35,1185,131,6
Asthma,Panchkula,Punjab,2022-12-01,1983,122,1861,116,10
Asthma,Panchkula,Punjab,2023-01-01,2470,271,2199,96,7
Asthma,Panchkula,Punjab,2023-02-01,2076,51,2025,99,4
Asthma,Panchkula,Punjab,2023-03-01,2308,142,2166,100,1
Asthma,Panchkula,Punjab,2023-04-01,3045,156,2889,15,7
Asthma,Panchkula,Punjab,2023-05-01,2368,164,2204,103,6
Asthma,Panchkula,Punjab,2023-06-01,2509,176,2333,77,8
Asthma,Panchkula,Punjab,2023-07-01,304,17,287,22,4
Asthma,Panchkula,Punjab,2023-08-01,3123,152,2971,200,6
Asthma,Panchkula,Punjab,2023-09-01,2478,92,2386,122,4
Asthma,Panchkula,Punjab,2023-10-01,4758,132,4626,107,5
Asthma,Panchkula,Punjab,2023-11-01,1337,63,1274,87,1
Asthma,Panchkula,Punjab,2023-12-01,172,2,170,143,6
Asthma,Panchkula,Punjab,2024-01-01,3427,112,3315,47,6
Asthma,Panchkula,Punjab,2024-02-01,3062,251,2811,90,3
Asthma,Panchkula,Punjab,2024-03-01,1245,65,1180,58,7
Asthma,Panchkula,Punjab,2024-04-01,545,41,504,143,7
Asthma,Panchkula,Punjab,2024-05-01,4660,432,4228,64,9
Asthma,Panchkula,Punjab,2024-06-01,4494,201,4293,162,2
Asthma,Panchkula,Punjab,2024-07-01,78,0,78,101,7
Asthma,Panchkula,Punjab,2024-08-01,1983,81,1902,146,9
Asthma,Panchkula,Punjab,2024-09-01,4830,127,4703,127,4
Asthma,Panchkula,Punjab,2024-10-01,1959,43,1916,160,9
Asthma,Panchkula,Punjab,2024-11-01,1939,144,1795,59,3
Asthma,Panchkula,Punjab,2024-12-01,2218,124,2094,152,5
Asthma,Panchkula,Punjab,2025-01-01,1094,113,981,11,1
Asthma,Panchkula,Punjab,2025-02-01,310,24,286,108,1
Asthma,Panchkula,Punjab,2025-03-01,4009,115,3894,78,1
Asthma,Panchkula,Punjab,2025-04-01,125,9,116,35,9
Asthma,Panchkula,Punjab,2025-05-01,2929,120,2809,61,3
Asthma,Panchkula,Punjab,2025-06-01,3787,323,3464,74,3
Asthma,Panchkula,Punjab,2025-07-01,651,23,628,96,6
Asthma,Panchkula,Punjab,2025-08-01,1357,26,1331,79,3
Asthma,Panchkula,Punjab,2025-09-01,4225,113,4112,110,8
Asthma,Panchkula,Punjab,2025-10-01,3312,94,3218,64,10
Asthma,Panchkula,Punjab,2025-11-01,1769,45,1724,82,1
Asthma,Panchkula,Punjab,2025-12-01,4210,140,4070,91,6
Asthma,Panchkula,Chandigarh,2018-01-01,4216,316,3900,115,1
Asthma,Panchkula,Chandigarh,2018-02-01,2958,302,2656,149,1
Asthma,Panchkula,Chandigarh,2018-03-01,1390,15,1375,150,6
Asthma,Panchkula,Chandigarh,2018-04-01,2043,177,1866,118,2
Asthma,Panchkula,Chandigarh,2018-05-01,2982,107,2875,128,6
Asthma,Panchkula,Chandigarh,2018-06-01,2344,141,2203,122,5
Asthma,Panchkula,Chandigarh,2018-07-01,3857,7,3850,90,1
Asthma,Panchkula,Chandigarh,2018-08-01,545,35,510,152,7
Asthma,Panchkula,Chandigarh,2018-09-01,593,0,593,60,6
Asthma,Panchkula,Chandigarh,2018-10-01,2840,168,2672,11,5
Asthma,Panchkula,Chandigarh,2018-11-01,1938,111,1827,53,3
Asthma,Panchkula,Chandigarh,2018-12-01,1756,97,1659,178,6
Asthma,Panchkula,Chandigarh,2019-01-01,226,6,220,91,1
Asthma,Panchkula,Chandigarh,2019-02-01,2624,173,2451,120,2
Asthma,Panchkula,Chandigarh,2019-03-01,2527,155,2372,92,6
Asthma,Panchkula,Chandigarh,2019-04-01,3474,152,3322,135,8
Asthma,Panchkula,Chandigarh,2019-05-01,2690,187,2503,110,3
Asthma,Panchkula,Chandigarh,2019-06-01,2420,114,2306,103,6
Asthma,Panchkula,Chandigarh,2019-07-01,4176,273,3903,137,5
Asthma,Panchkula,Chandigarh,2019-08-01,837,38,799,82,6
Asthma,Panchkula,Chandigarh,2019-09-01,3317,187,3130,125,3
Asthma,Panchkula,Chandigarh,2019-10-01,356,23,333,97,4
Asthma,Panchkula,Chandigarh,2019-11-01,1473,56,1417,101,5
Asthma,Panchkula,Chandigarh,2019-12-01,971,13,958,65,9
Asthma,Panchkula,Chandigarh,2020-01-01,3646,211,3435,95,2
Asthma,Panchkula,Chandigarh,2020-02-01,2510,212,2298,79,1
Asthma,Panchkula,Chandigarh,2020-03-01,2579,151,2428,164,10
Asthma,Panchkula,Chandigarh,2020-04-01,1113,66,1047,20,6
Asthma,Panchkula,Chandigarh,2020-05-01,2195,107,2088,152,6
Asthma,Panchkula,Chandigarh,2020-06-01,1573,112,1461,17,7
Asthma,Panchkula,Chandigarh,2020-07-01,3112,138,2974,134,7
Asthma,Panchkula,Chandigarh,2020-08-01,1268,46,1222,64,7
Asthma,Panchkula,Chandigarh,2020-09-01,4381,360,4021,135,7
Asthma,Panchkula,Chandigarh,2020-10-01,350,12,338,100,8
Asthma,Panchkula,Chandigarh,2020-11-01,1515,115,1400,33,5
Asthma,Panchkula,Chandigarh,2020-12-01,4847,398,4449,175,8
Asthma,Panchkula,Chandigarh,2021-01-01,2014,134,1880,146,10
Asthma,Panchkula,Chandigarh,2021-02-01,833,11,822,132,5
Asthma,Panchkula,Chandigarh,2021-03-01,2891,147,2744,74,6
Asthma,Panchkula,Chandigarh,2021-04-01,1960,86,1874,148,3
Asthma,Panchkula,Chandigarh,2021-05-01,1476,52,1424,41,4
Asthma,Panchkula,Chandigarh,2021-06-01,1127,61,1066,11,6
Asthma,Panchkula,Chandigarh,2021-07-01,4989,361,4628,27,4
Asthma,Panchkula,Chandigarh,2021-08-01,2260,82,2178,59,5
Asthma,Panchkula,Chandigarh,2021-09-01,78,0,78,68,6
Asthma,Panchkula,Chandigarh,2021-10-01,4601,198,4403,84,9
Asthma,Panchkula,Chandigarh,2021-11-01,3417,286,3131,86,2
Asthma,Panchkula,Chandigarh,2021-12-01,1569,66,1503,73,6
Asthma,Panchkula,Chandigarh,2022-01-01,1346,19,1327,11,3
Asthma,Panchkula,Chandigarh,2022-02-01,3501,14,3487,116,7
Asthma,Panchkula,Chandigarh,2022-03-01,2266,137,2129,93,7
Asthma,Panchkula,Chandigarh,2022-04-01,78,0,78,71,10
Asthma,Panchkula,Chandigarh,2022-05-01,4989,346,4643,177,4
Asthma,Panchkula,Chandigarh,2022-06-01,2015,22,1993,94,5
Asthma,Panchkula,Chandigarh,2022-07-01,4604,158,4446,109,7
Asthma,Panchkula,Chandigarh,2022-08-01,4312,48,4264,147,7
Asthma,Panchkula,Chandigarh,2022-09-01,1255,78,1177,30,1
Asthma,Panchkula,Chandigarh,2022-10-01,3983,274,3709,105,3
Asthma,Panchkula,Chandigarh,2022-11-01,1723,103,1620,147,6
Asthma,Panchkula,Chandigarh,2022-12-01,93,1,92,102,4
Asthma,Panchkula,Chandigarh,2023-01-01,2028,57,1971,40,7
Asthma,Panchkula,Chandigarh,2023-02-01,3131,178,2953,82,8
Asthma,Panchkula,Chandigarh,2023-03-01,1977,1,1976,116,4
Asthma,Panchkula,Chandigarh,2023-04-01,2185,94,2091,11,7
Asthma,Panchkula,Chandigarh,2023-05-01,4132,389,3743,37,9
Asthma,Panchkula,Chandigarh,2023-06-01,2740,122,2618,200,8
Asthma,Panchkula,Chandigarh,2023-07-01,1466,9,1457,131,3
Asthma,Panchkula,Chandigarh,2023-08-01,3539,114,3425,182,4
Asthma,Panchkula,Chandigarh,2023-09-01,2863,90,2773,150,5
Asthma,Panchkula,Chandigarh,2023-10-01,78,0,78,126,2
Asthma,Panchkula,Chandigarh,2023-11-01,3172,312,2860,90,8
Asthma,Panchkula,Chandigarh,2023-12-01,3123,222,2901,126,3
Asthma,Panchkula,Chandigarh,2024-01-01,2624,105,2519,180,5
Asthma,Panchkula,Chandigarh,2024-02-01,3794,322,3472,148,8
Asthma,Panchkula,Chandigarh,2024-03-01,1695,28,1667,115,4
Asthma,Panchkula,Chandigarh,2024-04-01,3049,248,2801,97,4
Asthma,Panchkula,Chandigarh,2024-05-01,495,38,457,132,6
Asthma,Panchkula,Chandigarh,2024-06-01,3144,143,3001,79,4
Asthma,Panchkula,Chandigarh,2024-07-01,4989,415,4574,132,9
Asthma,Panchkula,Chandigarh,2024-08-01,1263,46,1217,71,2
Asthma,Panchkula,Chandigarh,2024-09-01,1578,20,1558,88,1
Asthma,Panchkula,Chandigarh,2024-10-01,1645,129,1516,54,7
Asthma,Panchkula,Chandigarh,2024-11-01,2772,131,2641,84,4
Asthma,Panchkula,Chandigarh,2024-12-01,1171,79,1092,71,2
Asthma,Panchkula,Chandigarh,2025-01-01,3163,326,2837,192,6
Asthma,Panchkula,Chandigarh,2025-02-01,3733,108,3625,61,6
Asthma,Panchkula,Chandigarh,2025-03-01,3314,152,3162,126,3
Asthma,Panchkula,Chandigarh,2025-04-01,225,21,204,58,8
Asthma,Panchkula,Chandigarh,2025-05-01,3932,273,3659,109,7
Asthma,Panchkula,Chandigarh,2025-06-01,3855,114,3741,121,10
Asthma,Panchkula,Chandigarh,2025-07-01,3711,82,3629,12,3
Asthma,Panchkula,Chandigarh,2025-08-01,3098,107,2991,35,5
Asthma,Panchkula,Chandigarh,2025-09-01,2893,82,2811,58,5
Asthma,Panchkula,Chandigarh,2025-10-01,3982,226,3756,40,4
Asthma,Panchkula,Chandigarh,2025-11-01,4989,261,4728,110,6
Asthma,Panchkula,Chandigarh,2025-12-01,1319,76,1243,119,6
Asthma,Panchkula,Himachal Pradesh,2018-01-01,4044,103,3941,52,6
Asthma,Panchkula,Himachal Pradesh,2018-02-01,2482,119,2363,113,4
Asthma,Panchkula,Himachal Pradesh,2018-03-01,2423,0,2423,85,4
Asthma,Panchkula,Himachal Pradesh,2018-04-01,536,29,507,101,3
Asthma,Panchkula,Himachal Pradesh,2018-05-01,2215,186,2029,74,3
Asthma,Panchkula,Himachal Pradesh,2018-06-01,1260,10,1250,131,5
Asthma,Panchkula,Himachal Pradesh,2018-07-01,1975,126,1849,190,9
Asthma,Panchkula,Himachal Pradesh,2018-08-01,1124,36,1088,146,10
Asthma,Panchkula,Himachal Pradesh,2018-09-01,1995,146,1849,177,9
Asthma,Panchkula,Himachal Pradesh,2018-10-01,2053,112,1941,35,3
Asthma,Panchkula,Himachal Pradesh,2018-11-01,2727,168,2559,72,6
Asthma,Panchkula,Himachal Pradesh,2018-12-01,431,22,409,135,1
Asthma,Panchkula,Himachal Pradesh,2019-01-01,658,58,600,183,4
Asthma,Panchkula,Himachal Pradesh,2019-02-01,3083,185,2898,139,4
Asthma,Panchkula,Himachal Pradesh,2019-03-01,1528,45,1483,54,10
Asthma,Panchkula,Himachal Pradesh,2019-04-01,4039,213,3826,84,6
Asthma,Panchkula,Himachal Pradesh,2019-05-01,2900,114,2786,123,5
Asthma,Panchkula,Himachal Pradesh,2019-06-01,3411,186,3225,98,5
Asthma,Panchkula,Himachal Pradesh,2019-07-01,4490,169,4321,66,4
Asthma,Panchkula,Himachal Pradesh,2019-08-01,2182,66,2116,91,6
Asthma,Panchkula,Himachal Pradesh,2019-09-01,1827,102,1725,105,3
Asthma,Panchkula,Himachal Pradesh,2019-10-01,3767,194,3573,51,6
Asthma,Panchkula,Himachal Pradesh,2019-11-01,3281,265,3016,156,9
Asthma,Panchkula,Himachal Pradesh,2019-12-01,2346,89,2257,84,5
Asthma,Panchkula,Himachal Pradesh,2020-01-01,4464,0,4464,103,4
Asthma,Panchkula,Himachal Pradesh,2020-02-01,2313,91,2222,159,5
Asthma,Panchkula,Himachal Pradesh,2020-03-01,2641,7,2634,100,8
Asthma,Panchkula,Himachal Pradesh,2020-04-01,2626,163,2463,156,5
Asthma,Panchkula,Himachal Pradesh,2020-05-01,1344,1,1343,54,3
Asthma,Panchkula,Himachal Pradesh,2020-06-01,2701,57,2644,128,7
Asthma,Panchkula,Himachal Pradesh,2020-07-01,4471,176,4295,149,3
Asthma,Panchkula,Himachal Pradesh,2020-08-01,3194,303,2891,64,4
Asthma,Panchkula,Himachal Pradesh,2020-09-01,2639,49,2590,97,5
Asthma,Panchkula,Himachal Pradesh,2020-10-01,2380,120,2260,98,2
Asthma,Panchkula,Himachal Pradesh,2020-11-01,3041,203,2838,117,1
Asthma,Panchkula,Himachal Pradesh,2020-12-01,3603,336,3267,130,6
Asthma,Panchkula,Himachal Pradesh,2021-01-01,3415,248,3167,60,1
Asthma,Panchkula,Himachal Pradesh,2021-02-01,2152,176,1976,103,2
Asthma,Panchkula,Himachal Pradesh,2021-03-01,3033,228,2805,187,7
Asthma,Panchkula,Himachal Pradesh,2021-04-01,3241,48,3193,160,6
Asthma,Panchkula,Himachal Pradesh,2021-05-01,1246,75,1171,147,4
Asthma,Panchkula,Himachal Pradesh,2021-06-01,2823,211,2612,96,2
Asthma,Panchkula,Himachal Pradesh,2021-07-01,78,0,78,200,4
Asthma,Panchkula,Himachal Pradesh,2021-08-01,3245,107,3138,159,6
Asthma,Panchkula,Himachal Pradesh,2021-09-01,3483,92,3391,108,4
Asthma,Panchkula,Himachal Pradesh,2021-10-01,3600,261,3339,117,1
Asthma,Panchkula,Himachal Pradesh,2021-11-01,2067,99,1968,83,2
Asthma,Panchkula,Himachal Pradesh,2021-12-01,3012,122,2890,126,4
Asthma,Panchkula,Himachal Pradesh,2022-01-01,4508,57,4451,136,6
Asthma,Panchkula,Himachal Pradesh,2022-02-01,4494,216,4278,142,5
Asthma,Panchkula,Himachal Pradesh,2022-03-01,2558,85,2473,97,1
Asthma,Panchkula,Himachal Pradesh,2022-04-01,2784,159,2625,31,9
Asthma,Panchkula,Himachal Pradesh,2022-05-01,4088,68,4020,119,3
Asthma,Panchkula,Himachal Pradesh,2022-06-01,584,32,552,142,6
Asthma,Panchkula,Himachal Pradesh,2022-07-01,2164,80,2084,56,2
Asthma,Panchkula,Himachal Pradesh,2022-08-01,4389,60,4329,102,10
Asthma,Panchkula,Himachal Pradesh,2022-09-01,3906,44,3862,175,9
Asthma,Panchkula,Himachal Pradesh,2022-10-01,3093,48,3045,45,3
Asthma,Panchkula,Himachal Pradesh,2022-11-01,577,25,552,92,5
Asthma,Panchkula,Himachal Pradesh,2022-12-01,2530,135,2395,182,2
Asthma,Panchkula,Himachal Pradesh,2023-01-01,1806,104,1702,114,4
Asthma,Panchkula,Himachal Pradesh,2023-02-01,3041,179,2862,79,6
Asthma,Panchkula,Himachal Pradesh,2023-03-01,1512,42,1470,106,7
Asthma,Panchkula,Himachal Pradesh,2023-04-01,1221,98,1123,148,1
Asthma,Panchkula,Himachal Pradesh,2023-05-01,78,0,78,96,3
Asthma,Panchkula,Himachal Pradesh,2023-06-01,4236,267,3969,137,8
Asthma,Panchkula,Himachal Pradesh,2023-07-01,2061,93,1968,118,9
Asthma,Panchkula,Himachal Pradesh,2023-08-01,2808,171,2637,122,3
Asthma,Panchkula,Himachal Pradesh,2023-09-01,2594,113,2481,140,8
Asthma,Panchkula,Himachal Pradesh,2023-10-01,1165,71,1094,91,1
Asthma,Panchkula,Himachal Pradesh,2023-11-01,908,45,863,58,4
Asthma,Panchkula,Himachal Pradesh,2023-12-01,1249,92,1157,130,1
Asthma,Panchkula,Himachal Pradesh,2024-01-01,1627,42,1585,99,4
Asthma,Panchkula,Himachal Pradesh,2024-02-01,3089,0,3089,83,10
Asthma,Panchkula,Himachal Pradesh,2024-03-01,1530,33,1497,133,5
Asthma,Panchkula,Himachal Pradesh,2024-04-01,4940,401,4539,171,4
Asthma,Panchkula,Himachal Pradesh,2024-05-01,3975,181,3794,98,3
Asthma,Panchkula,Himachal Pradesh,2024-06-01,3682,194,3488,107,4
Asthma,Panchkula,Himachal Pradesh,2024-07-01,2437,47,2390,46,2
Asthma,Panchkula,Himachal Pradesh,2024-08-01,4629,240,4389,95,5
Asthma,Panchkula,Himachal Pradesh,2024-09-01,2305,46,2259,117,5
Asthma,Panchkula,Himachal Pradesh,2024-10-01,2555,62,2493,105,3
Asthma,Panchkula,Himachal Pradesh,2024-11-01,2825,108,2717,88,3
Asthma,Panchkula,Himachal Pradesh,2024-12-01,3539,223,3316,143,5
Asthma,Panchkula,Himachal Pradesh,2025-01-01,3452,228,3224,109,3
Asthma,Panchkula,Himachal Pradesh,2025-02-01,1960,131,1829,200,4
Asthma,Panchkula,Himachal Pradesh,2025-03-01,1882,7,1875,117,4
Asthma,Panchkula,Himachal Pradesh,2025-04-01,3456,172,3284,11,1
Asthma,Panchkula,Himachal Pradesh,2025-05-01,3557,157,3400,50,7
Asthma,Panchkula,Himachal Pradesh,2025-06-01,2070,11,2059,133,1
Asthma,Panchkula,Himachal Pradesh,2025-07-01,468,23,445,73,1
Asthma,Panchkula,Himachal Pradesh,2025-08-01,2319,99,2220,77,7
Asthma,Panchkula,Himachal Pradesh,2025-09-01,3434,223,3211,43,2
Asthma,Panchkula,Himachal Pradesh,2025-10-01,4989,261,4728,82,1
Asthma,Panchkula,Himachal Pradesh,2025-11-01,990,33,957,116,9
Asthma,Panchkula,Himachal Pradesh,2025-12-01,2025,155,1870,126,3
Asthma,Panchkula,Jammu & Kashmir,2018-01-01,2075,0,2075,54,8
Asthma,Panchkula,Jammu & Kashmir,2018-02-01,4416,212,4204,147,2
Asthma,Panchkula,Jammu & Kashmir,2018-03-01,2551,0,2551,46,1
Asthma,Panchkula,Jammu & Kashmir,2018-04-01,1380,32,1348,129,4
Asthma,Panchkula,Jammu & Kashmir,2018-05-01,3347,218,3129,123,1
Asthma,Panchkula,Jammu & Kashmir,2018-06-01,2055,26,2029,59,6
Asthma,Panchkula,Jammu & Kashmir,2018-07-01,955,8,947,53,7
Asthma,Panchkula,Jammu & Kashmir,2018-08-01,1400,167,1233,126,8
Asthma,Panchkula,Jammu & Kashmir,2018-09-01,4924,51,4873,78,4
Asthma,Panchkula,Jammu & Kashmir,2018-10-01,3113,305,2808,97,9
Asthma,Panchkula,Jammu & Kashmir,2018-11-01,2742,123,2619,141,2
Asthma,Panchkula,Jammu & Kashmir,2018-12-01,2262,78,2184,131,5
Asthma,Panchkula,Jammu & Kashmir,2019-01-01,2989,198,2791,60,4
Asthma,Panchkula,Jammu & Kashmir,2019-02-01,2973,264,2709,103,10
Asthma,Panchkula,Jammu & Kashmir,2019-03-01,2989,49,2940,59,8
Asthma,Panchkula,Jammu & Kashmir,2019-04-01,2751,96,2655,151,5
Asthma,Panchkula,Jammu & Kashmir,2019-05-01,3763,281,3482,184,5
Asthma,Panchkula,Jammu & Kashmir,2019-06-01,2628,153,2475,63,9
Asthma,Panchkula,Jammu & Kashmir,2019-07-01,1285,105,1180,105,3
Asthma,Panchkula,Jammu & Kashmir,2019-08-01,1776,115,1661,153,1
Asthma,Panchkula,Jammu & Kashmir,2019-09-01,78,0,78,107,2
Asthma,Panchkula,Jammu & Kashmir,2019-10-01,4989,275,4714,135,4
Asthma,Panchkula,Jammu & Kashmir,2019-11-01,3755,212,3543,109,9
Asthma,Panchkula,Jammu & Kashmir,2019-12-01,1484,88,1396,52,8
Asthma,Panchkula,Jammu & Kashmir,2020-01-01,2219,101,2118,112,5
Asthma,Panchkula,Jammu & Kashmir,2020-02-01,1743,130,1613,164,6
Asthma,Panchkula,Jammu & Kashmir,2020-03-01,4667,265,4402,122,3
Asthma,Panchkula,Jammu & Kashmir,2020-04-01,693,50,643,189,10
Asthma,Panchkula,Jammu & Kashmir,2020-05-01,2751,213,2538,16,8
Asthma,Panchkula,Jammu & Kashmir,2020-06-01,2452,153,2299,126,5
Asthma,Panchkula,Jammu & Kashmir,2020-07-01,3707,239,3468,73,5
Asthma,Panchkula,Jammu & Kashmir,2020-08-01,2458,50,2408,62,7
Asthma,Panchkula,Jammu & Kashmir,2020-09-01,239,8,231,174,5
Asthma,Panchkula,Jammu & Kashmir,2020-10-01,2261,168,2093,93,1
Asthma,Panchkula,Jammu & Kashmir,2020-11-01,1293,118,1175,88,9
Asthma,Panchkula,Jammu & Kashmir,2020-12-01,2704,0,2704,124,8
Asthma,Panchkula,Jammu & Kashmir,2021-01-01,4521,151,4370,11,6
Asthma,Panchkula,Jammu & Kashmir,2021-02-01,264,13,251,175,4
Asthma,Panchkula,Jammu & Kashmir,2021-03-01,1524,37,1487,200,5
Asthma,Panchkula,Jammu & Kashmir,2021-04-01,1856,48,1808,153,1
Asthma,Panchkula,Jammu & Kashmir,2021-05-01,2085,133,1952,127,2
Asthma,Panchkula,Jammu & Kashmir,2021-06-01,3590,344,3246,95,10
Asthma,Panchkula,Jammu & Kashmir,2021-07-01,2365,0,2365,51,6
Asthma,Panchkula,Jammu & Kashmir,2021-08-01,3155,142,3013,167,1
Asthma,Panchkula,Jammu & Kashmir,2021-09-01,1758,111,1647,153,2
Asthma,Panchkula,Jammu & Kashmir,2021-10-01,2906,211,2695,129,1
Asthma,Panchkula,Jammu & Kashmir,2021-11-01,3641,216,3425,123,3
Asthma,Panchkula,Jammu & Kashmir,2021-12-01,1615,163,1452,122,4
Asthma,Panchkula,Jammu & Kashmir,2022-01-01,3646,185,3461,79,9
Asthma,Panchkula,Jammu & Kashmir,2022-02-01,2668,235,2433,200,7
Asthma,Panchkula,Jammu & Kashmir,2022-03-01,4000,125,3875,92,4
Asthma,Panchkula,Jammu & Kashmir,2022-04-01,2327,120,2207,84,4
Asthma,Panchkula,Jammu & Kashmir,2022-05-01,3109,45,3064,163,2
Asthma,Panchkula,Jammu & Kashmir,2022-06-01,2543,194,2349,105,8
Asthma,Panchkula,Jammu & Kashmir,2022-07-01,2468,114,2354,105,8
Asthma,Panchkula,Jammu & Kashmir,2022-08-01,2945,178,2767,178,1
Asthma,Panchkula,Jammu & Kashmir,2022-09-01,3318,135,3183,141,1
Asthma,Panchkula,Jammu & Kashmir,2022-10-01,921,61,860,143,4
Asthma,Panchkula,Jammu & Kashmir,2022-11-01,4521,278,4243,34,4
Asthma,Panchkula,Jammu & Kashmir,2022-12-01,103,2,101,127,6
Asthma,Panchkula,Jammu & Kashmir,2023-01-01,1679,38,1641,55,1
Asthma,Panchkula,Jammu & Kashmir,2023-02-01,2471,121,2350,83,3
Asthma,Panchkula,Jammu & Kashmir,2023-03-01,3151,218,2933,115,5
Asthma,Panchkula,Jammu & Kashmir,2023-04-01,4712,442,4270,104,3
Asthma,Panchkula,Jammu & Kashmir,2023-05-01,104,6,98,140,7
Asthma,Panchkula,Jammu & Kashmir,2023-06-01,1916,152,1764,145,10
Asthma,Panchkula,Jammu & Kashmir,2023-07-01,78,0,78,149,3
Asthma,Panchkula,Jammu & Kashmir,2023-08-01,2640,286,2354,38,7
Asthma,Panchkula,Jammu & Kashmir,2023-09-01,2962,200,2762,200,4
Asthma,Panchkula,Jammu & Kashmir,2023-10-01,4731,230,4501,105,2
Asthma,Panchkula,Jammu & Kashmir,2023-11-01,2759,124,2635,168,3
Asthma,Panchkula,Jammu & Kashmir,2023-12-01,3998,71,3927,11,7
Asthma,Panchkula,Jammu & Kashmir,2024-01-01,3381,88,3293,93,3
Asthma,Panchkula,Jammu & Kashmir,2024-02-01,2014,212,1802,32,4
Asthma,Panchkula,Jammu & Kashmir,2024-03-01,707,15,692,62,1
Asthma,Panchkula,Jammu & Kashmir,2024-04-01,2966,61,2905,109,7
Asthma,Panchkula,Jammu & Kashmir,2024-05-01,596,17,579,89,6
Asthma,Panchkula,Jammu & Kashmir,2024-06-01,4335,65,4270,173,9
Asthma,Panchkula,Jammu & Kashmir,2024-07-01,2380,120,2260,196,7
Asthma,Panchkula,Jammu & Kashmir,2024-08-01,4201,343,3858,57,6
Asthma,Panchkula,Jammu & Kashmir,2024-09-01,1953,63,1890,81,7
Asthma,Panchkula,Jammu & Kashmir,2024-10-01,2958,29,2929,54,4
Asthma,Panchkula,Jammu & Kashmir,2024-11-01,2878,168,2710,165,5
Asthma,Panchkula,Jammu & Kashmir,2024-12-01,2537,122,2415,114,8
Asthma,Panchkula,Jammu & Kashmir,2025-01-01,2017,159,1858,108,2
Asthma,Panchkula,Jammu & Kashmir,2025-02-01,3124,115,3009,122,10
Asthma,Panchkula,Jammu & Kashmir,2025-03-01,1355,57,1298,90,7
Asthma,Panchkula,Jammu & Kashmir,2025-04-01,975,44,931,63,10
Asthma,Panchkula,Jammu & Kashmir,2025-05-01,4265,224,4041,109,1
Asthma,Panchkula,Jammu & Kashmir,2025-06-01,3573,138,3435,93,1
Asthma,Panchkula,Jammu & Kashmir,2025-07-01,2686,91,2595,124,6
Asthma,Panchkula,Jammu & Kashmir,2025-08-01,4831,0,4831,23,5
Asthma,Panchkula,Jammu & Kashmir,2025-09-01,2238,75,2163,116,3
Asthma,Panchkula,Jammu & Kashmir,2025-10-01,4372,309,4063,71,1
Asthma,Panchkula,Jammu & Kashmir,2025-11-01,2833,211,2622,114,4
Asthma,Panchkula,Jammu & Kashmir,2025-12-01,1223,44,1179,152,5
Asthma,Panchkula,Haryana,2018-01-01,4989,438,4551,78,1
Asthma,Panchkula,Haryana,2018-02-01,3926,193,3733,167,4
Asthma,Panchkula,Haryana,2018-03-01,2435,27,2408,18,6
Asthma,Panchkula,Haryana,2018-04-01,3573,7,3566,185,7
Asthma,Panchkula,Haryana,2018-05-01,2056,175,1881,169,4
Asthma,Panchkula,Haryana,2018-06-01,3710,145,3565,61,2
Asthma,Panchkula,Haryana,2018-07-01,78,0,78,61,5
Asthma,Panchkula,Haryana,2018-08-01,1229,0,1229,30,4
Asthma,Panchkula,Haryana,2018-09-01,3911,150,3761,153,1
Asthma,Panchkula,Haryana,2018-10-01,2262,139,2123,89,4
Asthma,Panchkula,Haryana,2018-11-01,2876,85,2791,86,3
Asthma,Panchkula,Haryana,2018-12-01,791,15,776,49,5
Asthma,Panchkula,Haryana,2019-01-01,4989,170,4819,199,3
Asthma,Panchkula,Haryana,2019-02-01,4195,361,3834,57,3
Asthma,Panchkula,Haryana,2019-03-01,2328,22,2306,107,4
Asthma,Panchkula,Haryana,2019-04-01,2055,64,1991,117,7
Asthma,Panchkula,Haryana,2019-05-01,3979,339,3640,86,5
Asthma,Panchkula,Haryana,2019-06-01,4989,321,4668,76,10
Asthma,Panchkula,Haryana,2019-07-01,3877,214,3663,87,1
Asthma,Panchkula,Haryana,2019-08-01,4989,155,4834,135,7
Asthma,Panchkula,Haryana,2019-09-01,1360,69,1291,89,5
Asthma,Panchkula,Haryana,2019-10-01,1498,51,1447,189,1
Asthma,Panchkula,Haryana,2019-11-01,1002,25,977,67,4
Asthma,Panchkula,Haryana,2019-12-01,3190,59,3131,145,1
Asthma,Panchkula,Haryana,2020-01-01,2833,206,2627,17,5
Asthma,Panchkula,Haryana,2020-02-01,2394,115,2279,67,4
Asthma,Panchkula,Haryana,2020-03-01,3683,218,3465,65,3
Asthma,Panchkula,Haryana,2020-04-01,4251,231,4020,50,2
Asthma,Panchkula,Haryana,2020-05-01,551,34,517,121,8
Asthma,Panchkula,Haryana,2020-06-01,1797,76,1721,101,4
Asthma,Panchkula,Haryana,2020-07-01,3698,133,3565,11,5
Asthma,Panchkula,Haryana,2020-08-01,1970,51,1919,200,5
Asthma,Panchkula,Haryana,2020-09-01,1527,13,1514,115,5
Asthma,Panchkula,Haryana,2020-10-01,3964,69,3895,106,4
Asthma,Panchkula,Haryana,2020-11-01,868,34,834,173,9
Asthma,Panchkula,Haryana,2020-12-01,2193,7,2186,157,10
Asthma,Panchkula,Haryana,2021-01-01,3038,29,3009,91,9
Asthma,Panchkula,Haryana,2021-02-01,1828,146,1682,11,5
Asthma,Panchkula,Haryana,2021-03-01,3648,206,3442,135,5
Asthma,Panchkula,Haryana,2021-04-01,1834,67,1767,57,8
Asthma,Panchkula,Haryana,2021-05-01,4487,442,4045,169,3
Asthma,Panchkula,Haryana,2021-06-01,2429,5,2424,67,10
Asthma,Panchkula,Haryana,2021-07-01,3498,274,3224,83,7
Asthma,Panchkula,Haryana,2021-08-01,3598,168,3430,38,4
Asthma,Panchkula,Haryana,2021-09-01,1756,128,1628,42,6
Asthma,Panchkula,Haryana,2021-10-01,78,0,78,101,7
Asthma,Panchkula,Haryana,2021-11-01,3081,0,3081,96,4
Asthma,Panchkula,Haryana,2021-12-01,2694,142,2552,82,8
Asthma,Panchkula,Haryana,2022-01-01,3343,200,3143,200,9
Asthma,Panchkula,Haryana,2022-02-01,2294,0,2294,137,4
Asthma,Panchkula,Haryana,2022-03-01,2020,215,1805,107,3
Asthma,Panchkula,Haryana,2022-04-01,4989,294,4695,11,5
Asthma,Panchkula,Haryana,2022-05-01,622,43,579,148,1
Asthma,Panchkula,Haryana,2022-06-01,3582,57,3525,200,1
Asthma,Panchkula,Haryana,2022-07-01,1827,128,1699,97,4
Asthma,Panchkula,Haryana,2022-08-01,2147,175,1972,65,2
Asthma,Panchkula,Haryana,2022-09-01,2172,124,2048,115,10
Asthma,Panchkula,Haryana,2022-10-01,1520,75,1445,33,3
Asthma,Panchkula,Haryana,2022-11-01,3364,80,3284,130,6
Asthma,Panchkula,Haryana,2022-12-01,4463,195,4268,183,3
Asthma,Panchkula,Haryana,2023-01-01,3228,113,3115,72,10
Asthma,Panchkula,Haryana,2023-02-01,2736,182,2554,74,4
Asthma,Panchkula,Haryana,2023-03-01,1274,32,1242,102,1
Asthma,Panchkula,Haryana,2023-04-01,3291,218,3073,81,7
Asthma,Panchkula,Haryana,2023-05-01,4989,127,4862,29,6
Asthma,Panchkula,Haryana,2023-06-01,2087,88,1999,87,8
Asthma,Panchkula,Haryana,2023-07-01,2093,142,1951,76,4
Asthma,Panchkula,Haryana,2023-08-01,1845,54,1791,176,5
Asthma,Panchkula,Haryana,2023-09-01,1941,133,1808,165,1
Asthma,Panchkula,Haryana,2023-10-01,78,0,78,177,7
Asthma,Panchkula,Haryana,2023-11-01,3141,132,3009,147,5
Asthma,Panchkula,Haryana,2023-12-01,1463,122,1341,117,4
Asthma,Panchkula,Haryana,2024-01-01,437,22,415,62,4
Asthma,Panchkula,Haryana,2024-02-01,3608,296,3312,174,4
Asthma,Panchkula,Haryana,2024-03-01,1146,117,1029,124,7
Asthma,Panchkula,Haryana,2024-04-01,2143,92,2051,43,2
Asthma,Panchkula,Haryana,2024-05-01,4565,314,4251,60,7
Asthma,Panchkula,Haryana,2024-06-01,707,22,685,42,1
Asthma,Panchkula,Haryana,2024-07-01,541,10,531,11,1
Asthma,Panchkula,Haryana,2024-08-01,2959,131,2828,126,9
Asthma,Panchkula,Haryana,2024-09-01,4139,43,4096,43,2
Asthma,Panchkula,Haryana,2024-10-01,485,11,474,68,5
Asthma,Panchkula,Haryana,2024-11-01,3144,211,2933,108,4
Asthma,Panchkula,Haryana,2024-12-01,3377,118,3259,97,6
Asthma,Panchkula,Haryana,2025-01-01,78,0,78,70,5
Asthma,Panchkula,Haryana,2025-02-01,3669,215,3454,184,8
Asthma,Panchkula,Haryana,2025-03-01,3773,392,3381,28,1
Asthma,Panchkula,Haryana,2025-04-01,2179,142,2037,31,7
Asthma,Panchkula,Haryana,2025-05-01,4277,352,3925,130,5
Asthma,Panchkula,Haryana,2025-06-01,4122,254,3868,74,1
Asthma,Panchkula,Haryana,2025-07-01,2736,161,2575,72,3
Asthma,Panchkula,Haryana,2025-08-01,1992,167,1825,51,1
Asthma,Panchkula,Haryana,2025-09-01,1292,89,1203,123,1
Asthma,Panchkula,Haryana,2025-10-01,2547,143,2404,118,4
Asthma,Panchkula,Haryana,2025-11-01,3362,188,3174,112,8
Asthma,Panchkula,Haryana,2025-12-01,2163,142,2021,77,6
Dengue,Amritsar,Punjab,2018-01-01,78,0,78,68,9
Dengue,Amritsar,Punjab,2018-02-01,4299,125,4174,98,5
Dengue,Amritsar,Punjab,2018-03-01,2853,261,2592,155,9
Dengue,Amritsar,Punjab,2018-04-01,2088,217,1871,186,9
Dengue,Amritsar,Punjab,2018-05-01,3747,86,3661,163,2
Dengue,Amritsar,Punjab,2018-06-01,4643,142,4501,132,5
Dengue,Amritsar,Punjab,2018-07-01,78,0,78,156,3
Dengue,Amritsar,Punjab,2018-08-01,3180,208,2972,46,4
Dengue,Amritsar,Punjab,2018-09-01,684,47,637,70,10
Dengue,Amritsar,Punjab,2018-10-01,3267,248,3019,133,3
Dengue,Amritsar,Punjab,2018-11-01,2769,119,2650,100,1
Dengue,Amritsar,Punjab,2018-12-01,3450,205,3245,123,2
Dengue,Amritsar,Punjab,2019-01-01,1928,110,1818,156,4
Dengue,Amritsar,Punjab,2019-02-01,84,2,82,148,10
Dengue,Amritsar,Punjab,2019-03-01,1993,118,1875,51,9
Dengue,Amritsar,Punjab,2019-04-01,3143,270,2873,107,1
Dengue,Amritsar,Punjab,2019-05-01,3960,159,3801,59,5
Dengue,Amritsar,Punjab,2019-06-01,1025,55,970,67,3
Dengue,Amritsar,Punjab,2019-07-01,3975,222,3753,19,8
Dengue,Amritsar,Punjab,2019-08-01,1728,72,1656,113,1
Dengue,Amritsar,Punjab,2019-09-01,3084,215,2869,15,2
Dengue,Amritsar,Punjab,2019-10-01,1913,57,1856,126,3
Dengue,Amritsar,Punjab,2019-11-01,2842,252,2590,175,3
Dengue,Amritsar,Punjab,2019-12-01,3794,259,3535,133,7
Dengue,Amritsar,Punjab,2020-01-01,951,21,930,109,4
Dengue,Amritsar,Punjab,2020-02-01,1685,167,1518,184,8
Dengue,Amritsar,Punjab,2020-03-01,2846,156,2690,123,2
Dengue,Amritsar,Punjab,2020-04-01,4989,144,4845,62,7
Dengue,Amritsar,Punjab,2020-05-01,1439,118,1321,113,1
Dengue,Amritsar,Punjab,2020-06-01,4989,321,4668,200,7
Dengue,Amritsar,Punjab,2020-07-01,4989,20,4969,51,3
Dengue,Amritsar,Punjab,2020-08-01,2467,85,2382,36,7
Dengue,Amritsar,Punjab,2020-09-01,2197,127,2070,138,1
Dengue,Amritsar,Punjab,2020-10-01,1669,0,1669,95,3
Dengue,Amritsar,Punjab,2020-11-01,2506,131,2375,79,8
Dengue,Amritsar,Punjab,2020-12-01,710,38,672,42,4
Dengue,Amritsar,Punjab,2021-01-01,2495,38,2457,11,1
Dengue,Amritsar,Punjab,2021-02-01,4605,266,4339,32,3
Dengue,Amritsar,Punjab,2021-03-01,1778,89,1689,188,6
Dengue,Amritsar,Punjab,2021-04-01,2274,35,2239,106,2
Dengue,Amritsar,Punjab,2021-05-01,315,24,291,11,8
Dengue,Amritsar,Punjab,2021-06-01,3099,230,2869,167,8
Dengue,Amritsar,Punjab,2021-07-01,2952,122,2830,169,7
Dengue,Amritsar,Punjab,2021-08-01,2683,118,2565,169,8
Dengue,Amritsar,Punjab,2021-09-01,2307,164,2143,85,3
Dengue,Amritsar,Punjab,2021-10-01,2205,97,2108,93,9
Dengue,Amritsar,Punjab,2021-11-01,3271,0,3271,113,8
Dengue,Amritsar,Punjab,2021-12-01,2559,164,2395,178,4
Dengue,Amritsar,Punjab,2022-01-01,3020,79,2941,78,1
Dengue,Amritsar,Punjab,2022-02-01,2886,111,2775,68,1
Dengue,Amritsar,Punjab,2022-03-01,4104,379,3725,142,8
Dengue,Amritsar,Punjab,2022-04-01,3506,161,3345,168,1
Dengue,Amritsar,Punjab,2022-05-01,2856,143,2713,104,2
Dengue,Amritsar,Punjab,2022-06-01,4634,300,4334,140,6
Dengue,Amritsar,Punjab,2022-07-01,3161,204,2957,112,1
Dengue,Amritsar,Punjab,2022-08-01,4348,101,4247,93,10
Dengue,Amritsar,Punjab,2022-09-01,3412,164,3248,64,6
Dengue,Amritsar,Punjab,2022-10-01,126,6,120,47,9
Dengue,Amritsar,Punjab,2022-11-01,4348,252,4096,75,8
Dengue,Amritsar,Punjab,2022-12-01,2779,162,2617,56,1
Dengue,Amritsar,Punjab,2023-01-01,2528,316,2212,121,7
Dengue,Amritsar,Punjab,2023-02-01,2975,47,2928,168,5
Dengue,Amritsar,Punjab,2023-03-01,2135,167,1968,117,5
Dengue,Amritsar,Punjab,2023-04-01,2902,245,2657,59,5
Dengue,Amritsar,Punjab,2023-05-01,1803,116,1687,150,8
Dengue,Amritsar,Punjab,2023-06-01,4307,134,4173,121,10
Dengue,Amritsar,Punjab,2023-07-01,2445,240,2205,131,1
Dengue,Amritsar,Punjab,2023-08-01,2084,0,2084,80,5
Dengue,Amritsar,Punjab,2023-09-01,1357,40,1317,164,9
Dengue,Amritsar,Punjab,2023-10-01,2958,248,2710,164,4
Dengue,Amritsar,Punjab,2023-11-01,2848,111,2737,97,5
Dengue,Amritsar,Punjab,2023-12-01,3118,300,2818,143,5
Dengue,Amritsar,Punjab,2024-01-01,1219,7,1212,162,10
Dengue,Amritsar,Punjab,2024-02-01,449,7,442,83,7
Dengue,Amritsar,Punjab,2024-03-01,3437,118,3319,102,10
Dengue,Amritsar,Punjab,2024-04-01,4589,285,4304,110,10
Dengue,Amritsar,Punjab,2024-05-01,1221,53,1168,50,4
Dengue,Amritsar,Punjab,2024-06-01,4730,169,4561,129,6
Dengue,Amritsar,Punjab,2024-07-01,2978,272,2706,158,10
Dengue,Amritsar,Punjab,2024-08-01,2588,243,2345,99,2
Dengue,Amritsar,Punjab,2024-09-01,2064,78,1986,124,7
Dengue,Amritsar,Punjab,2024-10-01,740,0,740,177,7
Dengue,Amritsar,Punjab,2024-11-01,3922,0,3922,86,4
Dengue,Amritsar,Punjab,2024-12-01,1557,88,1469,125,4
Dengue,Amritsar,Punjab,2025-01-01,1551,107,1444,77,4
Dengue,Amritsar,Punjab,2025-02-01,3928,203,3725,76,7
Dengue,Amritsar,Punjab,2025-03-01,78,0,78,124,9
Dengue,Amritsar,Punjab,2025-04-01,553,14,539,119,7
Dengue,Amritsar,Punjab,2025-05-01,2573,177,2396,134,1
Dengue,Amritsar,Punjab,2025-06-01,2991,295,2696,110,9
Dengue,Amritsar,Punjab,2025-07-01,3248,0,3248,130,8
Dengue,Amritsar,Punjab,2025-08-01,2193,104,2089,191,4
Dengue,Amritsar,Punjab,2025-09-01,4989,108,4881,160,3
Dengue,Amritsar,Punjab,2025-10-01,2292,15,2277,123,2
Dengue,Amritsar,Punjab,2025-11-01,2288,39,2249,132,8
Dengue,Amritsar,Punjab,2025-12-01,1528,93,1435,91,1
Dengue,Amritsar,Chandigarh,2018-01-01,2764,170,2594,98,8
Dengue,Amritsar,Chandigarh,2018-02-01,3422,316,3106,131,4
Dengue,Amritsar,Chandigarh,2018-03-01,4212,211,4001,111,6
Dengue,Amritsar,Chandigarh,2018-04-01,600,0,600,147,1
Dengue,Amritsar,Chandigarh,2018-05-01,2267,97,2170,171,1
Dengue,Amritsar,Chandigarh,2018-06-01,3197,31,3166,101,3
Dengue,Amritsar,Chandigarh,2018-07-01,3385,50,3335,11,2
Dengue,Amritsar,Chandigarh,2018-08-01,2606,174,2432,200,7
Dengue,Amritsar,Chandigarh,2018-09-01,3325,185,3140,73,6
Dengue,Amritsar,Chandigarh,2018-10-01,1512,101,1411,116,10
Dengue,Amritsar,Chandigarh,2018-11-01,4687,185,4502,143,6
Dengue,Amritsar,Chandigarh,2018-12-01,3929,287,3642,178,3
Dengue,Amritsar,Chandigarh,2019-01-01,793,30,763,198,8
Dengue,Amritsar,Chandigarh,2019-02-01,1155,95,1060,88,3
Dengue,Amritsar,Chandigarh,2019-03-01,1193,71,1122,167,3
Dengue,Amritsar,Chandigarh,2019-04-01,3507,154,3353,116,5
Dengue,Amritsar,Chandigarh,2019-05-01,874,49,825,200,10
Dengue,Amritsar,Chandigarh,2019-06-01,2153,106,2047,162,8
Dengue,Amritsar,Chandigarh,2019-07-01,3207,309,2898,97,8
Dengue,Amritsar,Chandigarh,2019-08-01,2509,143,2366,66,10
Dengue,Amritsar,Chandigarh,2019-09-01,2945,147,2798,11,8
Dengue,Amritsar,Chandigarh,2019-10-01,1168,50,1118,141,1
Dengue,Amritsar,Chandigarh,2019-11-01,3395,253,3142,158,6
Dengue,Amritsar,Chandigarh,2019-12-01,1775,125,1650,144,10
Dengue,Amritsar,Chandigarh,2020-01-01,2162,91,2071,11,1
Dengue,Amritsar,Chandigarh,2020-02-01,2916,47,2869,42,5
Dengue,Amritsar,Chandigarh,2020-03-01,2736,65,2671,131,2
Dengue,Amritsar,Chandigarh,2020-04-01,2630,117,2513,197,5
Dengue,Amritsar,Chandigarh,2020-05-01,1590,142,1448,103,8
Dengue,Amritsar,Chandigarh,2020-06-01,2196,93,2103,162,9
Dengue,Amritsar,Chandigarh,2020-07-01,2600,85,2515,54,4
Dengue,Amritsar,Chandigarh,2020-08-01,753,0,753,117,7
Dengue,Amritsar,Chandigarh,2020-09-01,1977,186,1791,92,1
Dengue,Amritsar,Chandigarh,2020-10-01,3117,207,2910,167,1
Dengue,Amritsar,Chandigarh,2020-11-01,884,64,820,79,8
Dengue,Amritsar,Chandigarh,2020-12-01,4149,323,3826,192,1
Dengue,Amritsar,Chandigarh,2021-01-01,4301,194,4107,91,3
Dengue,Amritsar,Chandigarh,2021-02-01,927,48,879,52,7
Dengue,Amritsar,Chandigarh,2021-03-01,4419,412,4007,53,5
Dengue,Amritsar,Chandigarh,2021-04-01,2405,132,2273,74,1
Dengue,Amritsar,Chandigarh,2021-05-01,3159,212,2947,125,6
Dengue,Amritsar,Chandigarh,2021-06-01,1931,145,1786,75,2
Dengue,Amritsar,Chandigarh,2021-07-01,3836,263,3573,64,5
Dengue,Amritsar,Chandigarh,2021-08-01,3142,145,2997,152,3
Dengue,Amritsar,Chandigarh,2021-09-01,1505,73,1432,11,3
Dengue,Amritsar,Chandigarh,2021-10-01,1034,75,959,84,1
Dengue,Amritsar,Chandigarh,2021-11-01,638,46,592,38,4
Dengue,Amritsar,Chandigarh,2021-12-01,2850,239,2611,62,8
Dengue,Amritsar,Chandigarh,2022-01-01,3365,222,3143,119,4
Dengue,Amritsar,Chandigarh,2022-02-01,3471,234,3237,96,4
Dengue,Amritsar,Chandigarh,2022-03-01,2439,90,2349,91,3
Dengue,Amritsar,Chandigarh,2022-04-01,1045,34,1011,167,1
Dengue,Amritsar,Chandigarh,2022-05-01,1682,122,1560,106,2
Dengue,Amritsar,Chandigarh,2022-06-01,4143,138,4005,198,5
Dengue,Amritsar,Chandigarh,2022-07-01,1947,96,1851,142,10
Dengue,Amritsar,Chandigarh,2022-08-01,2790,251,2539,57,8
Dengue,Amritsar,Chandigarh,2022-09-01,1154,98,1056,200,7
Dengue,Amritsar,Chandigarh,2022-10-01,3049,179,2870,120,10
Dengue,Amritsar,Chandigarh,2022-11-01,1983,82,1901,200,6
Dengue,Amritsar,Chandigarh,2022-12-01,4002,186,3816,93,8
Dengue,Amritsar,Chandigarh,2023-01-01,3635,273,3362,120,5
Dengue,Amritsar,Chandigarh,2023-02-01,1932,94,1838,128,6
Dengue,Amritsar,Chandigarh,2023-03-01,2427,82,2345,98,1
Dengue,Amritsar,Chandigarh,2023-04-01,1858,158,1700,171,4
Dengue,Amritsar,Chandigarh,2023-05-01,693,38,655,200,3
Dengue,Amritsar,Chandigarh,2023-06-01,1447,48,1399,11,3
Dengue,Amritsar,Chandigarh,2023-07-01,2863,183,2680,148,3
Dengue,Amritsar,Chandigarh,2023-08-01,3034,237,2797,61,9
Dengue,Amritsar,Chandigarh,2023-09-01,2797,58,2739,11,4
Dengue,Amritsar,Chandigarh,2023-10-01,2193,97,2096,133,4
Dengue,Amritsar,Chandigarh,2023-11-01,3849,165,3684,133,10
Dengue,Amritsar,Chandigarh,2023-12-01,2683,169,2514,141,7
Dengue,Amritsar,Chandigarh,2024-01-01,3541,242,3299,125,5
Dengue,Amritsar,Chandigarh,2024-02-01,218,7,211,151,8
Dengue,Amritsar,Chandigarh,2024-03-01,78,0,78,75,3
Dengue,Amritsar,Chandigarh,2024-04-01,2978,238,2740,120,4
Dengue,Amritsar,Chandigarh,2024-05-01,686,11,675,142,4
Dengue,Amritsar,Chandigarh,2024-06-01,2312,134,2178,175,6
Dengue,Amritsar,Chandigarh,2024-07-01,2192,101,2091,108,6
Dengue,Amritsar,Chandigarh,2024-08-01,4727,259,4468,95,2
Dengue,Amritsar,Chandigarh,2024-09-01,3134,307,2827,103,6
Dengue,Amritsar,Chandigarh,2024-10-01,2820,390,2430,45,7
Dengue,Amritsar,Chandigarh,2024-11-01,3720,9,3711,145,3
Dengue,Amritsar,Chandigarh,2024-12-01,3092,243,2849,32,4
Dengue,Amritsar,Chandigarh,2025-01-01,1983,90,1893,126,2
Dengue,Amritsar,Chandigarh,2025-02-01,4035,325,3710,111,1
Dengue,Amritsar,Chandigarh,2025-03-01,1109,86,1023,27,1
Dengue,Amritsar,Chandigarh,2025-04-01,3031,276,2755,30,7
Dengue,Amritsar,Chandigarh,2025-05-01,521,30,491,63,6
Dengue,Amritsar,Chandigarh,2025-06-01,2871,69,2802,89,10
Dengue,Amritsar,Chandigarh,2025-07-01,2856,220,2636,182,5
Dengue,Amritsar,Chandigarh,2025-08-01,4846,259,4587,101,5
Dengue,Amritsar,Chandigarh,2025-09-01,498,21,477,134,6
Dengue,Amritsar,Chandigarh,2025-10-01,1791,64,1727,171,2
Dengue,Amritsar,Chandigarh,2025-11-01,3701,293,3408,161,7
Dengue,Amritsar,Chandigarh,2025-12-01,3047,294,2753,106,6
Dengue,Amritsar,Himachal Pradesh,2018-01-01,2839,43,2796,70,2
Dengue,Amritsar,Himachal Pradesh,2018-02-01,1315,89,1226,132,6
Dengue,Amritsar,Himachal Pradesh,2018-03-01,1805,70,1735,71,7
Dengue,Amritsar,Himachal Pradesh,2018-04-01,4268,31,4237,199,1
Dengue,Amritsar,Himachal Pradesh,2018-05-01,2528,137,2391,150,8
Dengue,Amritsar,Himachal Pradesh,2018-06-01,3101,80,3021,117,4
Dengue,Amritsar,Himachal Pradesh,2018-07-01,2443,10,2433,132,1
Dengue,Amritsar,Himachal Pradesh,2018-08-01,1010,27,983,115,8
Dengue,Amritsar,Himachal Pradesh,2018-09-01,3850,77,3773,87,9
Dengue,Amritsar,Himachal Pradesh,2018-10-01,3272,102,3170,132,2
Dengue,Amritsar,Himachal Pradesh,2018-11-01,4989,57,4932,94,1
Dengue,Amritsar,Himachal Pradesh,2018-12-01,1235,47,1188,200,9
Dengue,Amritsar,Himachal Pradesh,2019-01-01,3701,108,3593,71,3
Dengue,Amritsar,Himachal Pradesh,2019-02-01,838,51,787,132,9
Dengue,Amritsar,Himachal Pradesh,2019-03-01,2808,189,2619,66,1
Dengue,Amritsar,Himachal Pradesh,2019-04-01,3907,225,3682,66,9
Dengue,Amritsar,Himachal Pradesh,2019-05-01,78,0,78,15,8
Dengue,Amritsar,Himachal Pradesh,2019-06-01,2322,98,2224,127,6
Dengue,Amritsar,Himachal Pradesh,2019-07-01,1842,47,1795,79,1
Dengue,Amritsar,Himachal Pradesh,2019-08-01,1656,43,1613,161,4
Dengue,Amritsar,Himachal Pradesh,2019-09-01,3114,219,2895,127,8
Dengue,Amritsar,Himachal Pradesh,2019-10-01,4101,0,4101,114,1
Dengue,Amritsar,Himachal Pradesh,2019-11-01,2419,115,2304,34,3
Dengue,Amritsar,Himachal Pradesh,2019-12-01,2873,116,2757,136,6
Dengue,Amritsar,Himachal Pradesh,2020-01-01,2751,185,2566,72,1
Dengue,Amritsar,Himachal Pradesh,2020-02-01,2600,22,2578,33,9
Dengue,Amritsar,Himachal Pradesh,2020-03-01,1136,57,1079,128,8
Dengue,Amritsar,Himachal Pradesh,2020-04-01,4084,245,3839,42,6
Dengue,Amritsar,Himachal Pradesh,2020-05-01,2993,0,2993,11,6
Dengue,Amritsar,Himachal Pradesh,2020-06-01,3127,58,3069,172,3
Dengue,Amritsar,Himachal Pradesh,2020-07-01,1515,71,1444,78,7
Dengue,Amritsar,Himachal Pradesh,2020-08-01,1981,128,1853,17,3
Dengue,Amritsar,Himachal Pradesh,2020-09-01,2361,130,2231,57,4
Dengue,Amritsar,Himachal Pradesh,2020-10-01,539,35,504,69,3
Dengue,Amritsar,Himachal Pradesh,2020-11-01,333,6,327,165,9
Dengue,Amritsar,Himachal Pradesh,2020-12-01,1791,6,1785,21,8
Dengue,Amritsar,Himachal Pradesh,2021-01-01,3298,173,3125,38,2
Dengue,Amritsar,Himachal Pradesh,2021-02-01,1721,24,1697,156,9
Dengue,Amritsar,Himachal Pradesh,2021-03-01,1231,30,1201,83,3
Dengue,Amritsar,Himachal Pradesh,2021-04-01,1504,116,1388,118,10
Dengue,Amritsar,Himachal Pradesh,2021-05-01,1987,110,1877,81,9
Dengue,Amritsar,Himachal Pradesh,2021-06-01,2123,71,2052,200,10
Dengue,Amritsar,Himachal Pradesh,2021-07-01,4989,148,4841,41,6
Dengue,Amritsar,Himachal Pradesh,2021-08-01,4012,273,3739,121,4
Dengue,Amritsar,Himachal Pradesh,2021-09-01,3972,223,3749,183,4
Dengue,Amritsar,Himachal Pradesh,2021-10-01,4165,61,4104,87,6
Dengue,Amritsar,Himachal Pradesh,2021-11-01,1257,0,1257,68,2
Dengue,Amritsar,Himachal Pradesh,2021-12-01,958,100,858,145,1
Dengue,Amritsar,Himachal Pradesh,2022-01-01,1113,16,1097,157,4
Dengue,Amritsar,Himachal Pradesh,2022-02-01,4388,287,4101,65,5
Dengue,Amritsar,Himachal Pradesh,2022-03-01,1863,175,1688,181,6
Dengue,Amritsar,Himachal Pradesh,2022-04-01,919,49,870,109,6
Dengue,Amritsar,Himachal Pradesh,2022-05-01,2019,65,1954,132,5
Dengue,Amritsar,Himachal Pradesh,2022-06-01,2277,19,2258,182,8
Dengue,Amritsar,Himachal Pradesh,2022-07-01,2957,24,2933,145,2
Dengue,Amritsar,Himachal Pradesh,2022-08-01,2934,179,2755,106,3
Dengue,Amritsar,Himachal Pradesh,2022-09-01,1486,137,1349,72,10
Dengue,Amritsar,Himachal Pradesh,2022-10-01,3517,135,3382,200,1
Dengue,Amritsar,Himachal Pradesh,2022-11-01,1740,58,1682,66,8
Dengue,Amritsar,Himachal Pradesh,2022-12-01,2388,168,2220,122,6
Dengue,Amritsar,Himachal Pradesh,2023-01-01,3519,105,3414,132,5
Dengue,Amritsar,Himachal Pradesh,2023-02-01,1736,100,1636,135,7
Dengue,Amritsar,Himachal Pradesh,2023-03-01,1834,94,1740,200,7
Dengue,Amritsar,Himachal Pradesh,2023-04-01,3391,129,3262,109,1
Dengue,Amritsar,Himachal Pradesh,2023-05-01,1447,71,1376,101,2
Dengue,Amritsar,Himachal Pradesh,2023-06-01,2081,210,1871,185,3
Dengue,Amritsar,Himachal Pradesh,2023-07-01,3343,226,3117,99,1
Dengue,Amritsar,Himachal Pradesh,2023-08-01,4989,408,4581,151,5
Dengue,Amritsar,Himachal Pradesh,2023-09-01,3410,79,3331,116,7
Dengue,Amritsar,Himachal Pradesh,2023-10-01,3231,264,2967,153,8
Dengue,Amritsar,Himachal Pradesh,2023-11-01,3309,227,3082,143,5
Dengue,Amritsar,Himachal Pradesh,2023-12-01,1158,7,1151,86,3
Dengue,Amritsar,Himachal Pradesh,2024-01-01,2752,181,2571,12,5
Dengue,Amritsar,Himachal Pradesh,2024-02-01,2557,89,2468,21,5
Dengue,Amritsar,Himachal Pradesh,2024-03-01,3029,15,3014,12,7
Dengue,Amritsar,Himachal Pradesh,2024-04-01,2754,148,2606,102,5
Dengue,Amritsar,Himachal Pradesh,2024-05-01,3107,204,2903,11,7
Dengue,Amritsar,Himachal Pradesh,2024-06-01,2180,118,2062,98,4
Dengue,Amritsar,Himachal Pradesh,2024-07-01,2676,125,2551,113,9
Dengue,Amritsar,Himachal Pradesh,2024-08-01,950,38,912,150,5
Dengue,Amritsar,Himachal Pradesh,2024-09-01,2168,264,1904,132,3
Dengue,Amritsar,Himachal Pradesh,2024-10-01,4463,69,4394,152,4
Dengue,Amritsar,Himachal Pradesh,2024-11-01,3025,228,2797,127,7
Dengue,Amritsar,Himachal Pradesh,2024-12-01,2569,129,2440,90,1
Dengue,Amritsar,Himachal Pradesh,2025-01-01,4989,125,4864,101,4
Dengue,Amritsar,Himachal Pradesh,2025-02-01,772,37,735,63,8
Dengue,Amritsar,Himachal Pradesh,2025-03-01,1109,10,1099,118,6
Dengue,Amritsar,Himachal Pradesh,2025-04-01,4895,160,4735,26,1
Dengue,Amritsar,Himachal Pradesh,2025-05-01,2659,129,2530,161,6
Dengue,Amritsar,Himachal Pradesh,2025-06-01,2272,11,2261,57,1
Dengue,Amritsar,Himachal Pradesh,2025-07-01,989,64,925,114,5
Dengue,Amritsar,Himachal Pradesh,2025-08-01,3198,70,3128,123,9
Dengue,Amritsar,Himachal Pradesh,2025-09-01,3328,26,3302,165,5
Dengue,Amritsar,Himachal Pradesh,2025-10-01,1129,21,1108,21,2
Dengue,Amritsar,Himachal Pradesh,2025-11-01,2409,273,2136,90,4
Dengue,Amritsar,Himachal Pradesh,2025-12-01,2147,0,2147,134,5
Dengue,Amritsar,Jammu & Kashmir,2018-01-01,2941,184,2757,195,8
Dengue,Amritsar,Jammu & Kashmir,2018-02-01,1096,30,1066,104,8
Dengue,Amritsar,Jammu & Kashmir,2018-03-01,4277,170,4107,76,2
Dengue,Amritsar,Jammu & Kashmir,2018-04-01,3826,258,3568,200,4
Dengue,Amritsar,Jammu & Kashmir,2018-05-01,2110,139,1971,147,6
Dengue,Amritsar,Jammu & Kashmir,2018-06-01,2307,69,2238,176,3
Dengue,Amritsar,Jammu & Kashmir,2018-07-01,2414,25,2389,45,6
Dengue,Amritsar,Jammu & Kashmir,2018-08-01,1553,105,1448,133,1
Dengue,Amritsar,Jammu & Kashmir,2018-09-01,2003,132,1871,51,6
Dengue,Amritsar,Jammu & Kashmir,2018-10-01,2235,93,2142,40,8
Dengue,Amritsar,Jammu & Kashmir,2018-11-01,4761,299,4462,136,5
Dengue,Amritsar,Jammu & Kashmir,2018-12-01,3867,143,3724,139,5
Dengue,Amritsar,Jammu & Kashmir,2019-01-01,3851,100,3751,82,7
Dengue,Amritsar,Jammu & Kashmir,2019-02-01,3094,155,2939,179,4
Dengue,Amritsar,Jammu & Kashmir,2019-03-01,1099,71,1028,87,7
Dengue,Amritsar,Jammu & Kashmir,2019-04-01,2542,150,2392,92,5
Dengue,Amritsar,Jammu & Kashmir,2019-05-01,3899,253,3646,104,2
Dengue,Amritsar,Jammu & Kashmir,2019-06-01,909,25,884,94,7
Dengue,Amritsar,Jammu & Kashmir,2019-07-01,3451,331,3120,171,9
Dengue,Amritsar,Jammu & Kashmir,2019-08-01,4989,200,4789,53,8
Dengue,Amritsar,Jammu & Kashmir,2019-09-01,4022,187,3835,68,7
Dengue,Amritsar,Jammu & Kashmir,2019-10-01,4494,52,4442,46,6
Dengue,Amritsar,Jammu & Kashmir,2019-11-01,2890,128,2762,200,6
Dengue,Amritsar,Jammu & Kashmir,2019-12-01,3896,255,3641,90,5
Dengue,Amritsar,Jammu & Kashmir,2020-01-01,1634,118,1516,67,3
Dengue,Amritsar,Jammu & Kashmir,2020-02-01,3665,350,3315,92,1
Dengue,Amritsar,Jammu & Kashmir,2020-03-01,3475,226,3249,149,1
Dengue,Amritsar,Jammu & Kashmir,2020-04-01,2986,173,2813,140,5
Dengue,Amritsar,Jammu & Kashmir,2020-05-01,4363,161,4202,77,1
Dengue,Amritsar,Jammu & Kashmir,2020-06-01,1875,57,1818,86,6
Dengue,Amritsar,Jammu & Kashmir,2020-07-01,2346,183,2163,32,10
Dengue,Amritsar,Jammu & Kashmir,2020-08-01,2725,211,2514,113,1
Dengue,Amritsar,Jammu & Kashmir,2020-09-01,1216,22,1194,172,2
Dengue,Amritsar,Jammu & Kashmir,2020-10-01,2902,206,2696,77,10
Dengue,Amritsar,Jammu & Kashmir,2020-11-01,291,20,271,139,7
Dengue,Amritsar,Jammu & Kashmir,2020-12-01,4002,70,3932,77,4
Dengue,Amritsar,Jammu & Kashmir,2021-01-01,2660,175,2485,50,3
Dengue,Amritsar,Jammu & Kashmir,2021-02-01,1899,37,1862,141,7
Dengue,Amritsar,Jammu & Kashmir,2021-03-01,1478,0,1478,200,8
Dengue,Amritsar,Jammu & Kashmir,2021-04-01,2283,103,2180,134,1
Dengue,Amritsar,Jammu & Kashmir,2021-05-01,3521,202,3319,85,9
Dengue,Amritsar,Jammu & Kashmir,2021-06-01,3332,155,3177,88,6
Dengue,Amritsar,Jammu & Kashmir,2021-07-01,1651,220,1431,200,8
Dengue,Amritsar,Jammu & Kashmir,2021-08-01,1462,89,1373,122,8
Dengue,Amritsar,Jammu & Kashmir,2021-09-01,3479,189,3290,67,6
Dengue,Amritsar,Jammu & Kashmir,2021-10-01,1628,101,1527,103,6
Dengue,Amritsar,Jammu & Kashmir,2021-11-01,2678,99,2579,117,6
Dengue,Amritsar,Jammu & Kashmir,2021-12-01,2763,213,2550,130,4
Dengue,Amritsar,Jammu & Kashmir,2022-01-01,3016,182,2834,183,7
Dengue,Amritsar,Jammu & Kashmir,2022-02-01,3749,222,3527,171,4
Dengue,Amritsar,Jammu & Kashmir,2022-03-01,903,28,875,116,5
Dengue,Amritsar,Jammu & Kashmir,2022-04-01,78,0,78,104,9
Dengue,Amritsar,Jammu & Kashmir,2022-05-01,1836,65,1771,126,5
Dengue,Amritsar,Jammu & Kashmir,2022-06-01,4989,290,4699,75,6
Dengue,Amritsar,Jammu & Kashmir,2022-07-01,4989,185,4804,156,4
Dengue,Amritsar,Jammu & Kashmir,2022-08-01,4989,292,4697,96,4
Dengue,Amritsar,Jammu & Kashmir,2022-09-01,2339,101,2238,131,10
Dengue,Amritsar,Jammu & Kashmir,2022-10-01,207,12,195,193,1
Dengue,Amritsar,Jammu & Kashmir,2022-11-01,78,0,78,134,5
Dengue,Amritsar,Jammu & Kashmir,2022-12-01,1774,98,1676,118,1
Dengue,Amritsar,Jammu & Kashmir,2023-01-01,2332,73,2259,80,8
Dengue,Amritsar,Jammu & Kashmir,2023-02-01,4342,23,4319,102,5
Dengue,Amritsar,Jammu & Kashmir,2023-03-01,3762,170,3592,48,3
Dengue,Amritsar,Jammu & Kashmir,2023-04-01,2902,275,2627,133,1
Dengue,Amritsar,Jammu & Kashmir,2023-05-01,1404,10,1394,11,9
Dengue,Amritsar,Jammu & Kashmir,2023-06-01,1309,70,1239,156,1
Dengue,Amritsar,Jammu & Kashmir,2023-07-01,2938,215,2723,143,6
Dengue,Amritsar,Jammu & Kashmir,2023-08-01,3533,413,3120,111,8
Dengue,Amritsar,Jammu & Kashmir,2023-09-01,3123,111,3012,79,10
Dengue,Amritsar,Jammu & Kashmir,2023-10-01,1209,38,1171,105,3
Dengue,Amritsar,Jammu & Kashmir,2023-11-01,3470,55,3415,16,2
Dengue,Amritsar,Jammu & Kashmir,2023-12-01,3169,263,2906,148,4
Dengue,Amritsar,Jammu & Kashmir,2024-01-01,1161,28,1133,98,3
Dengue,Amritsar,Jammu & Kashmir,2024-02-01,1545,60,1485,183,1
Dengue,Amritsar,Jammu & Kashmir,2024-03-01,3521,0,3521,126,10
Dengue,Amritsar,Jammu & Kashmir,2024-04-01,2283,173,2110,118,4
Dengue,Amritsar,Jammu & Kashmir,2024-05-01,4729,396,4333,127,4
Dengue,Amritsar,Jammu & Kashmir,2024-06-01,3270,244,3026,57,7
Dengue,Amritsar,Jammu & Kashmir,2024-07-01,1945,6,1939,83,9
Dengue,Amritsar,Jammu & Kashmir,2024-08-01,2584,175,2409,113,1
Dengue,Amritsar,Jammu & Kashmir,2024-09-01,2682,3,2679,91,6
Dengue,Amritsar,Jammu & Kashmir,2024-10-01,1620,83,1537,77,1
Dengue,Amritsar,Jammu & Kashmir,2024-11-01,1373,76,1297,92,6
Dengue,Amritsar,Jammu & Kashmir,2024-12-01,3538,209,3329,108,6
Dengue,Amritsar,Jammu & Kashmir,2025-01-01,3731,244,3487,200,3
Dengue,Amritsar,Jammu & Kashmir,2025-02-01,3407,169,3238,90,5
Dengue,Amritsar,Jammu & Kashmir,2025-03-01,4630,0,4630,72,6
Dengue,Amritsar,Jammu & Kashmir,2025-04-01,1871,122,1749,98,5
Dengue,Amritsar,Jammu & Kashmir,2025-05-01,4843,256,4587,183,4
Dengue,Amritsar,Jammu & Kashmir,2025-06-01,1389,33,1356,186,1
Dengue,Amritsar,Jammu & Kashmir,2025-07-01,1239,5,1234,200,2
Dengue,Amritsar,Jammu & Kashmir,2025-08-01,236,22,214,109,3
Dengue,Amritsar,Jammu & Kashmir,2025-09-01,1999,171,1828,139,2
Dengue,Amritsar,Jammu & Kashmir,2025-10-01,1922,135,1787,53,3
Dengue,Amritsar,Jammu & Kashmir,2025-11-01,3303,100,3203,88,5
Dengue,Amritsar,Jammu & Kashmir,2025-12-01,2925,0,2925,49,5
Dengue,Amritsar,Haryana,2018-01-01,997,72,925,130,6
Dengue,Amritsar,Haryana,2018-02-01,2071,125,1946,108,5
Dengue,Amritsar,Haryana,2018-03-01,2099,82,2017,118,5
Dengue,Amritsar,Haryana,2018-04-01,215,17,198,63,6
Dengue,Amritsar,Haryana,2018-05-01,1281,95,1186,150,2
Dengue,Amritsar,Haryana,2018-06-01,1563,86,1477,11,2
Dengue,Amritsar,Haryana,2018-07-01,4521,230,4291,93,4
Dengue,Amritsar,Haryana,2018-08-01,2854,147,2707,101,3
Dengue,Amritsar,Haryana,2018-09-01,3486,243,3243,11,1
Dengue,Amritsar,Haryana,2018-10-01,587,14,573,126,6
Dengue,Amritsar,Haryana,2018-11-01,4199,262,3937,97,2
Dengue,Amritsar,Haryana,2018-12-01,4343,101,4242,135,10
Dengue,Amritsar,Haryana,2019-01-01,78,0,78,200,5
Dengue,Amritsar,Haryana,2019-02-01,1651,108,1543,123,1
Dengue,Amritsar,Haryana,2019-03-01,3262,97,3165,156,7
Dengue,Amritsar,Haryana,2019-04-01,3462,181,3281,177,5
Dengue,Amritsar,Haryana,2019-05-01,1687,42,1645,131,6
Dengue,Amritsar,Haryana,2019-06-01,2188,205,1983,62,3
Dengue,Amritsar,Haryana,2019-07-01,1796,174,1622,23,2
Dengue,Amritsar,Haryana,2019-08-01,2746,193,2553,125,1
Dengue,Amritsar,Haryana,2019-09-01,4203,400,3803,86,1
Dengue,Amritsar,Haryana,2019-10-01,1563,85,1478,172,1
Dengue,Amritsar,Haryana,2019-11-01,3940,284,3656,82,4
Dengue,Amritsar,Haryana,2019-12-01,1549,132,1417,105,5
Dengue,Amritsar,Haryana,2020-01-01,1460,72,1388,47,1
Dengue,Amritsar,Haryana,2020-02-01,3696,192,3504,89,7
Dengue,Amritsar,Haryana,2020-03-01,3834,296,3538,58,5
Dengue,Amritsar,Haryana,2020-04-01,3740,257,3483,63,10
Dengue,Amritsar,Haryana,2020-05-01,832,23,809,104,4
Dengue,Amritsar,Haryana,2020-06-01,1972,0,1972,75,10
Dengue,Amritsar,Haryana,2020-07-01,3701,166,3535,200,7
Dengue,Amritsar,Haryana,2020-08-01,2653,0,2653,149,1
Dengue,Amritsar,Haryana,2020-09-01,1157,24,1133,161,1
Dengue,Amritsar,Haryana,2020-10-01,3212,79,3133,101,6
Dengue,Amritsar,Haryana,2020-11-01,1638,54,1584,112,1
Dengue,Amritsar,Haryana,2020-12-01,4989,368,4621,84,2
Dengue,Amritsar,Haryana,2021-01-01,4670,374,4296,200,1
Dengue,Amritsar,Haryana,2021-02-01,3408,221,3187,101,10
Dengue,Amritsar,Haryana,2021-03-01,4423,302,4121,75,8
Dengue,Amritsar,Haryana,2021-04-01,2684,185,2499,68,4
Dengue,Amritsar,Haryana,2021-05-01,3624,0,3624,123,9
Dengue,Amritsar,Haryana,2021-06-01,4580,230,4350,179,8
Dengue,Amritsar,Haryana,2021-07-01,2927,0,2927,162,9
Dengue,Amritsar,Haryana,2021-08-01,2255,146,2109,68,3
Dengue,Amritsar,Haryana,2021-09-01,311,0,311,66,4
Dengue,Amritsar,Haryana,2021-10-01,2486,111,2375,170,2
Dengue,Amritsar,Haryana,2021-11-01,3702,244,3458,200,4
Dengue,Amritsar,Haryana,2021-12-01,3866,67,3799,99,2
Dengue,Amritsar,Haryana,2022-01-01,3274,255,3019,168,2
Dengue,Amritsar,Haryana,2022-02-01,1871,121,1750,32,8
Dengue,Amritsar,Haryana,2022-03-01,78,0,78,63,7
Dengue,Amritsar,Haryana,2022-04-01,1933,136,1797,55,2
Dengue,Amritsar,Haryana,2022-05-01,2189,86,2103,127,8
Dengue,Amritsar,Haryana,2022-06-01,2178,118,2060,97,6
Dengue,Amritsar,Haryana,2022-07-01,3427,172,3255,118,4
Dengue,Amritsar,Haryana,2022-08-01,4989,247,4742,168,9
Dengue,Amritsar,Haryana,2022-09-01,2763,84,2679,73,6
Dengue,Amritsar,Haryana,2022-10-01,2307,32,2275,111,10
Dengue,Amritsar,Haryana,2022-11-01,2250,90,2160,38,6
Dengue,Amritsar,Haryana,2022-12-01,2764,106,2658,166,7
Dengue,Amritsar,Haryana,2023-01-01,1486,42,1444,162,2
Dengue,Amritsar,Haryana,2023-02-01,2759,206,2553,125,3
Dengue,Amritsar,Haryana,2023-03-01,3202,51,3151,112,9
Dengue,Amritsar,Haryana,2023-04-01,2879,129,2750,80,8
Dengue,Amritsar,Haryana,2023-05-01,3211,269,2942,35,4
Dengue,Amritsar,Haryana,2023-06-01,3179,243,2936,122,1
Dengue,Amritsar,Haryana,2023-07-01,220,18,202,145,10
Dengue,Amritsar,Haryana,2023-08-01,3452,113,3339,200,8
Dengue,Amritsar,Haryana,2023-09-01,1697,123,1574,86,1
Dengue,Amritsar,Haryana,2023-10-01,1127,21,1106,120,1
Dengue,Amritsar,Haryana,2023-11-01,1116,46,1070,163,10
Dengue,Amritsar,Haryana,2023-12-01,3179,142,3037,165,3
Dengue,Amritsar,Haryana,2024-01-01,2299,76,2223,74,3
Dengue,Amritsar,Haryana,2024-02-01,341,13,328,92,3
Dengue,Amritsar,Haryana,2024-03-01,3239,115,3124,79,6
Dengue,Amritsar,Haryana,2024-04-01,666,14,652,60,1
Dengue,Amritsar,Haryana,2024-05-01,2785,208,2577,181,6
Dengue,Amritsar,Haryana,2024-06-01,2917,130,2787,109,1
Dengue,Amritsar,Haryana,2024-07-01,3785,211,3574,102,1
Dengue,Amritsar,Haryana,2024-08-01,4988,273,4715,119,1
Dengue,Amritsar,Haryana,2024-09-01,767,39,728,109,1
Dengue,Amritsar,Haryana,2024-10-01,2527,133,2394,95,7
Dengue,Amritsar,Haryana,2024-11-01,2227,91,2136,67,7
Dengue,Amritsar,Haryana,2024-12-01,3179,290,2889,186,4
Dengue,Amritsar,Haryana,2025-01-01,2887,208,2679,77,3
Dengue,Amritsar,Haryana,2025-02-01,2124,107,2017,59,9
Dengue,Amritsar,Haryana,2025-03-01,2006,74,1932,102,7
Dengue,Amritsar,Haryana,2025-04-01,1100,51,1049,200,1
Dengue,Amritsar,Haryana,2025-05-01,3923,244,3679,64,6
Dengue,Amritsar,Haryana,2025-06-01,3213,301,2912,142,6
Dengue,Amritsar,Haryana,2025-07-01,3829,38,3791,94,7
Dengue,Amritsar,Haryana,2025-08-01,2181,151,2030,119,10
Dengue,Amritsar,Haryana,2025-09-01,1716,142,1574,153,2
Dengue,Amritsar,Haryana,2025-10-01,1151,7,1144,19,6
Dengue,Amritsar,Haryana,2025-11-01,3079,137,2942,61,9
Dengue,Amritsar,Haryana,2025-12-01,1203,22,1181,152,10
Dengue,Ludhiana,Punjab,2018-01-01,4989,312,4677,111,5
Dengue,Ludhiana,Punjab,2018-02-01,843,33,810,117,1
Dengue,Ludhiana,Punjab,2018-03-01,2965,137,2828,142,1
Dengue,Ludhiana,Punjab,2018-04-01,4699,179,4520,61,7
Dengue,Ludhiana,Punjab,2018-05-01,3401,241,3160,160,6
Dengue,Ludhiana,Punjab,2018-06-01,2833,160,2673,148,5
Dengue,Ludhiana,Punjab,2018-07-01,1298,73,1225,118,6
Dengue,Ludhiana,Punjab,2018-08-01,744,40,704,130,8
Dengue,Ludhiana,Punjab,2018-09-01,3630,242,3388,166,6
Dengue,Ludhiana,Punjab,2018-10-01,4618,196,4422,76,6
Dengue,Ludhiana,Punjab,2018-11-01,2009,200,1809,140,3
Dengue,Ludhiana,Punjab,2018-12-01,1069,15,1054,195,8
Dengue,Ludhiana,Punjab,2019-01-01,78,0,78,139,3
Dengue,Ludhiana,Punjab,2019-02-01,1282,0,1282,95,8
Dengue,Ludhiana,Punjab,2019-03-01,2445,0,2445,200,4
Dengue,Ludhiana,Punjab,2019-04-01,4743,330,4413,118,7
Dengue,Ludhiana,Punjab,2019-05-01,3500,231,3269,177,10
Dengue,Ludhiana,Punjab,2019-06-01,3007,256,2751,85,7
Dengue,Ludhiana,Punjab,2019-07-01,2061,39,2022,161,9
Dengue,Ludhiana,Punjab,2019-08-01,1815,130,1685,78,4
Dengue,Ludhiana,Punjab,2019-09-01,4483,231,4252,123,5
Dengue,Ludhiana,Punjab,2019-10-01,2867,157,2710,75,4
Dengue,Ludhiana,Punjab,2019-11-01,78,0,78,200,1
Dengue,Ludhiana,Punjab,2019-12-01,1694,47,1647,95,8
Dengue,Ludhiana,Punjab,2020-01-01,1446,181,1265,50,6
Dengue,Ludhiana,Punjab,2020-02-01,1865,165,1700,111,6
Dengue,Ludhiana,Punjab,2020-03-01,3353,116,3237,134,8
Dengue,Ludhiana,Punjab,2020-04-01,2453,44,2409,105,2
Dengue,Ludhiana,Punjab,2020-05-01,2494,118,2376,65,1
Dengue,Ludhiana,Punjab,2020-06-01,4359,241,4118,159,8
Dengue,Ludhiana,Punjab,2020-07-01,1663,134,1529,170,5
Dengue,Ludhiana,Punjab,2020-08-01,4989,80,4909,22,5
Dengue,Ludhiana,Punjab,2020-09-01,1697,99,1598,62,1
Dengue,Ludhiana,Punjab,2020-10-01,2717,15,2702,98,9
Dengue,Ludhiana,Punjab,2020-11-01,2220,139,2081,79,7
Dengue,Ludhiana,Punjab,2020-12-01,2763,129,2634,133,3
Dengue,Ludhiana,Punjab,2021-01-01,3194,339,2855,200,10
Dengue,Ludhiana,Punjab,2021-02-01,3179,16,3163,87,1
Dengue,Ludhiana,Punjab,2021-03-01,1587,142,1445,187,4
Dengue,Ludhiana,Punjab,2021-04-01,1091,0,1091,31,8
Dengue,Ludhiana,Punjab,2021-05-01,4989,57,4932,129,8
Dengue,Ludhiana,Punjab,2021-06-01,1948,2,1946,76,1
Dengue,Ludhiana,Punjab,2021-07-01,3535,202,3333,131,4
Dengue,Ludhiana,Punjab,2021-08-01,441,7,434,17,7
Dengue,Ludhiana,Punjab,2021-09-01,2222,24,2198,41,9
Dengue,Ludhiana,Punjab,2021-10-01,2427,135,2292,130,9
Dengue,Ludhiana,Punjab,2021-11-01,3232,204,3028,74,7
Dengue,Ludhiana,Punjab,2021-12-01,78,0,78,90,5
Dengue,Ludhiana,Punjab,2022-01-01,2820,127,2693,200,4
Dengue,Ludhiana,Punjab,2022-02-01,1055,108,947,113,6
Dengue,Ludhiana,Punjab,2022-03-01,3033,164,2869,152,9
Dengue,Ludhiana,Punjab,2022-04-01,1207,88,1119,68,4
Dengue,Ludhiana,Punjab,2022-05-01,1450,78,1372,38,4
Dengue,Ludhiana,Punjab,2022-06-01,2230,40,2190,102,8
Dengue,Ludhiana,Punjab,2022-07-01,1186,78,1108,30,8
Dengue,Ludhiana,Punjab,2022-08-01,1959,60,1899,71,3
Dengue,Ludhiana,Punjab,2022-09-01,996,47,949,118,1
Dengue,Ludhiana,Punjab,2022-10-01,138,8,130,101,1
Dengue,Ludhiana,Punjab,2022-11-01,3963,0,3963,123,5
Dengue,Ludhiana,Punjab,2022-12-01,859,2,857,137,2
Dengue,Ludhiana,Punjab,2023-01-01,2358,180,2178,45,7
Dengue,Ludhiana,Punjab,2023-02-01,3607,110,3497,58,1
Dengue,Ludhiana,Punjab,2023-03-01,1772,56,1716,11,10
Dengue,Ludhiana,Punjab,2023-04-01,1490,81,1409,87,4
Dengue,Ludhiana,Punjab,2023-05-01,2901,112,2789,144,2
Dengue,Ludhiana,Punjab,2023-06-01,4097,254,3843,182,3
Dengue,Ludhiana,Punjab,2023-07-01,1029,49,980,116,2
Dengue,Ludhiana,Punjab,2023-08-01,2396,133,2263,176,9
Dengue,Ludhiana,Punjab,2023-09-01,273,8,265,126,7
Dengue,Ludhiana,Punjab,2023-10-01,2070,115,1955,112,5
Dengue,Ludhiana,Punjab,2023-11-01,2643,217,2426,75,1
Dengue,Ludhiana,Punjab,2023-12-01,1451,48,1403,11,5
Dengue,Ludhiana,Punjab,2024-01-01,1984,152,1832,169,3
Dengue,Ludhiana,Punjab,2024-02-01,708,34,674,103,1
Dengue,Ludhiana,Punjab,2024-03-01,2701,192,2509,177,3
Dengue,Ludhiana,Punjab,2024-04-01,4014,216,3798,58,7
Dengue,Ludhiana,Punjab,2024-05-01,1126,55,1071,200,4
Dengue,Ludhiana,Punjab,2024-06-01,1762,106,1656,94,4
Dengue,Ludhiana,Punjab,2024-07-01,3272,279,2993,71,8
Dengue,Ludhiana,Punjab,2024-08-01,4223,240,3983,95,7
Dengue,Ludhiana,Punjab,2024-09-01,594,38,556,115,10
Dengue,Ludhiana,Punjab,2024-10-01,2371,93,2278,103,1
Dengue,Ludhiana,Punjab,2024-11-01,2977,285,2692,80,2
Dengue,Ludhiana,Punjab,2024-12-01,2460,169,2291,14,7
Dengue,Ludhiana,Punjab,2025-01-01,78,0,78,65,6
Dengue,Ludhiana,Punjab,2025-02-01,3270,152,3118,161,5
Dengue,Ludhiana,Punjab,2025-03-01,4636,364,4272,61,3
Dengue,Ludhiana,Punjab,2025-04-01,2754,89,2665,19,5
Dengue,Ludhiana,Punjab,2025-05-01,1214,0,1214,52,5
Dengue,Ludhiana,Punjab,2025-06-01,1909,99,1810,102,1
Dengue,Ludhiana,Punjab,2025-07-01,4972,421,4551,68,5
Dengue,Ludhiana,Punjab,2025-08-01,3818,368,3450,92,3
Dengue,Ludhiana,Punjab,2025-09-01,3456,162,3294,66,7
Dengue,Ludhiana,Punjab,2025-10-01,3076,157,2919,158,6
Dengue,Ludhiana,Punjab,2025-11-01,1710,111,1599,131,10
Dengue,Ludhiana,Punjab,2025-12-01,2328,98,2230,200,5
Dengue,Ludhiana,Chandigarh,2018-01-01,2493,162,2331,87,2
Dengue,Ludhiana,Chandigarh,2018-02-01,3335,158,3177,92,1
Dengue,Ludhiana,Chandigarh,2018-03-01,4622,367,4255,167,2
Dengue,Ludhiana,Chandigarh,2018-04-01,4098,291,3807,126,6
Dengue,Ludhiana,Chandigarh,2018-05-01,693,51,642,58,7
Dengue,Ludhiana,Chandigarh,2018-06-01,2898,127,2771,135,3
Dengue,Ludhiana,Chandigarh,2018-07-01,3586,380,3206,126,4
Dengue,Ludhiana,Chandigarh,2018-08-01,3428,219,3209,15,5
Dengue,Ludhiana,Chandigarh,2018-09-01,1753,100,1653,73,6
Dengue,Ludhiana,Chandigarh,2018-10-01,4989,139,4850,116,8
Dengue,Ludhiana,Chandigarh,2018-11-01,884,41,843,180,3
Dengue,Ludhiana,Chandigarh,2018-12-01,1144,61,1083,142,3
Dengue,Ludhiana,Chandigarh,2019-01-01,2911,79,2832,77,10
Dengue,Ludhiana,Chandigarh,2019-02-01,4989,207,4782,70,10
Dengue,Ludhiana,Chandigarh,2019-03-01,1476,66,1410,147,3
Dengue,Ludhiana,Chandigarh,2019-04-01,2241,115,2126,11,8
Dengue,Ludhiana,Chandigarh,2019-05-01,4043,0,4043,65,10
Dengue,Ludhiana,Chandigarh,2019-06-01,2573,118,2455,178,9
Dengue,Ludhiana,Chandigarh,2019-07-01,2149,84,2065,121,3
Dengue,Ludhiana,Chandigarh,2019-08-01,3356,165,3191,68,5
Dengue,Ludhiana,Chandigarh,2019-09-01,2963,237,2726,45,1
Dengue,Ludhiana,Chandigarh,2019-10-01,3980,437,3543,149,2
Dengue,Ludhiana,Chandigarh,2019-11-01,4330,302,4028,110,5
Dengue,Ludhiana,Chandigarh,2019-12-01,3009,42,2967,95,5
Dengue,Ludhiana,Chandigarh,2020-01-01,2989,119,2870,125,3
Dengue,Ludhiana,Chandigarh,2020-02-01,2885,194,2691,115,1
Dengue,Ludhiana,Chandigarh,2020-03-01,3254,208,3046,111,5
Dengue,Ludhiana,Chandigarh,2020-04-01,2671,210,2461,39,7
Dengue,Ludhiana,Chandigarh,2020-05-01,2597,122,2475,54,7
Dengue,Ludhiana,Chandigarh,2020-06-01,4203,165,4038,144,4
Dengue,Ludhiana,Chandigarh,2020-07-01,4631,442,4189,135,4
Dengue,Ludhiana,Chandigarh,2020-08-01,575,29,546,126,6
Dengue,Ludhiana,Chandigarh,2020-09-01,2611,53,2558,76,6
Dengue,Ludhiana,Chandigarh,2020-10-01,1674,155,1519,145,5
Dengue,Ludhiana,Chandigarh,2020-11-01,2180,14,2166,87,1
Dengue,Ludhiana,Chandigarh,2020-12-01,3137,0,3137,173,9
Dengue,Ludhiana,Chandigarh,2021-01-01,3495,253,3242,68,3
Dengue,Ludhiana,Chandigarh,2021-02-01,2447,187,2260,79,1
Dengue,Ludhiana,Chandigarh,2021-03-01,78,0,78,98,4
Dengue,Ludhiana,Chandigarh,2021-04-01,1303,15,1288,149,5
Dengue,Ludhiana,Chandigarh,2021-05-01,3800,183,3617,104,3
Dengue,Ludhiana,Chandigarh,2021-06-01,78,0,78,108,3
Dengue,Ludhiana,Chandigarh,2021-07-01,4190,144,4046,86,4
Dengue,Ludhiana,Chandigarh,2021-08-01,3297,300,2997,120,6
Dengue,Ludhiana,Chandigarh,2021-09-01,4363,85,4278,103,2
Dengue,Ludhiana,Chandigarh,2021-10-01,2331,138,2193,66,6
Dengue,Ludhiana,Chandigarh,2021-11-01,78,0,78,113,1
Dengue,Ludhiana,Chandigarh,2021-12-01,3175,194,2981,114,10
Dengue,Ludhiana,Chandigarh,2022-01-01,4307,371,3936,200,8
Dengue,Ludhiana,Chandigarh,2022-02-01,3838,255,3583,75,4
Dengue,Ludhiana,Chandigarh,2022-03-01,1708,106,1602,63,6
Dengue,Ludhiana,Chandigarh,2022-04-01,2714,164,2550,120,1
Dengue,Ludhiana,Chandigarh,2022-05-01,1883,127,1756,56,6
Dengue,Ludhiana,Chandigarh,2022-06-01,1498,58,1440,52,7
Dengue,Ludhiana,Chandigarh,2022-07-01,3879,47,3832,33,6
Dengue,Ludhiana,Chandigarh,2022-08-01,991,77,914,67,7
Dengue,Ludhiana,Chandigarh,2022-09-01,1398,117,1281,68,5
Dengue,Ludhiana,Chandigarh,2022-10-01,1116,64,1052,41,5
Dengue,Ludhiana,Chandigarh,2022-11-01,598,20,578,93,3
Dengue,Ludhiana,Chandigarh,2022-12-01,2794,13,2781,11,6
Dengue,Ludhiana,Chandigarh,2023-01-01,4156,218,3938,131,2
Dengue,Ludhiana,Chandigarh,2023-02-01,2349,25,2324,78,6
Dengue,Ludhiana,Chandigarh,2023-03-01,577,3,574,85,6
Dengue,Ludhiana,Chandigarh,2023-04-01,3724,184,3540,136,9
Dengue,Ludhiana,Chandigarh,2023-05-01,4859,135,4724,125,7
Dengue,Ludhiana,Chandigarh,2023-06-01,1730,104,1626,74,1
Dengue,Ludhiana,Chandigarh,2023-07-01,1955,88,1867,129,3
Dengue,Ludhiana,Chandigarh,2023-08-01,3289,106,3183,185,3
Dengue,Ludhiana,Chandigarh,2023-09-01,4773,2,4771,55,3
Dengue,Ludhiana,Chandigarh,2023-10-01,1900,47,1853,145,8
Dengue,Ludhiana,Chandigarh,2023-11-01,810,21,789,50,1
Dengue,Ludhiana,Chandigarh,2023-12-01,3444,49,3395,166,9
Dengue,Ludhiana,Chandigarh,2024-01-01,3669,148,3521,70,8
Dengue,Ludhiana,Chandigarh,2024-02-01,2606,43,2563,68,5
Dengue,Ludhiana,Chandigarh,2024-03-01,1849,83,1766,165,6
Dengue,Ludhiana,Chandigarh,2024-04-01,3931,224,3707,143,5
Dengue,Ludhiana,Chandigarh,2024-05-01,3306,86,3220,72,5
Dengue,Ludhiana,Chandigarh,2024-06-01,1567,97,1470,113,8
Dengue,Ludhiana,Chandigarh,2024-07-01,2663,27,2636,70,4
Dengue,Ludhiana,Chandigarh,2024-08-01,784,13,771,25,7
Dengue,Ludhiana,Chandigarh,2024-09-01,3518,164,3354,116,2
Dengue,Ludhiana,Chandigarh,2024-10-01,2246,157,2089,88,6
Dengue,Ludhiana,Chandigarh,2024-11-01,2013,151,1862,58,4
Dengue,Ludhiana,Chandigarh,2024-12-01,2553,247,2306,173,6
Dengue,Ludhiana,Chandigarh,2025-01-01,2651,103,2548,60,2
Dengue,Ludhiana,Chandigarh,2025-02-01,3798,176,3622,114,6
Dengue,Ludhiana,Chandigarh,2025-03-01,3390,67,3323,161,5
Dengue,Ludhiana,Chandigarh,2025-04-01,2388,32,2356,93,9
Dengue,Ludhiana,Chandigarh,2025-05-01,3622,205,3417,69,6
Dengue,Ludhiana,Chandigarh,2025-06-01,3135,86,3049,121,6
Dengue,Ludhiana,Chandigarh,2025-07-01,2025,174,1851,129,4
Dengue,Ludhiana,Chandigarh,2025-08-01,2430,18,2412,151,6
Dengue,Ludhiana,Chandigarh,2025-09-01,2399,154,2245,200,6
Dengue,Ludhiana,Chandigarh,2025-10-01,3275,68,3207,83,4
Dengue,Ludhiana,Chandigarh,2025-11-01,2105,55,2050,116,4
Dengue,Ludhiana,Chandigarh,2025-12-01,2074,136,1938,42,2
Dengue,Ludhiana,Himachal Pradesh,2018-01-01,4989,151,4838,140,5
Dengue,Ludhiana,Himachal Pradesh,2018-02-01,3858,135,3723,116,3
Dengue,Ludhiana,Himachal Pradesh,2018-03-01,1577,41,1536,97,6
Dengue,Ludhiana,Himachal Pradesh,2018-04-01,3363,343,3020,75,3
Dengue,Ludhiana,Himachal Pradesh,2018-05-01,2756,88,2668,88,4
Dengue,Ludhiana,Himachal Pradesh,2018-06-01,3123,161,2962,118,2
Dengue,Ludhiana,Himachal Pradesh,2018-07-01,2782,122,2660,57,8
Dengue,Ludhiana,Himachal Pradesh,2018-08-01,4193,236,3957,91,5
Dengue,Ludhiana,Himachal Pradesh,2018-09-01,3061,98,2963,107,5
Dengue,Ludhiana,Himachal Pradesh,2018-10-01,2514,111,2403,28,7
Dengue,Ludhiana,Himachal Pradesh,2018-11-01,3996,245,3751,53,10
Dengue,Ludhiana,Himachal Pradesh,2018-12-01,2910,72,2838,73,5
Dengue,Ludhiana,Himachal Pradesh,2019-01-01,2760,225,2535,186,1
Dengue,Ludhiana,Himachal Pradesh,2019-02-01,3019,255,2764,64,8
Dengue,Ludhiana,Himachal Pradesh,2019-03-01,2472,167,2305,103,1
Dengue,Ludhiana,Himachal Pradesh,2019-04-01,2610,135,2475,53,3
Dengue,Ludhiana,Himachal Pradesh,2019-05-01,1810,0,1810,67,8
Dengue,Ludhiana,Himachal Pradesh,2019-06-01,1590,99,1491,33,4
Dengue,Ludhiana,Himachal Pradesh,2019-07-01,1258,48,1210,140,3
Dengue,Ludhiana,Himachal Pradesh,2019-08-01,730,31,699,39,6
Dengue,Ludhiana,Himachal Pradesh,2019-09-01,1417,0,1417,152,5
Dengue,Ludhiana,Himachal Pradesh,2019-10-01,2364,152,2212,130,3
Dengue,Ludhiana,Himachal Pradesh,2019-11-01,2736,21,2715,102,7
Dengue,Ludhiana,Himachal Pradesh,2019-12-01,2233,119,2114,154,8
Dengue,Ludhiana,Himachal Pradesh,2020-01-01,78,0,78,200,9
Dengue,Ludhiana,Himachal Pradesh,2020-02-01,4710,171,4539,131,6
Dengue,Ludhiana,Himachal Pradesh,2020-03-01,4055,346,3709,49,3
Dengue,Ludhiana,Himachal Pradesh,2020-04-01,3195,90,3105,182,1
Dengue,Ludhiana,Himachal Pradesh,2020-05-01,4989,336,4653,116,1
Dengue,Ludhiana,Himachal Pradesh,2020-06-01,1286,15,1271,200,8
Dengue,Ludhiana,Himachal Pradesh,2020-07-01,4989,399,4590,80,5
Dengue,Ludhiana,Himachal Pradesh,2020-08-01,1303,98,1205,172,4
Dengue,Ludhiana,Himachal Pradesh,2020-09-01,2918,185,2733,106,1
Dengue,Ludhiana,Himachal Pradesh,2020-10-01,889,34,855,200,1
Dengue,Ludhiana,Himachal Pradesh,2020-11-01,2617,24,2593,92,1
Dengue,Ludhiana,Himachal Pradesh,2020-12-01,3115,120,2995,200,9
Dengue,Ludhiana,Himachal Pradesh,2021-01-01,2390,196,2194,129,7
Dengue,Ludhiana,Himachal Pradesh,2021-02-01,3555,191,3364,149,1
Dengue,Ludhiana,Himachal Pradesh,2021-03-01,2730,13,2717,193,10
Dengue,Ludhiana,Himachal Pradesh,2021-04-01,1897,32,1865,66,3
Dengue,Ludhiana,Himachal Pradesh,2021-05-01,1837,158,1679,156,6
Dengue,Ludhiana,Himachal Pradesh,2021-06-01,3685,236,3449,91,6
Dengue,Ludhiana,Himachal Pradesh,2021-07-01,1720,24,1696,114,5
Dengue,Ludhiana,Himachal Pradesh,2021-08-01,3825,0,3825,110,4
Dengue,Ludhiana,Himachal Pradesh,2021-09-01,4238,135,4103,135,5
Dengue,Ludhiana,Himachal Pradesh,2021-10-01,359,0,359,133,4
Dengue,Ludhiana,Himachal Pradesh,2021-11-01,4117,187,3930,77,6
Dengue,Ludhiana,Himachal Pradesh,2021-12-01,4989,442,4547,113,6
Dengue,Ludhiana,Himachal Pradesh,2022-01-01,2935,10,2925,11,3
Dengue,Ludhiana,Himachal Pradesh,2022-02-01,3401,151,3250,157,8
Dengue,Ludhiana,Himachal Pradesh,2022-03-01,3989,352,3637,193,2
Dengue,Ludhiana,Himachal Pradesh,2022-04-01,2228,160,2068,116,6
Dengue,Ludhiana,Himachal Pradesh,2022-05-01,2842,129,2713,24,4
Dengue,Ludhiana,Himachal Pradesh,2022-06-01,834,38,796,144,2
Dengue,Ludhiana,Himachal Pradesh,2022-07-01,2783,45,2738,67,4
Dengue,Ludhiana,Himachal Pradesh,2022-08-01,3266,138,3128,115,3
Dengue,Ludhiana,Himachal Pradesh,2022-09-01,3290,188,3102,141,7
Dengue,Ludhiana,Himachal Pradesh,2022-10-01,4027,331,3696,134,5
Dengue,Ludhiana,Himachal Pradesh,2022-11-01,1558,49,1509,161,9
Dengue,Ludhiana,Himachal Pradesh,2022-12-01,1883,83,1800,114,2
Dengue,Ludhiana,Himachal Pradesh,2023-01-01,4989,111,4878,115,1
Dengue,Ludhiana,Himachal Pradesh,2023-02-01,2396,135,2261,144,6
Dengue,Ludhiana,Himachal Pradesh,2023-03-01,2866,208,2658,103,10
Dengue,Ludhiana,Himachal Pradesh,2023-04-01,2508,171,2337,71,6
Dengue,Ludhiana,Himachal Pradesh,2023-05-01,1495,23,1472,129,2
Dengue,Ludhiana,Himachal Pradesh,2023-06-01,4775,259,4516,49,2
Dengue,Ludhiana,Himachal Pradesh,2023-07-01,1889,57,1832,102,10
Dengue,Ludhiana,Himachal Pradesh,2023-08-01,1085,86,999,36,4
Dengue,Ludhiana,Himachal Pradesh,2023-09-01,1993,90,1903,78,2
Dengue,Ludhiana,Himachal Pradesh,2023-10-01,78,0,78,80,8
Dengue,Ludhiana,Himachal Pradesh,2023-11-01,1724,75,1649,56,4
Dengue,Ludhiana,Himachal Pradesh,2023-12-01,1299,82,1217,162,1
Dengue,Ludhiana,Himachal Pradesh,2024-01-01,3426,195,3231,158,10
Dengue,Ludhiana,Himachal Pradesh,2024-02-01,1694,59,1635,173,7
Dengue,Ludhiana,Himachal Pradesh,2024-03-01,3788,125,3663,97,1
Dengue,Ludhiana,Himachal Pradesh,2024-04-01,4473,95,4378,84,9
Dengue,Ludhiana,Himachal Pradesh,2024-05-01,3645,140,3505,147,2
Dengue,Ludhiana,Himachal Pradesh,2024-06-01,2308,58,2250,113,2
Dengue,Ludhiana,Himachal Pradesh,2024-07-01,2787,218,2569,113,2
Dengue,Ludhiana,Himachal Pradesh,2024-08-01,552,13,539,11,10
Dengue,Ludhiana,Himachal Pradesh,2024-09-01,2418,129,2289,145,10
Dengue,Ludhiana,Himachal Pradesh,2024-10-01,1443,74,1369,138,3
Dengue,Ludhiana,Himachal Pradesh,2024-11-01,3529,273,3256,106,10
Dengue,Ludhiana,Himachal Pradesh,2024-12-01,4989,407,4582,148,1
Dengue,Ludhiana,Himachal Pradesh,2025-01-01,3268,229,3039,137,7
Dengue,Ludhiana,Himachal Pradesh,2025-02-01,78,0,78,71,9
Dengue,Ludhiana,Himachal Pradesh,2025-03-01,2113,41,2072,95,9
Dengue,Ludhiana,Himachal Pradesh,2025-04-01,2762,52,2710,55,5
Dengue,Ludhiana,Himachal Pradesh,2025-05-01,2715,69,2646,181,6
Dengue,Ludhiana,Himachal Pradesh,2025-06-01,1617,116,1501,156,3
Dengue,Ludhiana,Himachal Pradesh,2025-07-01,2926,152,2774,65,5
Dengue,Ludhiana,Himachal Pradesh,2025-08-01,931,70,861,138,4
Dengue,Ludhiana,Himachal Pradesh,2025-09-01,1330,105,1225,120,4
Dengue,Ludhiana,Himachal Pradesh,2025-10-01,3464,100,3364,71,8
Dengue,Ludhiana,Himachal Pradesh,2025-11-01,1235,62,1173,113,5
Dengue,Ludhiana,Himachal Pradesh,2025-12-01,3319,164,3155,150,10
Dengue,Ludhiana,Jammu & Kashmir,2018-01-01,760,30,730,154,6
Dengue,Ludhiana,Jammu & Kashmir,2018-02-01,4965,171,4794,200,10
Dengue,Ludhiana,Jammu & Kashmir,2018-03-01,1559,131,1428,111,8
Dengue,Ludhiana,Jammu & Kashmir,2018-04-01,2297,118,2179,94,5
Dengue,Ludhiana,Jammu & Kashmir,2018-05-01,3041,153,2888,135,5
Dengue,Ludhiana,Jammu & Kashmir,2018-06-01,1839,49,1790,97,2
Dengue,Ludhiana,Jammu & Kashmir,2018-07-01,2790,194,2596,76,5
Dengue,Ludhiana,Jammu & Kashmir,2018-08-01,3369,70,3299,59,2
Dengue,Ludhiana,Jammu & Kashmir,2018-09-01,3886,246,3640,11,9
Dengue,Ludhiana,Jammu & Kashmir,2018-10-01,3659,234,3425,144,4
Dengue,Ludhiana,Jammu & Kashmir,2018-11-01,2367,90,2277,23,6
Dengue,Ludhiana,Jammu & Kashmir,2018-12-01,2401,142,2259,61,1
Dengue,Ludhiana,Jammu & Kashmir,2019-01-01,4989,276,4713,121,4
Dengue,Ludhiana,Jammu & Kashmir,2019-02-01,3872,189,3683,90,4
Dengue,Ludhiana,Jammu & Kashmir,2019-03-01,1361,68,1293,200,7
Dengue,Ludhiana,Jammu & Kashmir,2019-04-01,2732,141,2591,29,6
Dengue,Ludhiana,Jammu & Kashmir,2019-05-01,2148,115,2033,200,8
Dengue,Ludhiana,Jammu & Kashmir,2019-06-01,2416,125,2291,177,6
Dengue,Ludhiana,Jammu & Kashmir,2019-07-01,948,17,931,153,8
Dengue,Ludhiana,Jammu & Kashmir,2019-08-01,2045,93,1952,180,6
Dengue,Ludhiana,Jammu & Kashmir,2019-09-01,4989,288,4701,127,1
Dengue,Ludhiana,Jammu & Kashmir,2019-10-01,3374,178,3196,19,5
Dengue,Ludhiana,Jammu & Kashmir,2019-11-01,78,0,78,132,5
Dengue,Ludhiana,Jammu & Kashmir,2019-12-01,4230,288,3942,31,1
Dengue,Ludhiana,Jammu & Kashmir,2020-01-01,4059,100,3959,79,2
Dengue,Ludhiana,Jammu & Kashmir,2020-02-01,2115,95,2020,102,10
Dengue,Ludhiana,Jammu & Kashmir,2020-03-01,3560,145,3415,60,4
Dengue,Ludhiana,Jammu & Kashmir,2020-04-01,1445,72,1373,154,5
Dengue,Ludhiana,Jammu & Kashmir,2020-05-01,1967,98,1869,95,1
Dengue,Ludhiana,Jammu & Kashmir,2020-06-01,4608,312,4296,127,1
Dengue,Ludhiana,Jammu & Kashmir,2020-07-01,2233,123,2110,106,6
Dengue,Ludhiana,Jammu & Kashmir,2020-08-01,89,7,82,113,3
Dengue,Ludhiana,Jammu & Kashmir,2020-09-01,2512,143,2369,61,2
Dengue,Ludhiana,Jammu & Kashmir,2020-10-01,2492,64,2428,46,9
Dengue,Ludhiana,Jammu & Kashmir,2020-11-01,4205,153,4052,98,3
Dengue,Ludhiana,Jammu & Kashmir,2020-12-01,2617,177,2440,57,1
Dengue,Ludhiana,Jammu & Kashmir,2021-01-01,2032,6,2026,177,5
Dengue,Ludhiana,Jammu & Kashmir,2021-02-01,3999,43,3956,36,2
Dengue,Ludhiana,Jammu & Kashmir,2021-03-01,2759,139,2620,200,2
Dengue,Ludhiana,Jammu & Kashmir,2021-04-01,1591,123,1468,122,5
Dengue,Ludhiana,Jammu & Kashmir,2021-05-01,4147,365,3782,110,3
Dengue,Ludhiana,Jammu & Kashmir,2021-06-01,2857,125,2732,79,1
Dengue,Ludhiana,Jammu & Kashmir,2021-07-01,2601,210,2391,140,6
Dengue,Ludhiana,Jammu & Kashmir,2021-08-01,2836,147,2689,96,7
Dengue,Ludhiana,Jammu & Kashmir,2021-09-01,1161,6,1155,122,4
Dengue,Ludhiana,Jammu & Kashmir,2021-10-01,1890,94,1796,149,7
Dengue,Ludhiana,Jammu & Kashmir,2021-11-01,2602,83,2519,140,4
Dengue,Ludhiana,Jammu & Kashmir,2021-12-01,2336,179,2157,169,1
Dengue,Ludhiana,Jammu & Kashmir,2022-01-01,4304,212,4092,134,7
Dengue,Ludhiana,Jammu & Kashmir,2022-02-01,2889,37,2852,58,5
Dengue,Ludhiana,Jammu & Kashmir,2022-03-01,3744,24,3720,11,5
Dengue,Ludhiana,Jammu & Kashmir,2022-04-01,2610,129,2481,117,5
Dengue,Ludhiana,Jammu & Kashmir,2022-05-01,4014,0,4014,118,4
Dengue,Ludhiana,Jammu & Kashmir,2022-06-01,3131,109,3022,200,5
Dengue,Ludhiana,Jammu & Kashmir,2022-07-01,2615,148,2467,100,5
Dengue,Ludhiana,Jammu & Kashmir,2022-08-01,2580,49,2531,125,8
Dengue,Ludhiana,Jammu & Kashmir,2022-09-01,1317,104,1213,146,6
Dengue,Ludhiana,Jammu & Kashmir,2022-10-01,3277,277,3000,132,8
Dengue,Ludhiana,Jammu & Kashmir,2022-11-01,2543,52,2491,149,9
Dengue,Ludhiana,Jammu & Kashmir,2022-12-01,1924,79,1845,65,1
Dengue,Ludhiana,Jammu & Kashmir,2023-01-01,4082,322,3760,56,9
Dengue,Ludhiana,Jammu & Kashmir,2023-02-01,920,46,874,92,7
Dengue,Ludhiana,Jammu & Kashmir,2023-03-01,2031,19,2012,11,6
Dengue,Ludhiana,Jammu & Kashmir,2023-04-01,3976,182,3794,104,8
Dengue,Ludhiana,Jammu & Kashmir,2023-05-01,3021,76,2945,73,4
Dengue,Ludhiana,Jammu & Kashmir,2023-06-01,2533,208,2325,123,7
Dengue,Ludhiana,Jammu & Kashmir,2023-07-01,2934,198,2736,93,2
Dengue,Ludhiana,Jammu & Kashmir,2023-08-01,2838,116,2722,54,1
Dengue,Ludhiana,Jammu & Kashmir,2023-09-01,563,30,533,173,6
Dengue,Ludhiana,Jammu & Kashmir,2023-10-01,2129,25,2104,110,5
Dengue,Ludhiana,Jammu & Kashmir,2023-11-01,4766,134,4632,150,5
Dengue,Ludhiana,Jammu & Kashmir,2023-12-01,1713,163,1550,116,3
Dengue,Ludhiana,Jammu & Kashmir,2024-01-01,2170,112,2058,130,6
Dengue,Ludhiana,Jammu & Kashmir,2024-02-01,1871,144,1727,37,4
Dengue,Ludhiana,Jammu & Kashmir,2024-03-01,2481,140,2341,171,5
Dengue,Ludhiana,Jammu & Kashmir,2024-04-01,1815,160,1655,151,3
Dengue,Ludhiana,Jammu & Kashmir,2024-05-01,3250,0,3250,105,2
Dengue,Ludhiana,Jammu & Kashmir,2024-06-01,2862,127,2735,121,4
Dengue,Ludhiana,Jammu & Kashmir,2024-07-01,3635,356,3279,157,8
Dengue,Ludhiana,Jammu & Kashmir,2024-08-01,1188,92,1096,87,3
Dengue,Ludhiana,Jammu & Kashmir,2024-09-01,2141,189,1952,26,4
Dengue,Ludhiana,Jammu & Kashmir,2024-10-01,2295,114,2181,88,4
Dengue,Ludhiana,Jammu & Kashmir,2024-11-01,3209,110,3099,114,3
Dengue,Ludhiana,Jammu & Kashmir,2024-12-01,1533,30,1503,105,8
Dengue,Ludhiana,Jammu & Kashmir,2025-01-01,3826,69,3757,173,1
Dengue,Ludhiana,Jammu & Kashmir,2025-02-01,4189,308,3881,57,5
Dengue,Ludhiana,Jammu & Kashmir,2025-03-01,1271,82,1189,64,2
Dengue,Ludhiana,Jammu & Kashmir,2025-04-01,1939,93,1846,52,6
Dengue,Ludhiana,Jammu & Kashmir,2025-05-01,1884,122,1762,128,5
Dengue,Ludhiana,Jammu & Kashmir,2025-06-01,4989,270,4719,28,8
Dengue,Ludhiana,Jammu & Kashmir,2025-07-01,2021,157,1864,144,7
Dengue,Ludhiana,Jammu & Kashmir,2025-08-01,4848,377,4471,59,5
Dengue,Ludhiana,Jammu & Kashmir,2025-09-01,898,17,881,67,7
Dengue,Ludhiana,Jammu & Kashmir,2025-10-01,1270,73,1197,196,7
Dengue,Ludhiana,Jammu & Kashmir,2025-11-01,1676,2,1674,169,2
Dengue,Ludhiana,Jammu & Kashmir,2025-12-01,1463,78,1385,112,7
Dengue,Ludhiana,Haryana,2018-01-01,2238,151,2087,39,6
Dengue,Ludhiana,Haryana,2018-02-01,1647,19,1628,200,6
Dengue,Ludhiana,Haryana,2018-03-01,1498,56,1442,96,4
Dengue,Ludhiana,Haryana,2018-04-01,4152,209,3943,119,2
Dengue,Ludhiana,Haryana,2018-05-01,4239,241,3998,153,2
Dengue,Ludhiana,Haryana,2018-06-01,3871,162,3709,11,1
Dengue,Ludhiana,Haryana,2018-07-01,3300,52,3248,74,3
Dengue,Ludhiana,Haryana,2018-08-01,2722,132,2590,103,10
Dengue,Ludhiana,Haryana,2018-09-01,1931,3,1928,113,7
Dengue,Ludhiana,Haryana,2018-10-01,1319,57,1262,40,6
Dengue,Ludhiana,Haryana,2018-11-01,3084,114,2970,123,8
Dengue,Ludhiana,Haryana,2018-12-01,1023,47,976,108,4
Dengue,Ludhiana,Haryana,2019-01-01,1264,42,1222,191,4
Dengue,Ludhiana,Haryana,2019-02-01,4144,25,4119,157,4
Dengue,Ludhiana,Haryana,2019-03-01,4989,196,4793,92,3
Dengue,Ludhiana,Haryana,2019-04-01,3125,241,2884,96,3
Dengue,Ludhiana,Haryana,2019-05-01,4082,354,3728,158,5
Dengue,Ludhiana,Haryana,2019-06-01,2268,274,1994,121,5
Dengue,Ludhiana,Haryana,2019-07-01,803,79,724,36,9
Dengue,Ludhiana,Haryana,2019-08-01,3419,52,3367,200,8
Dengue,Ludhiana,Haryana,2019-09-01,3361,128,3233,56,1
Dengue,Ludhiana,Haryana,2019-10-01,2694,133,2561,200,4
Dengue,Ludhiana,Haryana,2019-11-01,2272,108,2164,128,2
Dengue,Ludhiana,Haryana,2019-12-01,3888,202,3686,74,1
Dengue,Ludhiana,Haryana,2020-01-01,1275,153,1122,11,5
Dengue,Ludhiana,Haryana,2020-02-01,1559,28,1531,146,6
Dengue,Ludhiana,Haryana,2020-03-01,1245,36,1209,27,5
Dengue,Ludhiana,Haryana,2020-04-01,2711,265,2446,124,6
Dengue,Ludhiana,Haryana,2020-05-01,1138,36,1102,200,4
Dengue,Ludhiana,Haryana,2020-06-01,1679,103,1576,48,2
Dengue,Ludhiana,Haryana,2020-07-01,1651,132,1519,144,4
Dengue,Ludhiana,Haryana,2020-08-01,2248,144,2104,65,9
Dengue,Ludhiana,Haryana,2020-09-01,602,33,569,164,6
Dengue,Ludhiana,Haryana,2020-10-01,2714,210,2504,110,1
Dengue,Ludhiana,Haryana,2020-11-01,4271,102,4169,105,5
Dengue,Ludhiana,Haryana,2020-12-01,2779,99,2680,168,9
Dengue,Ludhiana,Haryana,2021-01-01,4665,306,4359,138,7
Dengue,Ludhiana,Haryana,2021-02-01,4387,0,4387,65,9
Dengue,Ludhiana,Haryana,2021-03-01,3641,332,3309,197,1
Dengue,Ludhiana,Haryana,2021-04-01,2698,158,2540,28,5
Dengue,Ludhiana,Haryana,2021-05-01,2628,143,2485,120,4
Dengue,Ludhiana,Haryana,2021-06-01,3622,9,3613,64,7
Dengue,Ludhiana,Haryana,2021-07-01,2072,26,2046,30,2
Dengue,Ludhiana,Haryana,2021-08-01,78,0,78,48,2
Dengue,Ludhiana,Haryana,2021-09-01,3257,239,3018,104,5
Dengue,Ludhiana,Haryana,2021-10-01,1080,0,1080,124,2
Dengue,Ludhiana,Haryana,2021-11-01,1307,95,1212,160,6
Dengue,Ludhiana,Haryana,2021-12-01,2598,102,2496,181,1
Dengue,Ludhiana,Haryana,2022-01-01,2470,107,2363,120,8
Dengue,Ludhiana,Haryana,2022-02-01,703,40,663,84,1
Dengue,Ludhiana,Haryana,2022-03-01,2819,163,2656,159,7
Dengue,Ludhiana,Haryana,2022-04-01,3893,114,3779,75,3
Dengue,Ludhiana,Haryana,2022-05-01,1084,73,1011,25,1
Dengue,Ludhiana,Haryana,2022-06-01,4304,0,4304,154,5
Dengue,Ludhiana,Haryana,2022-07-01,504,18,486,174,7
Dengue,Ludhiana,Haryana,2022-08-01,4989,272,4717,64,8
Dengue,Ludhiana,Haryana,2022-09-01,2046,81,1965,200,8
Dengue,Ludhiana,Haryana,2022-10-01,2793,0,2793,136,2
Dengue,Ludhiana,Haryana,2022-11-01,78,0,78,128,5
Dengue,Ludhiana,Haryana,2022-12-01,2514,34,2480,80,1
Dengue,Ludhiana,Haryana,2023-01-01,2904,139,2765,158,5
Dengue,Ludhiana,Haryana,2023-02-01,2482,135,2347,29,6
Dengue,Ludhiana,Haryana,2023-03-01,1842,93,1749,89,4
Dengue,Ludhiana,Haryana,2023-04-01,1328,111,1217,69,1
Dengue,Ludhiana,Haryana,2023-05-01,4114,199,3915,40,3
Dengue,Ludhiana,Haryana,2023-06-01,2639,164,2475,150,10
Dengue,Ludhiana,Haryana,2023-07-01,4664,225,4439,124,6
Dengue,Ludhiana,Haryana,2023-08-01,1891,128,1763,147,3
Dengue,Ludhiana,Haryana,2023-09-01,2014,182,1832,92,4
Dengue,Ludhiana,Haryana,2023-10-01,3692,199,3493,156,6
Dengue,Ludhiana,Haryana,2023-11-01,420,30,390,110,1
Dengue,Ludhiana,Haryana,2023-12-01,970,89,881,82,1
Dengue,Ludhiana,Haryana,2024-01-01,4070,364,3706,74,3
Dengue,Ludhiana,Haryana,2024-02-01,1025,39,986,11,3
Dengue,Ludhiana,Haryana,2024-03-01,157,12,145,166,10
Dengue,Ludhiana,Haryana,2024-04-01,4989,285,4704,160,5
Dengue,Ludhiana,Haryana,2024-05-01,728,60,668,200,3
Dengue,Ludhiana,Haryana,2024-06-01,2844,189,2655,89,5
Dengue,Ludhiana,Haryana,2024-07-01,2690,156,2534,72,1
Dengue,Ludhiana,Haryana,2024-08-01,78,0,78,20,2
Dengue,Ludhiana,Haryana,2024-09-01,2239,128,2111,155,3
Dengue,Ludhiana,Haryana,2024-10-01,3199,187,3012,143,2
Dengue,Ludhiana,Haryana,2024-11-01,3073,139,2934,185,8
Dengue,Ludhiana,Haryana,2024-12-01,3809,162,3647,60,7
Dengue,Ludhiana,Haryana,2025-01-01,2078,210,1868,143,1
Dengue,Ludhiana,Haryana,2025-02-01,3553,227,3326,80,1
Dengue,Ludhiana,Haryana,2025-03-01,1673,55,1618,175,1
Dengue,Ludhiana,Haryana,2025-04-01,705,29,676,134,4
Dengue,Ludhiana,Haryana,2025-05-01,856,69,787,27,5
Dengue,Ludhiana,Haryana,2025-06-01,636,18,618,100,6
Dengue,Ludhiana,Haryana,2025-07-01,3952,27,3925,11,2
Dengue,Ludhiana,Haryana,2025-08-01,566,5,561,47,4
Dengue,Ludhiana,Haryana,2025-09-01,2965,0,2965,50,5
Dengue,Ludhiana,Haryana,2025-10-01,2241,27,2214,74,8
Dengue,Ludhiana,Haryana,2025-11-01,2460,38,2422,93,7
Dengue,Ludhiana,Haryana,2025-12-01,4427,400,4027,115,1
Dengue,Chandigarh,Punjab,2018-01-01,2009,97,1912,112,1
Dengue,Chandigarh,Punjab,2018-02-01,3418,135,3283,105,4
Dengue,Chandigarh,Punjab,2018-03-01,2648,21,2627,123,3
Dengue,Chandigarh,Punjab,2018-04-01,2393,109,2284,43,2
Dengue,Chandigarh,Punjab,2018-05-01,4989,20,4969,110,3
Dengue,Chandigarh,Punjab,2018-06-01,664,26,638,179,7
Dengue,Chandigarh,Punjab,2018-07-01,4327,442,3885,98,1
Dengue,Chandigarh,Punjab,2018-08-01,3478,241,3237,131,10
Dengue,Chandigarh,Punjab,2018-09-01,1954,85,1869,127,3
Dengue,Chandigarh,Punjab,2018-10-01,4783,336,4447,150,7
Dengue,Chandigarh,Punjab,2018-11-01,118,4,114,121,3
Dengue,Chandigarh,Punjab,2018-12-01,1897,50,1847,149,1
Dengue,Chandigarh,Punjab,2019-01-01,976,97,879,132,4
Dengue,Chandigarh,Punjab,2019-02-01,3150,53,3097,140,1
Dengue,Chandigarh,Punjab,2019-03-01,1104,43,1061,129,5
Dengue,Chandigarh,Punjab,2019-04-01,3178,187,2991,55,5
Dengue,Chandigarh,Punjab,2019-05-01,2347,53,2294,47,3
Dengue,Chandigarh,Punjab,2019-06-01,1954,134,1820,88,5
Dengue,Chandigarh,Punjab,2019-07-01,3119,128,2991,185,8
Dengue,Chandigarh,Punjab,2019-08-01,2237,155,2082,97,5
Dengue,Chandigarh,Punjab,2019-09-01,1137,76,1061,122,3
Dengue,Chandigarh,Punjab,2019-10-01,4989,214,4775,11,6
Dengue,Chandigarh,Punjab,2019-11-01,1944,194,1750,116,6
Dengue,Chandigarh,Punjab,2019-12-01,78,0,78,111,4
Dengue,Chandigarh,Punjab,2020-01-01,1468,131,1337,11,9
Dengue,Chandigarh,Punjab,2020-02-01,897,75,822,121,4
Dengue,Chandigarh,Punjab,2020-03-01,3706,376,3330,22,9
Dengue,Chandigarh,Punjab,2020-04-01,3029,167,2862,69,3
Dengue,Chandigarh,Punjab,2020-05-01,3132,84,3048,157,7
Dengue,Chandigarh,Punjab,2020-06-01,2101,232,1869,114,4
Dengue,Chandigarh,Punjab,2020-07-01,2223,89,2134,83,6
Dengue,Chandigarh,Punjab,2020-08-01,2100,55,2045,79,1
Dengue,Chandigarh,Punjab,2020-09-01,2488,110,2378,85,10
Dengue,Chandigarh,Punjab,2020-10-01,3718,79,3639,114,6
Dengue,Chandigarh,Punjab,2020-11-01,3048,199,2849,45,8
Dengue,Chandigarh,Punjab,2020-12-01,3268,106,3162,163,1
Dengue,Chandigarh,Punjab,2021-01-01,3268,136,3132,48,5
Dengue,Chandigarh,Punjab,2021-02-01,3784,296,3488,18,4
Dengue,Chandigarh,Punjab,2021-03-01,2984,203,2781,157,2
Dengue,Chandigarh,Punjab,2021-04-01,3079,155,2924,84,9
Dengue,Chandigarh,Punjab,2021-05-01,4192,230,3962,110,5
Dengue,Chandigarh,Punjab,2021-06-01,1705,85,1620,140,5
Dengue,Chandigarh,Punjab,2021-07-01,1449,54,1395,70,7
Dengue,Chandigarh,Punjab,2021-08-01,1006,50,956,113,2
Dengue,Chandigarh,Punjab,2021-09-01,2843,182,2661,139,5
Dengue,Chandigarh,Punjab,2021-10-01,111,5,106,190,5
Dengue,Chandigarh,Punjab,2021-11-01,3217,200,3017,80,5
Dengue,Chandigarh,Punjab,2021-12-01,2451,63,2388,83,8
Dengue,Chandigarh,Punjab,2022-01-01,4120,133,3987,135,4
Dengue,Chandigarh,Punjab,2022-02-01,1696,48,1648,117,3
Dengue,Chandigarh,Punjab,2022-03-01,2325,78,2247,99,3
Dengue,Chandigarh,Punjab,2022-04-01,4103,359,3744,187,3
Dengue,Chandigarh,Punjab,2022-05-01,4453,317,4136,20,8
Dengue,Chandigarh,Punjab,2022-06-01,1685,31,1654,34,5
Dengue,Chandigarh,Punjab,2022-07-01,2841,178,2663,21,8
Dengue,Chandigarh,Punjab,2022-08-01,2992,115,2877,167,6
Dengue,Chandigarh,Punjab,2022-09-01,3099,93,3006,132,2
Dengue,Chandigarh,Punjab,2022-10-01,2245,15,2230,36,1
Dengue,Chandigarh,Punjab,2022-11-01,4316,338,3978,100,1
Dengue,Chandigarh,Punjab,2022-12-01,78,0,78,105,2
Dengue,Chandigarh,Punjab,2023-01-01,2032,98,1934,11,8
Dengue,Chandigarh,Punjab,2023-02-01,3198,72,3126,116,9
Dengue,Chandigarh,Punjab,2023-03-01,3211,233,2978,46,5
Dengue,Chandigarh,Punjab,2023-04-01,4412,177,4235,142,8
Dengue,Chandigarh,Punjab,2023-05-01,4205,194,4011,48,3
Dengue,Chandigarh,Punjab,2023-06-01,2214,104,2110,117,3
Dengue,Chandigarh,Punjab,2023-07-01,4341,255,4086,172,7
Dengue,Chandigarh,Punjab,2023-08-01,1640,82,1558,156,5
Dengue,Chandigarh,Punjab,2023-09-01,3846,187,3659,132,7
Dengue,Chandigarh,Punjab,2023-10-01,4989,174,4815,102,5
Dengue,Chandigarh,Punjab,2023-11-01,4227,17,4210,30,4
Dengue,Chandigarh,Punjab,2023-12-01,2739,47,2692,84,4
Dengue,Chandigarh,Punjab,2024-01-01,2152,152,2000,95,6
Dengue,Chandigarh,Punjab,2024-02-01,547,22,525,91,6
Dengue,Chandigarh,Punjab,2024-03-01,3014,92,2922,28,2
Dengue,Chandigarh,Punjab,2024-04-01,1101,10,1091,128,4
Dengue,Chandigarh,Punjab,2024-05-01,1533,0,1533,46,1
Dengue,Chandigarh,Punjab,2024-06-01,1000,29,971,185,4
Dengue,Chandigarh,Punjab,2024-07-01,1980,150,1830,114,2
Dengue,Chandigarh,Punjab,2024-08-01,2560,86,2474,156,1
Dengue,Chandigarh,Punjab,2024-09-01,2964,182,2782,155,10
Dengue,Chandigarh,Punjab,2024-10-01,1792,58,1734,200,3
Dengue,Chandigarh,Punjab,2024-11-01,4032,276,3756,115,2
Dengue,Chandigarh,Punjab,2024-12-01,2318,92,2226,86,10
Dengue,Chandigarh,Punjab,2025-01-01,1541,21,1520,87,1
Dengue,Chandigarh,Punjab,2025-02-01,2901,122,2779,182,1
Dengue,Chandigarh,Punjab,2025-03-01,4989,442,4547,39,4
Dengue,Chandigarh,Punjab,2025-04-01,3047,311,2736,61,3
Dengue,Chandigarh,Punjab,2025-05-01,2111,135,1976,118,3
Dengue,Chandigarh,Punjab,2025-06-01,548,25,523,98,2
Dengue,Chandigarh,Punjab,2025-07-01,2303,135,2168,156,4
Dengue,Chandigarh,Punjab,2025-08-01,2913,172,2741,38,10
Dengue,Chandigarh,Punjab,2025-09-01,2077,101,1976,103,1
Dengue,Chandigarh,Punjab,2025-10-01,363,22,341,97,7
Dengue,Chandigarh,Punjab,2025-11-01,1456,81,1375,52,9
Dengue,Chandigarh,Punjab,2025-12-01,4549,185,4364,151,3
Dengue,Chandigarh,Chandigarh,2018-01-01,4521,69,4452,102,6
Dengue,Chandigarh,Chandigarh,2018-02-01,1408,51,1357,99,4
Dengue,Chandigarh,Chandigarh,2018-03-01,3500,256,3244,64,1
Dengue,Chandigarh,Chandigarh,2018-04-01,1016,49,967,87,8
Dengue,Chandigarh,Chandigarh,2018-05-01,4481,263,4218,54,5
Dengue,Chandigarh,Chandigarh,2018-06-01,2926,122,2804,150,3
Dengue,Chandigarh,Chandigarh,2018-07-01,3871,74,3797,159,1
Dengue,Chandigarh,Chandigarh,2018-08-01,297,12,285,192,6
Dengue,Chandigarh,Chandigarh,2018-09-01,3506,71,3435,128,5
Dengue,Chandigarh,Chandigarh,2018-10-01,2587,47,2540,89,7
Dengue,Chandigarh,Chandigarh,2018-11-01,3740,318,3422,82,6
Dengue,Chandigarh,Chandigarh,2018-12-01,3825,144,3681,131,2
Dengue,Chandigarh,Chandigarh,2019-01-01,2686,76,2610,116,1
Dengue,Chandigarh,Chandigarh,2019-02-01,1791,174,1617,97,5
Dengue,Chandigarh,Chandigarh,2019-03-01,3643,268,3375,93,4
Dengue,Chandigarh,Chandigarh,2019-04-01,2517,98,2419,166,5
Dengue,Chandigarh,Chandigarh,2019-05-01,1427,89,1338,84,9
Dengue,Chandigarh,Chandigarh,2019-06-01,1363,58,1305,175,5
Dengue,Chandigarh,Chandigarh,2019-07-01,616,18,598,115,7
Dengue,Chandigarh,Chandigarh,2019-08-01,1913,122,1791,87,6
Dengue,Chandigarh,Chandigarh,2019-09-01,4077,165,3912,66,1
Dengue,Chandigarh,Chandigarh,2019-10-01,2836,148,2688,98,1
Dengue,Chandigarh,Chandigarh,2019-11-01,1887,150,1737,132,8
Dengue,Chandigarh,Chandigarh,2019-12-01,3677,281,3396,87,2
Dengue,Chandigarh,Chandigarh,2020-01-01,1481,50,1431,150,6
Dengue,Chandigarh,Chandigarh,2020-02-01,2725,174,2551,84,2
Dengue,Chandigarh,Chandigarh,2020-03-01,2356,40,2316,100,7
Dengue,Chandigarh,Chandigarh,2020-04-01,3643,230,3413,41,6
Dengue,Chandigarh,Chandigarh,2020-05-01,482,26,456,135,4
Dengue,Chandigarh,Chandigarh,2020-06-01,1457,89,1368,93,7
Dengue,Chandigarh,Chandigarh,2020-07-01,400,16,384,187,6
Dengue,Chandigarh,Chandigarh,2020-08-01,2249,249,2000,142,3
Dengue,Chandigarh,Chandigarh,2020-09-01,4223,100,4123,111,5
Dengue,Chandigarh,Chandigarh,2020-10-01,1919,150,1769,169,7
Dengue,Chandigarh,Chandigarh,2020-11-01,1912,38,1874,127,8
Dengue,Chandigarh,Chandigarh,2020-12-01,3767,243,3524,158,4
Dengue,Chandigarh,Chandigarh,2021-01-01,4031,269,3762,62,10
Dengue,Chandigarh,Chandigarh,2021-02-01,2479,128,2351,130,3
Dengue,Chandigarh,Chandigarh,2021-03-01,3516,125,3391,132,1
Dengue,Chandigarh,Chandigarh,2021-04-01,1153,62,1091,28,1
Dengue,Chandigarh,Chandigarh,2021-05-01,4446,257,4189,183,5
Dengue,Chandigarh,Chandigarh,2021-06-01,4989,442,4547,47,5
Dengue,Chandigarh,Chandigarh,2021-07-01,3297,81,3216,40,5
Dengue,Chandigarh,Chandigarh,2021-08-01,78,0,78,11,3
Dengue,Chandigarh,Chandigarh,2021-09-01,1849,107,1742,130,10
Dengue,Chandigarh,Chandigarh,2021-10-01,3420,145,3275,23,9
Dengue,Chandigarh,Chandigarh,2021-11-01,2032,95,1937,80,1
Dengue,Chandigarh,Chandigarh,2021-12-01,4304,349,3955,149,5
Dengue,Chandigarh,Chandigarh,2022-01-01,3386,0,3386,116,5
Dengue,Chandigarh,Chandigarh,2022-02-01,1650,53,1597,74,7
Dengue,Chandigarh,Chandigarh,2022-03-01,2641,0,2641,25,1
Dengue,Chandigarh,Chandigarh,2022-04-01,1398,21,1377,101,1
Dengue,Chandigarh,Chandigarh,2022-05-01,2352,282,2070,150,1
Dengue,Chandigarh,Chandigarh,2022-06-01,1853,125,1728,142,9
Dengue,Chandigarh,Chandigarh,2022-07-01,4173,324,3849,197,3
Dengue,Chandigarh,Chandigarh,2022-08-01,4989,238,4751,73,7
Dengue,Chandigarh,Chandigarh,2022-09-01,677,48,629,39,7
Dengue,Chandigarh,Chandigarh,2022-10-01,78,0,78,122,4
Dengue,Chandigarh,Chandigarh,2022-11-01,2269,182,2087,117,7
Dengue,Chandigarh,Chandigarh,2022-12-01,560,14,546,106,1
Dengue,Chandigarh,Chandigarh,2023-01-01,2659,92,2567,68,3
Dengue,Chandigarh,Chandigarh,2023-02-01,3602,233,3369,11,1
Dengue,Chandigarh,Chandigarh,2023-03-01,4602,272,4330,55,5
Dengue,Chandigarh,Chandigarh,2023-04-01,2868,150,2718,135,3
Dengue,Chandigarh,Chandigarh,2023-05-01,2338,24,2314,121,10
Dengue,Chandigarh,Chandigarh,2023-06-01,78,0,78,155,5
Dengue,Chandigarh,Chandigarh,2023-07-01,2633,205,2428,124,7
Dengue,Chandigarh,Chandigarh,2023-08-01,2693,93,2600,144,7
Dengue,Chandigarh,Chandigarh,2023-09-01,3455,305,3150,145,5
Dengue,Chandigarh,Chandigarh,2023-10-01,1647,40,1607,107,8
Dengue,Chandigarh,Chandigarh,2023-11-01,2014,101,1913,108,5
Dengue,Chandigarh,Chandigarh,2023-12-01,615,58,557,11,6
Dengue,Chandigarh,Chandigarh,2024-01-01,78,0,78,73,10
Dengue,Chandigarh,Chandigarh,2024-02-01,1110,89,1021,75,5
Dengue,Chandigarh,Chandigarh,2024-03-01,491,52,439,101,3
Dengue,Chandigarh,Chandigarh,2024-04-01,3049,167,2882,59,3
Dengue,Chandigarh,Chandigarh,2024-05-01,1902,66,1836,154,5
Dengue,Chandigarh,Chandigarh,2024-06-01,1875,51,1824,61,5
Dengue,Chandigarh,Chandigarh,2024-07-01,1277,112,1165,162,5
Dengue,Chandigarh,Chandigarh,2024-08-01,78,0,78,57,1
Dengue,Chandigarh,Chandigarh,2024-09-01,4621,426,4195,75,1
Dengue,Chandigarh,Chandigarh,2024-10-01,1256,61,1195,72,2
Dengue,Chandigarh,Chandigarh,2024-11-01,2044,164,1880,81,5
Dengue,Chandigarh,Chandigarh,2024-12-01,646,31,615,166,5
Dengue,Chandigarh,Chandigarh,2025-01-01,3901,95,3806,90,6
Dengue,Chandigarh,Chandigarh,2025-02-01,2790,230,2560,91,6
Dengue,Chandigarh,Chandigarh,2025-03-01,1489,145,1344,68,3
Dengue,Chandigarh,Chandigarh,2025-04-01,2071,42,2029,93,2
Dengue,Chandigarh,Chandigarh,2025-05-01,4849,96,4753,117,6
Dengue,Chandigarh,Chandigarh,2025-06-01,2500,128,2372,95,5
Dengue,Chandigarh,Chandigarh,2025-07-01,2354,183,2171,99,2
Dengue,Chandigarh,Chandigarh,2025-08-01,1335,22,1313,158,7
Dengue,Chandigarh,Chandigarh,2025-09-01,78,0,78,120,8
Dengue,Chandigarh,Chandigarh,2025-10-01,2383,78,2305,48,7
Dengue,Chandigarh,Chandigarh,2025-11-01,3034,213,2821,102,8
Dengue,Chandigarh,Chandigarh,2025-12-01,4073,109,3964,79,3
Dengue,Chandigarh,Himachal Pradesh,2018-01-01,78,0,78,133,7
Dengue,Chandigarh,Himachal Pradesh,2018-02-01,1088,49,1039,111,4
Dengue,Chandigarh,Himachal Pradesh,2018-03-01,1818,41,1777,164,10
Dengue,Chandigarh,Himachal Pradesh,2018-04-01,2593,134,2459,69,7
Dengue,Chandigarh,Himachal Pradesh,2018-05-01,2403,0,2403,96,6
Dengue,Chandigarh,Himachal Pradesh,2018-06-01,2434,82,2352,52,10
Dengue,Chandigarh,Himachal Pradesh,2018-07-01,3145,188,2957,104,3
Dengue,Chandigarh,Himachal Pradesh,2018-08-01,1386,0,1386,28,6
Dengue,Chandigarh,Himachal Pradesh,2018-09-01,3851,0,3851,123,10
Dengue,Chandigarh,Himachal Pradesh,2018-10-01,3179,0,3179,103,7
Dengue,Chandigarh,Himachal Pradesh,2018-11-01,2168,192,1976,114,5
Dengue,Chandigarh,Himachal Pradesh,2018-12-01,4745,226,4519,146,4
Dengue,Chandigarh,Himachal Pradesh,2019-01-01,4685,161,4524,118,2
Dengue,Chandigarh,Himachal Pradesh,2019-02-01,3849,298,3551,41,4
Dengue,Chandigarh,Himachal Pradesh,2019-03-01,78,0,78,78,2
Dengue,Chandigarh,Himachal Pradesh,2019-04-01,4716,272,4444,102,4
Dengue,Chandigarh,Himachal Pradesh,2019-05-01,3664,186,3478,89,4
Dengue,Chandigarh,Himachal Pradesh,2019-06-01,4989,181,4808,96,8
Dengue,Chandigarh,Himachal Pradesh,2019-07-01,4257,249,4008,189,4
Dengue,Chandigarh,Himachal Pradesh,2019-08-01,4715,342,4373,111,3
Dengue,Chandigarh,Himachal Pradesh,2019-09-01,3776,168,3608,126,7
Dengue,Chandigarh,Himachal Pradesh,2019-10-01,4407,161,4246,11,7
Dengue,Chandigarh,Himachal Pradesh,2019-11-01,4989,200,4789,144,4
Dengue,Chandigarh,Himachal Pradesh,2019-12-01,2888,0,2888,200,7
Dengue,Chandigarh,Himachal Pradesh,2020-01-01,488,28,460,175,4
Dengue,Chandigarh,Himachal Pradesh,2020-02-01,2185,32,2153,84,4
Dengue,Chandigarh,Himachal Pradesh,2020-03-01,3121,213,2908,200,9
Dengue,Chandigarh,Himachal Pradesh,2020-04-01,2698,127,2571,108,4
Dengue,Chandigarh,Himachal Pradesh,2020-05-01,925,49,876,122,4
Dengue,Chandigarh,Himachal Pradesh,2020-06-01,409,28,381,93,5
Dengue,Chandigarh,Himachal Pradesh,2020-07-01,1603,37,1566,91,1
Dengue,Chandigarh,Himachal Pradesh,2020-08-01,3681,223,3458,11,4
Dengue,Chandigarh,Himachal Pradesh,2020-09-01,4717,272,4445,146,6
Dengue,Chandigarh,Himachal Pradesh,2020-10-01,3827,171,3656,91,10
Dengue,Chandigarh,Himachal Pradesh,2020-11-01,4016,92,3924,97,5
Dengue,Chandigarh,Himachal Pradesh,2020-12-01,2489,167,2322,120,6
Dengue,Chandigarh,Himachal Pradesh,2021-01-01,260,18,242,85,6
Dengue,Chandigarh,Himachal Pradesh,2021-02-01,1987,106,1881,120,10
Dengue,Chandigarh,Himachal Pradesh,2021-03-01,2250,42,2208,168,8
Dengue,Chandigarh,Himachal Pradesh,2021-04-01,1931,67,1864,127,1
Dengue,Chandigarh,Himachal Pradesh,2021-05-01,2671,129,2542,98,8
Dengue,Chandigarh,Himachal Pradesh,2021-06-01,3190,223,2967,100,2
Dengue,Chandigarh,Himachal Pradesh,2021-07-01,3742,14,3728,116,3
Dengue,Chandigarh,Himachal Pradesh,2021-08-01,2224,74,2150,64,1
Dengue,Chandigarh,Himachal Pradesh,2021-09-01,78,0,78,117,10
Dengue,Chandigarh,Himachal Pradesh,2021-10-01,1950,92,1858,141,8
Dengue,Chandigarh,Himachal Pradesh,2021-11-01,2656,32,2624,111,8
Dengue,Chandigarh,Himachal Pradesh,2021-12-01,4238,185,4053,85,8
Dengue,Chandigarh,Himachal Pradesh,2022-01-01,1836,75,1761,92,7
Dengue,Chandigarh,Himachal Pradesh,2022-02-01,3285,65,3220,139,4
Dengue,Chandigarh,Himachal Pradesh,2022-03-01,2987,139,2848,50,5
Dengue,Chandigarh,Himachal Pradesh,2022-04-01,2656,91,2565,65,3
Dengue,Chandigarh,Himachal Pradesh,2022-05-01,3846,248,3598,24,2
Dengue,Chandigarh,Himachal Pradesh,2022-06-01,1711,41,1670,108,3
Dengue,Chandigarh,Himachal Pradesh,2022-07-01,1826,96,1730,150,10
Dengue,Chandigarh,Himachal Pradesh,2022-08-01,2581,68,2513,174,4
Dengue,Chandigarh,Himachal Pradesh,2022-09-01,1739,56,1683,185,8
Dengue,Chandigarh,Himachal Pradesh,2022-10-01,3279,192,3087,71,10
Dengue,Chandigarh,Himachal Pradesh,2022-11-01,1641,93,1548,119,7
Dengue,Chandigarh,Himachal Pradesh,2022-12-01,2901,110,2791,86,3
Dengue,Chandigarh,Himachal Pradesh,2023-01-01,2463,104,2359,190,3
Dengue,Chandigarh,Himachal Pradesh,2023-02-01,2886,22,2864,173,5
Dengue,Chandigarh,Himachal Pradesh,2023-03-01,1981,180,1801,115,10
Dengue,Chandigarh,Himachal Pradesh,2023-04-01,2143,150,1993,75,9
Dengue,Chandigarh,Himachal Pradesh,2023-05-01,2726,188,2538,11,6
Dengue,Chandigarh,Himachal Pradesh,2023-06-01,2868,10,2858,33,4
Dengue,Chandigarh,Himachal Pradesh,2023-07-01,2592,84,2508,12,6
Dengue,Chandigarh,Himachal Pradesh,2023-08-01,4885,197,4688,33,5
Dengue,Chandigarh,Himachal Pradesh,2023-09-01,1268,0,1268,200,5
Dengue,Chandigarh,Himachal Pradesh,2023-10-01,2511,190,2321,40,2
Dengue,Chandigarh,Himachal Pradesh,2023-11-01,486,44,442,52,2
Dengue,Chandigarh,Himachal Pradesh,2023-12-01,3097,340,2757,59,6
Dengue,Chandigarh,Himachal Pradesh,2024-01-01,1101,21,1080,200,1
Dengue,Chandigarh,Himachal Pradesh,2024-02-01,2224,118,2106,103,3
Dengue,Chandigarh,Himachal Pradesh,2024-03-01,2098,185,1913,157,5
Dengue,Chandigarh,Himachal Pradesh,2024-04-01,2974,126,2848,115,6
Dengue,Chandigarh,Himachal Pradesh,2024-05-01,1856,62,1794,11,8
Dengue,Chandigarh,Himachal Pradesh,2024-06-01,1799,0,1799,184,1
Dengue,Chandigarh,Himachal Pradesh,2024-07-01,4524,375,4149,127,1
Dengue,Chandigarh,Himachal Pradesh,2024-08-01,2979,147,2832,100,9
Dengue,Chandigarh,Himachal Pradesh,2024-09-01,1845,53,1792,196,10
Dengue,Chandigarh,Himachal Pradesh,2024-10-01,2261,131,2130,89,2
Dengue,Chandigarh,Himachal Pradesh,2024-11-01,4805,261,4544,99,2
Dengue,Chandigarh,Himachal Pradesh,2024-12-01,2282,125,2157,89,6
Dengue,Chandigarh,Himachal Pradesh,2025-01-01,1673,73,1600,161,5
Dengue,Chandigarh,Himachal Pradesh,2025-02-01,1678,163,1515,148,5
Dengue,Chandigarh,Himachal Pradesh,2025-03-01,1861,85,1776,120,3
Dengue,Chandigarh,Himachal Pradesh,2025-04-01,1800,174,1626,53,7
Dengue,Chandigarh,Himachal Pradesh,2025-05-01,881,58,823,87,4
Dengue,Chandigarh,Himachal Pradesh,2025-06-01,1089,65,1024,53,4
Dengue,Chandigarh,Himachal Pradesh,2025-07-01,1485,69,1416,165,2
Dengue,Chandigarh,Himachal Pradesh,2025-08-01,3391,265,3126,26,7
Dengue,Chandigarh,Himachal Pradesh,2025-09-01,2086,111,1975,187,4
Dengue,Chandigarh,Himachal Pradesh,2025-10-01,2319,53,2266,172,5
Dengue,Chandigarh,Himachal Pradesh,2025-11-01,4301,94,4207,59,8
Dengue,Chandigarh,Himachal Pradesh,2025-12-01,4335,270,4065,85,2
Dengue,Chandigarh,Jammu & Kashmir,2018-01-01,2219,52,2167,70,5
Dengue,Chandigarh,Jammu & Kashmir,2018-02-01,1751,84,1667,128,1
Dengue,Chandigarh,Jammu & Kashmir,2018-03-01,1438,116,1322,178,3
Dengue,Chandigarh,Jammu & Kashmir,2018-04-01,3527,207,3320,167,9
Dengue,Chandigarh,Jammu & Kashmir,2018-05-01,2323,67,2256,84,1
Dengue,Chandigarh,Jammu & Kashmir,2018-06-01,2079,189,1890,170,6
Dengue,Chandigarh,Jammu & Kashmir,2018-07-01,1506,99,1407,166,9
Dengue,Chandigarh,Jammu & Kashmir,2018-08-01,1565,124,1441,97,6
Dengue,Chandigarh,Jammu & Kashmir,2018-09-01,3027,0,3027,106,3
Dengue,Chandigarh,Jammu & Kashmir,2018-10-01,833,49,784,185,2
Dengue,Chandigarh,Jammu & Kashmir,2018-11-01,3932,293,3639,160,1
Dengue,Chandigarh,Jammu & Kashmir,2018-12-01,1881,187,1694,169,9
Dengue,Chandigarh,Jammu & Kashmir,2019-01-01,2397,17,2380,200,4
Dengue,Chandigarh,Jammu & Kashmir,2019-02-01,804,68,736,134,1
Dengue,Chandigarh,Jammu & Kashmir,2019-03-01,2581,252,2329,123,2
Dengue,Chandigarh,Jammu & Kashmir,2019-04-01,2157,0,2157,175,2
Dengue,Chandigarh,Jammu & Kashmir,2019-05-01,2530,161,2369,200,3
Dengue,Chandigarh,Jammu & Kashmir,2019-06-01,4572,311,4261,75,10
Dengue,Chandigarh,Jammu & Kashmir,2019-07-01,2836,115,2721,96,8
Dengue,Chandigarh,Jammu & Kashmir,2019-08-01,1531,54,1477,54,6
Dengue,Chandigarh,Jammu & Kashmir,2019-09-01,1643,114,1529,124,8
Dengue,Chandigarh,Jammu & Kashmir,2019-10-01,3396,109,3287,152,10
Dengue,Chandigarh,Jammu & Kashmir,2019-11-01,4340,189,4151,58,6
Dengue,Chandigarh,Jammu & Kashmir,2019-12-01,2976,219,2757,164,9
Dengue,Chandigarh,Jammu & Kashmir,2020-01-01,3521,356,3165,83,3
Dengue,Chandigarh,Jammu & Kashmir,2020-02-01,3415,224,3191,79,2
Dengue,Chandigarh,Jammu & Kashmir,2020-03-01,4501,242,4259,164,2
Dengue,Chandigarh,Jammu & Kashmir,2020-04-01,78,0,78,74,6
Dengue,Chandigarh,Jammu & Kashmir,2020-05-01,3492,72,3420,35,1
Dengue,Chandigarh,Jammu & Kashmir,2020-06-01,3917,322,3595,144,9
Dengue,Chandigarh,Jammu & Kashmir,2020-07-01,801,36,765,100,3
Dengue,Chandigarh,Jammu & Kashmir,2020-08-01,1409,117,1292,167,7
Dengue,Chandigarh,Jammu & Kashmir,2020-09-01,1456,58,1398,149,1
Dengue,Chandigarh,Jammu & Kashmir,2020-10-01,1620,50,1570,17,8
Dengue,Chandigarh,Jammu & Kashmir,2020-11-01,1951,121,1830,173,9
Dengue,Chandigarh,Jammu & Kashmir,2020-12-01,2923,139,2784,200,5
Dengue,Chandigarh,Jammu & Kashmir,2021-01-01,3759,56,3703,159,6
Dengue,Chandigarh,Jammu & Kashmir,2021-02-01,4048,416,3632,161,2
Dengue,Chandigarh,Jammu & Kashmir,2021-03-01,1473,46,1427,94,5
Dengue,Chandigarh,Jammu & Kashmir,2021-04-01,1464,112,1352,82,8
Dengue,Chandigarh,Jammu & Kashmir,2021-05-01,4363,325,4038,117,4
Dengue,Chandigarh,Jammu & Kashmir,2021-06-01,3465,46,3419,153,9
Dengue,Chandigarh,Jammu & Kashmir,2021-07-01,2709,56,2653,152,1
Dengue,Chandigarh,Jammu & Kashmir,2021-08-01,3232,133,3099,84,4
Dengue,Chandigarh,Jammu & Kashmir,2021-09-01,2557,63,2494,79,1
Dengue,Chandigarh,Jammu & Kashmir,2021-10-01,3301,331,2970,30,6
Dengue,Chandigarh,Jammu & Kashmir,2021-11-01,2147,94,2053,139,4
Dengue,Chandigarh,Jammu & Kashmir,2021-12-01,2958,224,2734,86,4
Dengue,Chandigarh,Jammu & Kashmir,2022-01-01,571,37,534,91,7
Dengue,Chandigarh,Jammu & Kashmir,2022-02-01,1675,96,1579,194,4
Dengue,Chandigarh,Jammu & Kashmir,2022-03-01,1689,86,1603,137,10
Dengue,Chandigarh,Jammu & Kashmir,2022-04-01,2095,180,1915,123,7
Dengue,Chandigarh,Jammu & Kashmir,2022-05-01,1354,35,1319,149,5
Dengue,Chandigarh,Jammu & Kashmir,2022-06-01,1882,188,1694,179,3
Dengue,Chandigarh,Jammu & Kashmir,2022-07-01,566,7,559,24,2
Dengue,Chandigarh,Jammu & Kashmir,2022-08-01,3333,242,3091,77,6
Dengue,Chandigarh,Jammu & Kashmir,2022-09-01,2487,22,2465,94,3
Dengue,Chandigarh,Jammu & Kashmir,2022-10-01,310,12,298,56,8
Dengue,Chandigarh,Jammu & Kashmir,2022-11-01,1477,77,1400,93,5
Dengue,Chandigarh,Jammu & Kashmir,2022-12-01,3049,109,2940,27,5
Dengue,Chandigarh,Jammu & Kashmir,2023-01-01,1869,83,1786,153,5
Dengue,Chandigarh,Jammu & Kashmir,2023-02-01,1662,16,1646,80,4
Dengue,Chandigarh,Jammu & Kashmir,2023-03-01,2497,53,2444,116,6
Dengue,Chandigarh,Jammu & Kashmir,2023-04-01,3058,197,2861,109,10
Dengue,Chandigarh,Jammu & Kashmir,2023-05-01,671,34,637,135,6
Dengue,Chandigarh,Jammu & Kashmir,2023-06-01,3335,99,3236,11,6
Dengue,Chandigarh,Jammu & Kashmir,2023-07-01,1524,135,1389,129,7
Dengue,Chandigarh,Jammu & Kashmir,2023-08-01,2573,37,2536,92,5
Dengue,Chandigarh,Jammu & Kashmir,2023-09-01,2550,100,2450,127,2
Dengue,Chandigarh,Jammu & Kashmir,2023-10-01,1890,66,1824,46,1
Dengue,Chandigarh,Jammu & Kashmir,2023-11-01,1224,83,1141,127,1
Dengue,Chandigarh,Jammu & Kashmir,2023-12-01,2214,113,2101,172,7
Dengue,Chandigarh,Jammu & Kashmir,2024-01-01,4778,224,4554,116,6
Dengue,Chandigarh,Jammu & Kashmir,2024-02-01,771,0,771,70,4
Dengue,Chandigarh,Jammu & Kashmir,2024-03-01,4868,366,4502,72,10
Dengue,Chandigarh,Jammu & Kashmir,2024-04-01,2249,98,2151,136,5
Dengue,Chandigarh,Jammu & Kashmir,2024-05-01,2645,141,2504,135,1
Dengue,Chandigarh,Jammu & Kashmir,2024-06-01,1140,32,1108,124,7
Dengue,Chandigarh,Jammu & Kashmir,2024-07-01,1563,37,1526,104,8
Dengue,Chandigarh,Jammu & Kashmir,2024-08-01,1923,180,1743,117,7
Dengue,Chandigarh,Jammu & Kashmir,2024-09-01,1195,0,1195,103,8
Dengue,Chandigarh,Jammu & Kashmir,2024-10-01,2317,44,2273,87,1
Dengue,Chandigarh,Jammu & Kashmir,2024-11-01,2051,191,1860,145,5
Dengue,Chandigarh,Jammu & Kashmir,2024-12-01,4989,342,4647,122,2
Dengue,Chandigarh,Jammu & Kashmir,2025-01-01,1033,41,992,172,6
Dengue,Chandigarh,Jammu & Kashmir,2025-02-01,2735,236,2499,163,9
Dengue,Chandigarh,Jammu & Kashmir,2025-03-01,2930,184,2746,120,4
Dengue,Chandigarh,Jammu & Kashmir,2025-04-01,1162,66,1096,137,7
Dengue,Chandigarh,Jammu & Kashmir,2025-05-01,3519,199,3320,57,2
Dengue,Chandigarh,Jammu & Kashmir,2025-06-01,2063,131,1932,102,5
Dengue,Chandigarh,Jammu & Kashmir,2025-07-01,78,0,78,124,3
Dengue,Chandigarh,Jammu & Kashmir,2025-08-01,3483,397,3086,26,10
Dengue,Chandigarh,Jammu & Kashmir,2025-09-01,1099,48,1051,128,2
Dengue,Chandigarh,Jammu & Kashmir,2025-10-01,1192,53,1139,57,5
Dengue,Chandigarh,Jammu & Kashmir,2025-11-01,3520,49,3471,63,9
Dengue,Chandigarh,Jammu & Kashmir,2025-12-01,2132,103,2029,79,1
Dengue,Chandigarh,Haryana,2018-01-01,3829,399,3430,105,6
Dengue,Chandigarh,Haryana,2018-02-01,4221,332,3889,39,5
Dengue,Chandigarh,Haryana,2018-03-01,1732,59,1673,150,3
Dengue,Chandigarh,Haryana,2018-04-01,3662,186,3476,115,8
Dengue,Chandigarh,Haryana,2018-05-01,1584,19,1565,200,10
Dengue,Chandigarh,Haryana,2018-06-01,4989,109,4880,121,7
Dengue,Chandigarh,Haryana,2018-07-01,1668,90,1578,135,4
Dengue,Chandigarh,Haryana,2018-08-01,3974,141,3833,63,1
Dengue,Chandigarh,Haryana,2018-09-01,3729,73,3656,46,5
Dengue,Chandigarh,Haryana,2018-10-01,3021,194,2827,138,4
Dengue,Chandigarh,Haryana,2018-11-01,1698,80,1618,51,5
Dengue,Chandigarh,Haryana,2018-12-01,2394,10,2384,139,3
Dengue,Chandigarh,Haryana,2019-01-01,78,0,78,193,3
Dengue,Chandigarh,Haryana,2019-02-01,2898,97,2801,154,5
Dengue,Chandigarh,Haryana,2019-03-01,3066,11,3055,135,1
Dengue,Chandigarh,Haryana,2019-04-01,2776,0,2776,120,8
Dengue,Chandigarh,Haryana,2019-05-01,78,0,78,87,3
Dengue,Chandigarh,Haryana,2019-06-01,900,42,858,100,5
Dengue,Chandigarh,Haryana,2019-07-01,1594,67,1527,77,4
Dengue,Chandigarh,Haryana,2019-08-01,2989,133,2856,39,7
Dengue,Chandigarh,Haryana,2019-09-01,2986,50,2936,108,7
Dengue,Chandigarh,Haryana,2019-10-01,2369,146,2223,163,6
Dengue,Chandigarh,Haryana,2019-11-01,3450,159,3291,41,1
Dengue,Chandigarh,Haryana,2019-12-01,1221,34,1187,177,4
Dengue,Chandigarh,Haryana,2020-01-01,3416,110,3306,168,9
Dengue,Chandigarh,Haryana,2020-02-01,3234,46,3188,126,4
Dengue,Chandigarh,Haryana,2020-03-01,3104,118,2986,127,8
Dengue,Chandigarh,Haryana,2020-04-01,2353,101,2252,97,5
Dengue,Chandigarh,Haryana,2020-05-01,4989,187,4802,108,4
Dengue,Chandigarh,Haryana,2020-06-01,3259,168,3091,83,5
Dengue,Chandigarh,Haryana,2020-07-01,1298,62,1236,108,2
Dengue,Chandigarh,Haryana,2020-08-01,2931,166,2765,113,7
Dengue,Chandigarh,Haryana,2020-09-01,3607,279,3328,200,2
Dengue,Chandigarh,Haryana,2020-10-01,1808,121,1687,135,6
Dengue,Chandigarh,Haryana,2020-11-01,4059,316,3743,96,8
Dengue,Chandigarh,Haryana,2020-12-01,3110,78,3032,101,6
Dengue,Chandigarh,Haryana,2021-01-01,78,0,78,70,3
Dengue,Chandigarh,Haryana,2021-02-01,2999,207,2792,78,5
Dengue,Chandigarh,Haryana,2021-03-01,2053,142,1911,153,3
Dengue,Chandigarh,Haryana,2021-04-01,3318,100,3218,81,4
Dengue,Chandigarh,Haryana,2021-05-01,3864,262,3602,75,3
Dengue,Chandigarh,Haryana,2021-06-01,2859,64,2795,76,3
Dengue,Chandigarh,Haryana,2021-07-01,4831,309,4522,69,7
Dengue,Chandigarh,Haryana,2021-08-01,2358,116,2242,164,8
Dengue,Chandigarh,Haryana,2021-09-01,3436,33,3403,113,8
Dengue,Chandigarh,Haryana,2021-10-01,3677,137,3540,92,6
Dengue,Chandigarh,Haryana,2021-11-01,2467,280,2187,108,9
Dengue,Chandigarh,Haryana,2021-12-01,3642,203,3439,117,3
Dengue,Chandigarh,Haryana,2022-01-01,1800,210,1590,68,9
Dengue,Chandigarh,Haryana,2022-02-01,2031,16,2015,35,7
Dengue,Chandigarh,Haryana,2022-03-01,837,60,777,174,5
Dengue,Chandigarh,Haryana,2022-04-01,2921,0,2921,157,5
Dengue,Chandigarh,Haryana,2022-05-01,3034,151,2883,125,8
Dengue,Chandigarh,Haryana,2022-06-01,4179,286,3893,153,7
Dengue,Chandigarh,Haryana,2022-07-01,3659,272,3387,200,6
Dengue,Chandigarh,Haryana,2022-08-01,2215,59,2156,79,4
Dengue,Chandigarh,Haryana,2022-09-01,1017,81,936,49,2
Dengue,Chandigarh,Haryana,2022-10-01,3178,109,3069,140,5
Dengue,Chandigarh,Haryana,2022-11-01,4087,185,3902,31,1
Dengue,Chandigarh,Haryana,2022-12-01,3610,135,3475,108,7
Dengue,Chandigarh,Haryana,2023-01-01,4052,68,3984,91,1
Dengue,Chandigarh,Haryana,2023-02-01,2313,221,2092,141,6
Dengue,Chandigarh,Haryana,2023-03-01,1971,101,1870,82,4
Dengue,Chandigarh,Haryana,2023-04-01,1609,131,1478,167,4
Dengue,Chandigarh,Haryana,2023-05-01,2522,202,2320,68,4
Dengue,Chandigarh,Haryana,2023-06-01,2492,54,2438,142,1
Dengue,Chandigarh,Haryana,2023-07-01,2875,245,2630,72,4
Dengue,Chandigarh,Haryana,2023-08-01,2424,156,2268,134,2
Dengue,Chandigarh,Haryana,2023-09-01,2418,47,2371,55,2
Dengue,Chandigarh,Haryana,2023-10-01,1555,98,1457,105,10
Dengue,Chandigarh,Haryana,2023-11-01,3861,78,3783,174,1
Dengue,Chandigarh,Haryana,2023-12-01,2700,261,2439,112,6
Dengue,Chandigarh,Haryana,2024-01-01,2363,174,2189,166,3
Dengue,Chandigarh,Haryana,2024-02-01,1595,76,1519,105,2
Dengue,Chandigarh,Haryana,2024-03-01,811,70,741,80,1
Dengue,Chandigarh,Haryana,2024-04-01,4352,17,4335,115,8
Dengue,Chandigarh,Haryana,2024-05-01,3341,94,3247,138,8
Dengue,Chandigarh,Haryana,2024-06-01,419,17,402,11,3
Dengue,Chandigarh,Haryana,2024-07-01,3621,416,3205,133,7
Dengue,Chandigarh,Haryana,2024-08-01,3835,72,3763,58,2
Dengue,Chandigarh,Haryana,2024-09-01,2764,1,2763,46,4
Dengue,Chandigarh,Haryana,2024-10-01,4741,38,4703,134,7
Dengue,Chandigarh,Haryana,2024-11-01,2888,220,2668,174,2
Dengue,Chandigarh,Haryana,2024-12-01,697,22,675,117,3
Dengue,Chandigarh,Haryana,2025-01-01,3087,140,2947,37,5
Dengue,Chandigarh,Haryana,2025-02-01,2926,211,2715,72,5
Dengue,Chandigarh,Haryana,2025-03-01,1788,81,1707,85,2
Dengue,Chandigarh,Haryana,2025-04-01,3367,188,3179,116,10
Dengue,Chandigarh,Haryana,2025-05-01,360,23,337,103,2
Dengue,Chandigarh,Haryana,2025-06-01,3926,147,3779,131,8
Dengue,Chandigarh,Haryana,2025-07-01,1419,64,1355,157,7
Dengue,Chandigarh,Haryana,2025-08-01,1276,72,1204,124,2
Dengue,Chandigarh,Haryana,2025-09-01,2445,184,2261,152,6
Dengue,Chandigarh,Haryana,2025-10-01,3178,85,3093,92,2
Dengue,Chandigarh,Haryana,2025-11-01,2817,0,2817,200,5
Dengue,Chandigarh,Haryana,2025-12-01,1601,111,1490,134,7
Dengue,Shimla,Punjab,2018-01-01,1918,147,1771,141,3
Dengue,Shimla,Punjab,2018-02-01,1077,60,1017,196,6
Dengue,Shimla,Punjab,2018-03-01,2296,132,2164,111,3
Dengue,Shimla,Punjab,2018-04-01,4040,135,3905,73,5
Dengue,Shimla,Punjab,2018-05-01,2592,167,2425,173,5
Dengue,Shimla,Punjab,2018-06-01,3750,280,3470,176,4
Dengue,Shimla,Punjab,2018-07-01,4550,235,4315,114,1
Dengue,Shimla,Punjab,2018-08-01,1809,221,1588,196,7
Dengue,Shimla,Punjab,2018-09-01,2347,10,2337,102,10
Dengue,Shimla,Punjab,2018-10-01,4989,273,4716,154,5
Dengue,Shimla,Punjab,2018-11-01,4535,72,4463,183,3
Dengue,Shimla,Punjab,2018-12-01,354,26,328,111,5
Dengue,Shimla,Punjab,2019-01-01,3117,12,3105,129,8
Dengue,Shimla,Punjab,2019-02-01,2598,29,2569,158,9
Dengue,Shimla,Punjab,2019-03-01,3706,117,3589,88,7
Dengue,Shimla,Punjab,2019-04-01,1598,92,1506,65,6
Dengue,Shimla,Punjab,2019-05-01,1471,48,1423,174,7
Dengue,Shimla,Punjab,2019-06-01,1690,55,1635,122,5
Dengue,Shimla,Punjab,2019-07-01,1830,81,1749,80,2
Dengue,Shimla,Punjab,2019-08-01,3691,158,3533,111,4
Dengue,Shimla,Punjab,2019-09-01,1013,94,919,132,4
Dengue,Shimla,Punjab,2019-10-01,1762,123,1639,26,6
Dengue,Shimla,Punjab,2019-11-01,197,8,189,143,1
Dengue,Shimla,Punjab,2019-12-01,3948,438,3510,127,6
Dengue,Shimla,Punjab,2020-01-01,4302,276,4026,191,1
Dengue,Shimla,Punjab,2020-02-01,2159,47,2112,95,6
Dengue,Shimla,Punjab,2020-03-01,2198,126,2072,176,8
Dengue,Shimla,Punjab,2020-04-01,3205,210,2995,104,7
Dengue,Shimla,Punjab,2020-05-01,4575,137,4438,113,2
Dengue,Shimla,Punjab,2020-06-01,3146,61,3085,121,7
Dengue,Shimla,Punjab,2020-07-01,1662,87,1575,200,7
Dengue,Shimla,Punjab,2020-08-01,426,16,410,43,10
Dengue,Shimla,Punjab,2020-09-01,1101,102,999,131,6
Dengue,Shimla,Punjab,2020-10-01,2696,193,2503,108,8
Dengue,Shimla,Punjab,2020-11-01,1718,53,1665,105,4
Dengue,Shimla,Punjab,2020-12-01,2859,178,2681,136,2
Dengue,Shimla,Punjab,2021-01-01,1856,161,1695,163,7
Dengue,Shimla,Punjab,2021-02-01,1178,11,1167,133,7
Dengue,Shimla,Punjab,2021-03-01,1018,20,998,169,3
Dengue,Shimla,Punjab,2021-04-01,4693,233,4460,93,1
Dengue,Shimla,Punjab,2021-05-01,3790,193,3597,104,5
Dengue,Shimla,Punjab,2021-06-01,4919,238,4681,55,5
Dengue,Shimla,Punjab,2021-07-01,3322,136,3186,200,5
Dengue,Shimla,Punjab,2021-08-01,2021,82,1939,97,7
Dengue,Shimla,Punjab,2021-09-01,4373,267,4106,91,8
Dengue,Shimla,Punjab,2021-10-01,2553,212,2341,137,5
Dengue,Shimla,Punjab,2021-11-01,2894,104,2790,163,2
Dengue,Shimla,Punjab,2021-12-01,2540,307,2233,71,3
Dengue,Shimla,Punjab,2022-01-01,78,0,78,167,3
Dengue,Shimla,Punjab,2022-02-01,4750,421,4329,91,4
Dengue,Shimla,Punjab,2022-03-01,3256,222,3034,179,3
Dengue,Shimla,Punjab,2022-04-01,3040,329,2711,79,4
Dengue,Shimla,Punjab,2022-05-01,2515,104,2411,144,5
Dengue,Shimla,Punjab,2022-06-01,2817,72,2745,108,3
Dengue,Shimla,Punjab,2022-07-01,1796,62,1734,49,6
Dengue,Shimla,Punjab,2022-08-01,3425,71,3354,34,10
Dengue,Shimla,Punjab,2022-09-01,844,45,799,68,4
Dengue,Shimla,Punjab,2022-10-01,2847,167,2680,157,3
Dengue,Shimla,Punjab,2022-11-01,3351,187,3164,11,6
Dengue,Shimla,Punjab,2022-12-01,2331,115,2216,123,3
Dengue,Shimla,Punjab,2023-01-01,3095,166,2929,119,4
Dengue,Shimla,Punjab,2023-02-01,1268,127,1141,21,3
Dengue,Shimla,Punjab,2023-03-01,1302,88,1214,66,2
Dengue,Shimla,Punjab,2023-04-01,2915,224,2691,66,2
Dengue,Shimla,Punjab,2023-05-01,3508,195,3313,109,3
Dengue,Shimla,Punjab,2023-06-01,82,0,82,181,2
Dengue,Shimla,Punjab,2023-07-01,3298,0,3298,161,9
Dengue,Shimla,Punjab,2023-08-01,1869,206,1663,88,6
Dengue,Shimla,Punjab,2023-09-01,2339,80,2259,64,8
Dengue,Shimla,Punjab,2023-10-01,800,25,775,27,1
Dengue,Shimla,Punjab,2023-11-01,1455,83,1372,87,4
Dengue,Shimla,Punjab,2023-12-01,3893,257,3636,60,6
Dengue,Shimla,Punjab,2024-01-01,2641,184,2457,104,10
Dengue,Shimla,Punjab,2024-02-01,2084,211,1873,106,3
Dengue,Shimla,Punjab,2024-03-01,2441,228,2213,82,1
Dengue,Shimla,Punjab,2024-04-01,3254,86,3168,83,5
Dengue,Shimla,Punjab,2024-05-01,3188,249,2939,71,3
Dengue,Shimla,Punjab,2024-06-01,2497,97,2400,80,10
Dengue,Shimla,Punjab,2024-07-01,4064,187,3877,179,6
Dengue,Shimla,Punjab,2024-08-01,3899,71,3828,133,4
Dengue,Shimla,Punjab,2024-09-01,3152,2,3150,133,4
Dengue,Shimla,Punjab,2024-10-01,2671,131,2540,158,4
Dengue,Shimla,Punjab,2024-11-01,3479,77,3402,153,1
Dengue,Shimla,Punjab,2024-12-01,3019,232,2787,179,5
Dengue,Shimla,Punjab,2025-01-01,4020,168,3852,136,3
Dengue,Shimla,Punjab,2025-02-01,3804,224,3580,117,7
Dengue,Shimla,Punjab,2025-03-01,1231,110,1121,76,2
Dengue,Shimla,Punjab,2025-04-01,1141,7,1134,64,7
Dengue,Shimla,Punjab,2025-05-01,1657,48,1609,151,6
Dengue,Shimla,Punjab,2025-06-01,3907,216,3691,101,5
Dengue,Shimla,Punjab,2025-07-01,483,28,455,37,8
Dengue,Shimla,Punjab,2025-08-01,3127,257,2870,11,1
Dengue,Shimla,Punjab,2025-09-01,3084,232,2852,200,6
Dengue,Shimla,Punjab,2025-10-01,4157,219,3938,56,5
Dengue,Shimla,Punjab,2025-11-01,2839,167,2672,71,5
Dengue,Shimla,Punjab,2025-12-01,795,47,748,169,2
Dengue,Shimla,Chandigarh,2018-01-01,1310,9,1301,45,1
Dengue,Shimla,Chandigarh,2018-02-01,1012,46,966,133,7
Dengue,Shimla,Chandigarh,2018-03-01,1876,107,1769,199,7
Dengue,Shimla,Chandigarh,2018-04-01,2352,149,2203,200,10
Dengue,Shimla,Chandigarh,2018-05-01,1034,23,1011,83,10
Dengue,Shimla,Chandigarh,2018-06-01,4570,60,4510,106,1
Dengue,Shimla,Chandigarh,2018-07-01,820,35,785,86,4
Dengue,Shimla,Chandigarh,2018-08-01,4403,442,3961,105,6
Dengue,Shimla,Chandigarh,2018-09-01,4187,109,4078,172,8
Dengue,Shimla,Chandigarh,2018-10-01,3802,320,3482,35,9
Dengue,Shimla,Chandigarh,2018-11-01,1667,160,1507,139,2
Dengue,Shimla,Chandigarh,2018-12-01,3057,157,2900,96,3
Dengue,Shimla,Chandigarh,2019-01-01,884,26,858,176,9
Dengue,Shimla,Chandigarh,2019-02-01,3819,248,3571,173,1
Dengue,Shimla,Chandigarh,2019-03-01,2498,139,2359,85,2
Dengue,Shimla,Chandigarh,2019-04-01,2048,51,1997,101,6
Dengue,Shimla,Chandigarh,2019-05-01,956,29,927,152,10
Dengue,Shimla,Chandigarh,2019-06-01,78,0,78,156,1
Dengue,Shimla,Chandigarh,2019-07-01,1204,92,1112,11,5
Dengue,Shimla,Chandigarh,2019-08-01,4090,166,3924,152,6
Dengue,Shimla,Chandigarh,2019-09-01,2057,98,1959,190,9
Dengue,Shimla,Chandigarh,2019-10-01,2370,164,2206,119,6
Dengue,Shimla,Chandigarh,2019-11-01,3477,156,3321,155,1
Dengue,Shimla,Chandigarh,2019-12-01,4989,206,4783,171,1
Dengue,Shimla,Chandigarh,2020-01-01,4375,122,4253,117,9
Dengue,Shimla,Chandigarh,2020-02-01,1293,35,1258,148,6
Dengue,Shimla,Chandigarh,2020-03-01,78,0,78,107,2
Dengue,Shimla,Chandigarh,2020-04-01,4989,221,4768,104,6
Dengue,Shimla,Chandigarh,2020-05-01,4989,442,4547,73,6
Dengue,Shimla,Chandigarh,2020-06-01,2850,282,2568,115,1
Dengue,Shimla,Chandigarh,2020-07-01,893,39,854,200,1
Dengue,Shimla,Chandigarh,2020-08-01,3890,236,3654,60,6
Dengue,Shimla,Chandigarh,2020-09-01,2453,130,2323,138,10
Dengue,Shimla,Chandigarh,2020-10-01,2446,7,2439,123,6
Dengue,Shimla,Chandigarh,2020-11-01,3797,18,3779,181,1
Dengue,Shimla,Chandigarh,2020-12-01,3046,156,2890,191,1
Dengue,Shimla,Chandigarh,2021-01-01,1007,37,970,59,7
Dengue,Shimla,Chandigarh,2021-02-01,2162,227,1935,77,7
Dengue,Shimla,Chandigarh,2021-03-01,3484,150,3334,80,4
Dengue,Shimla,Chandigarh,2021-04-01,3282,350,2932,82,3
Dengue,Shimla,Chandigarh,2021-05-01,2949,106,2843,86,7
Dengue,Shimla,Chandigarh,2021-06-01,3850,407,3443,124,8
Dengue,Shimla,Chandigarh,2021-07-01,2112,136,1976,63,7
Dengue,Shimla,Chandigarh,2021-08-01,2837,188,2649,70,2
Dengue,Shimla,Chandigarh,2021-09-01,78,0,78,66,7
Dengue,Shimla,Chandigarh,2021-10-01,1994,133,1861,131,4
Dengue,Shimla,Chandigarh,2021-11-01,3622,359,3263,103,3
Dengue,Shimla,Chandigarh,2021-12-01,2074,95,1979,94,3
Dengue,Shimla,Chandigarh,2022-01-01,1972,79,1893,63,5
Dengue,Shimla,Chandigarh,2022-02-01,1200,51,1149,24,6
Dengue,Shimla,Chandigarh,2022-03-01,3943,383,3560,189,1
Dengue,Shimla,Chandigarh,2022-04-01,3333,249,3084,92,3
Dengue,Shimla,Chandigarh,2022-05-01,3705,341,3364,200,3
Dengue,Shimla,Chandigarh,2022-06-01,282,16,266,146,8
Dengue,Shimla,Chandigarh,2022-07-01,2382,121,2261,199,2
Dengue,Shimla,Chandigarh,2022-08-01,2222,138,2084,157,4
Dengue,Shimla,Chandigarh,2022-09-01,2221,180,2041,114,7
Dengue,Shimla,Chandigarh,2022-10-01,1771,75,1696,76,5
Dengue,Shimla,Chandigarh,2022-11-01,2133,191,1942,56,9
Dengue,Shimla,Chandigarh,2022-12-01,3737,226,3511,163,4
Dengue,Shimla,Chandigarh,2023-01-01,78,0,78,120,10
Dengue,Shimla,Chandigarh,2023-02-01,4982,377,4605,138,10
Dengue,Shimla,Chandigarh,2023-03-01,3246,42,3204,148,6
Dengue,Shimla,Chandigarh,2023-04-01,2541,190,2351,124,6
Dengue,Shimla,Chandigarh,2023-05-01,3814,291,3523,82,6
Dengue,Shimla,Chandigarh,2023-06-01,650,38,612,158,7
Dengue,Shimla,Chandigarh,2023-07-01,1706,112,1594,96,5
Dengue,Shimla,Chandigarh,2023-08-01,2435,199,2236,111,8
Dengue,Shimla,Chandigarh,2023-09-01,4429,157,4272,143,6
Dengue,Shimla,Chandigarh,2023-10-01,2535,185,2350,103,9
Dengue,Shimla,Chandigarh,2023-11-01,3201,268,2933,14,1
Dengue,Shimla,Chandigarh,2023-12-01,1806,182,1624,159,5
Dengue,Shimla,Chandigarh,2024-01-01,3251,58,3193,170,8
Dengue,Shimla,Chandigarh,2024-02-01,4847,300,4547,13,2
Dengue,Shimla,Chandigarh,2024-03-01,3933,86,3847,53,6
Dengue,Shimla,Chandigarh,2024-04-01,2488,51,2437,200,7
Dengue,Shimla,Chandigarh,2024-05-01,3504,212,3292,118,10
Dengue,Shimla,Chandigarh,2024-06-01,3372,176,3196,106,4
Dengue,Shimla,Chandigarh,2024-07-01,3277,273,3004,84,5
Dengue,Shimla,Chandigarh,2024-08-01,4089,163,3926,54,3
Dengue,Shimla,Chandigarh,2024-09-01,4079,188,3891,96,4
Dengue,Shimla,Chandigarh,2024-10-01,2427,136,2291,156,10
Dengue,Shimla,Chandigarh,2024-11-01,3458,86,3372,105,5
Dengue,Shimla,Chandigarh,2024-12-01,2083,60,2023,137,3
Dengue,Shimla,Chandigarh,2025-01-01,1359,112,1247,196,4
Dengue,Shimla,Chandigarh,2025-02-01,2236,76,2160,77,3
Dengue,Shimla,Chandigarh,2025-03-01,2495,210,2285,122,4
Dengue,Shimla,Chandigarh,2025-04-01,368,24,344,157,3
Dengue,Shimla,Chandigarh,2025-05-01,3752,18,3734,59,3
Dengue,Shimla,Chandigarh,2025-06-01,78,0,78,115,1
Dengue,Shimla,Chandigarh,2025-07-01,4989,325,4664,200,5
Dengue,Shimla,Chandigarh,2025-08-01,4612,287,4325,89,2
Dengue,Shimla,Chandigarh,2025-09-01,2247,103,2144,161,8
Dengue,Shimla,Chandigarh,2025-10-01,2610,59,2551,99,4
Dengue,Shimla,Chandigarh,2025-11-01,3004,268,2736,198,6
Dengue,Shimla,Chandigarh,2025-12-01,1807,85,1722,22,6
Dengue,Shimla,Himachal Pradesh,2018-01-01,2856,69,2787,110,1
Dengue,Shimla,Himachal Pradesh,2018-02-01,2404,152,2252,31,4
Dengue,Shimla,Himachal Pradesh,2018-03-01,2471,70,2401,71,10
Dengue,Shimla,Himachal Pradesh,2018-04-01,2841,63,2778,70,3
Dengue,Shimla,Himachal Pradesh,2018-05-01,835,32,803,93,10
Dengue,Shimla,Himachal Pradesh,2018-06-01,2650,81,2569,46,6
Dengue,Shimla,Himachal Pradesh,2018-07-01,2817,66,2751,103,6
Dengue,Shimla,Himachal Pradesh,2018-08-01,2770,203,2567,130,6
Dengue,Shimla,Himachal Pradesh,2018-09-01,2308,107,2201,28,8
Dengue,Shimla,Himachal Pradesh,2018-10-01,4124,356,3768,74,8
Dengue,Shimla,Himachal Pradesh,2018-11-01,2123,53,2070,200,5
Dengue,Shimla,Himachal Pradesh,2018-12-01,2902,0,2902,123,4
Dengue,Shimla,Himachal Pradesh,2019-01-01,4338,235,4103,14,1
Dengue,Shimla,Himachal Pradesh,2019-02-01,2491,259,2232,35,7
Dengue,Shimla,Himachal Pradesh,2019-03-01,2885,189,2696,118,5
Dengue,Shimla,Himachal Pradesh,2019-04-01,2468,354,2114,111,2
Dengue,Shimla,Himachal Pradesh,2019-05-01,4257,254,4003,76,3
Dengue,Shimla,Himachal Pradesh,2019-06-01,2252,128,2124,200,5
Dengue,Shimla,Himachal Pradesh,2019-07-01,4319,0,4319,200,2
Dengue,Shimla,Himachal Pradesh,2019-08-01,2458,153,2305,93,5
Dengue,Shimla,Himachal Pradesh,2019-09-01,1444,79,1365,151,1
Dengue,Shimla,Himachal Pradesh,2019-10-01,3509,134,3375,153,3
Dengue,Shimla,Himachal Pradesh,2019-11-01,2189,100,2089,160,1
Dengue,Shimla,Himachal Pradesh,2019-12-01,3430,164,3266,74,5
Dengue,Shimla,Himachal Pradesh,2020-01-01,78,0,78,200,2
Dengue,Shimla,Himachal Pradesh,2020-02-01,2604,288,2316,103,3
Dengue,Shimla,Himachal Pradesh,2020-03-01,1981,77,1904,128,10
Dengue,Shimla,Himachal Pradesh,2020-04-01,1171,64,1107,106,7
Dengue,Shimla,Himachal Pradesh,2020-05-01,1855,71,1784,99,7
Dengue,Shimla,Himachal Pradesh,2020-06-01,1828,133,1695,120,9
Dengue,Shimla,Himachal Pradesh,2020-07-01,2533,139,2394,46,6
Dengue,Shimla,Himachal Pradesh,2020-08-01,763,31,732,11,1
Dengue,Shimla,Himachal Pradesh,2020-09-01,3022,0,3022,95,1
Dengue,Shimla,Himachal Pradesh,2020-10-01,4430,253,4177,61,1
Dengue,Shimla,Himachal Pradesh,2020-11-01,2974,122,2852,134,5
Dengue,Shimla,Himachal Pradesh,2020-12-01,3683,177,3506,128,2
Dengue,Shimla,Himachal Pradesh,2021-01-01,4066,63,4003,107,3
Dengue,Shimla,Himachal Pradesh,2021-02-01,4256,390,3866,182,4
Dengue,Shimla,Himachal Pradesh,2021-03-01,4989,374,4615,106,3
Dengue,Shimla,Himachal Pradesh,2021-04-01,1928,176,1752,32,5
Dengue,Shimla,Himachal Pradesh,2021-05-01,1634,136,1498,95,4
Dengue,Shimla,Himachal Pradesh,2021-06-01,3648,245,3403,166,4
Dengue,Shimla,Himachal Pradesh,2021-07-01,3548,59,3489,11,1
Dengue,Shimla,Himachal Pradesh,2021-08-01,3638,377,3261,101,6
Dengue,Shimla,Himachal Pradesh,2021-09-01,4989,115,4874,136,10
Dengue,Shimla,Himachal Pradesh,2021-10-01,2613,110,2503,200,6
Dengue,Shimla,Himachal Pradesh,2021-11-01,3169,223,2946,168,10
Dengue,Shimla,Himachal Pradesh,2021-12-01,1282,92,1190,113,3
Dengue,Shimla,Himachal Pradesh,2022-01-01,4989,332,4657,133,4
Dengue,Shimla,Himachal Pradesh,2022-02-01,2146,82,2064,11,5
Dengue,Shimla,Himachal Pradesh,2022-03-01,2184,70,2114,53,4
Dengue,Shimla,Himachal Pradesh,2022-04-01,2132,264,1868,139,8
Dengue,Shimla,Himachal Pradesh,2022-05-01,1732,84,1648,114,1
Dengue,Shimla,Himachal Pradesh,2022-06-01,1619,73,1546,121,3
Dengue,Shimla,Himachal Pradesh,2022-07-01,1895,55,1840,108,10
Dengue,Shimla,Himachal Pradesh,2022-08-01,765,43,722,106,3
Dengue,Shimla,Himachal Pradesh,2022-09-01,1544,86,1458,111,8
Dengue,Shimla,Himachal Pradesh,2022-10-01,4989,247,4742,52,7
Dengue,Shimla,Himachal Pradesh,2022-11-01,3584,219,3365,95,5
Dengue,Shimla,Himachal Pradesh,2022-12-01,3840,389,3451,43,6
Dengue,Shimla,Himachal Pradesh,2023-01-01,4177,136,4041,75,5
Dengue,Shimla,Himachal Pradesh,2023-02-01,4989,256,4733,167,1
Dengue,Shimla,Himachal Pradesh,2023-03-01,221,6,215,97,6
Dengue,Shimla,Himachal Pradesh,2023-04-01,948,55,893,137,3
Dengue,Shimla,Himachal Pradesh,2023-05-01,1519,50,1469,112,1
Dengue,Shimla,Himachal Pradesh,2023-06-01,1967,68,1899,87,6
Dengue,Shimla,Himachal Pradesh,2023-07-01,2194,16,2178,55,6
Dengue,Shimla,Himachal Pradesh,2023-08-01,1998,105,1893,86,8
Dengue,Shimla,Himachal Pradesh,2023-09-01,2892,180,2712,116,4
Dengue,Shimla,Himachal Pradesh,2023-10-01,2645,275,2370,136,7
Dengue,Shimla,Himachal Pradesh,2023-11-01,1628,103,1525,112,5
Dengue,Shimla,Himachal Pradesh,2023-12-01,78,0,78,139,6
Dengue,Shimla,Himachal Pradesh,2024-01-01,1265,13,1252,29,6
Dengue,Shimla,Himachal Pradesh,2024-02-01,1861,27,1834,150,1
Dengue,Shimla,Himachal Pradesh,2024-03-01,2266,28,2238,49,6
Dengue,Shimla,Himachal Pradesh,2024-04-01,1082,113,969,156,5
Dengue,Shimla,Himachal Pradesh,2024-05-01,1939,113,1826,132,4
Dengue,Shimla,Himachal Pradesh,2024-06-01,1080,35,1045,11,5
Dengue,Shimla,Himachal Pradesh,2024-07-01,2429,53,2376,144,10
Dengue,Shimla,Himachal Pradesh,2024-08-01,1158,29,1129,157,1
Dengue,Shimla,Himachal Pradesh,2024-09-01,1459,47,1412,170,4
Dengue,Shimla,Himachal Pradesh,2024-10-01,842,74,768,67,7
Dengue,Shimla,Himachal Pradesh,2024-11-01,2391,117,2274,115,1
Dengue,Shimla,Himachal Pradesh,2024-12-01,1435,11,1424,142,6
Dengue,Shimla,Himachal Pradesh,2025-01-01,3814,442,3372,144,6
Dengue,Shimla,Himachal Pradesh,2025-02-01,3142,53,3089,127,1
Dengue,Shimla,Himachal Pradesh,2025-03-01,2504,82,2422,84,3
Dengue,Shimla,Himachal Pradesh,2025-04-01,1528,134,1394,157,10
Dengue,Shimla,Himachal Pradesh,2025-05-01,3108,193,2915,157,1
Dengue,Shimla,Himachal Pradesh,2025-06-01,3524,128,3396,98,4
Dengue,Shimla,Himachal Pradesh,2025-07-01,2789,39,2750,66,4
Dengue,Shimla,Himachal Pradesh,2025-08-01,4749,104,4645,69,5
Dengue,Shimla,Himachal Pradesh,2025-09-01,3214,76,3138,176,4
Dengue,Shimla,Himachal Pradesh,2025-10-01,3823,192,3631,155,5
Dengue,Shimla,Himachal Pradesh,2025-11-01,2777,154,2623,105,5
Dengue,Shimla,Himachal Pradesh,2025-12-01,3504,160,3344,96,7
Dengue,Shimla,Jammu & Kashmir,2018-01-01,1529,74,1455,16,7
Dengue,Shimla,Jammu & Kashmir,2018-02-01,1982,38,1944,102,6
Dengue,Shimla,Jammu & Kashmir,2018-03-01,3066,179,2887,46,6
Dengue,Shimla,Jammu & Kashmir,2018-04-01,3056,266,2790,114,1
Dengue,Shimla,Jammu & Kashmir,2018-05-01,3278,148,3130,167,5
Dengue,Shimla,Jammu & Kashmir,2018-06-01,4074,182,3892,56,8
Dengue,Shimla,Jammu & Kashmir,2018-07-01,686,36,650,118,1
Dengue,Shimla,Jammu & Kashmir,2018-08-01,1290,106,1184,157,1
Dengue,Shimla,Jammu & Kashmir,2018-09-01,2905,69,2836,117,9
Dengue,Shimla,Jammu & Kashmir,2018-10-01,1626,150,1476,80,1
Dengue,Shimla,Jammu & Kashmir,2018-11-01,4989,310,4679,107,5
Dengue,Shimla,Jammu & Kashmir,2018-12-01,3289,167,3122,155,3
Dengue,Shimla,Jammu & Kashmir,2019-01-01,2492,212,2280,120,9
Dengue,Shimla,Jammu & Kashmir,2019-02-01,1906,29,1877,106,6
Dengue,Shimla,Jammu & Kashmir,2019-03-01,1953,127,1826,165,7
Dengue,Shimla,Jammu & Kashmir,2019-04-01,2638,165,2473,132,5
Dengue,Shimla,Jammu & Kashmir,2019-05-01,2748,62,2686,45,10
Dengue,Shimla,Jammu & Kashmir,2019-06-01,1985,126,1859,138,3
Dengue,Shimla,Jammu & Kashmir,2019-07-01,2231,130,2101,155,6
Dengue,Shimla,Jammu & Kashmir,2019-08-01,4401,197,4204,43,8
Dengue,Shimla,Jammu & Kashmir,2019-09-01,4455,334,4121,11,9
Dengue,Shimla,Jammu & Kashmir,2019-10-01,2936,98,2838,53,4
Dengue,Shimla,Jammu & Kashmir,2019-11-01,798,46,752,101,1
Dengue,Shimla,Jammu & Kashmir,2019-12-01,3320,153,3167,158,4
Dengue,Shimla,Jammu & Kashmir,2020-01-01,4682,150,4532,61,10
Dengue,Shimla,Jammu & Kashmir,2020-02-01,4435,286,4149,134,3
Dengue,Shimla,Jammu & Kashmir,2020-03-01,3583,157,3426,11,6
Dengue,Shimla,Jammu & Kashmir,2020-04-01,4506,32,4474,115,4
Dengue,Shimla,Jammu & Kashmir,2020-05-01,2669,0,2669,85,5
Dengue,Shimla,Jammu & Kashmir,2020-06-01,3440,251,3189,200,9
Dengue,Shimla,Jammu & Kashmir,2020-07-01,1684,24,1660,11,6
Dengue,Shimla,Jammu & Kashmir,2020-08-01,2989,173,2816,105,10
Dengue,Shimla,Jammu & Kashmir,2020-09-01,4381,226,4155,11,8
Dengue,Shimla,Jammu & Kashmir,2020-10-01,1807,71,1736,78,5
Dengue,Shimla,Jammu & Kashmir,2020-11-01,1442,154,1288,20,5
Dengue,Shimla,Jammu & Kashmir,2020-12-01,2728,150,2578,200,6
Dengue,Shimla,Jammu & Kashmir,2021-01-01,2293,165,2128,88,1
Dengue,Shimla,Jammu & Kashmir,2021-02-01,3468,202,3266,95,2
Dengue,Shimla,Jammu & Kashmir,2021-03-01,1989,86,1903,104,7
Dengue,Shimla,Jammu & Kashmir,2021-04-01,4903,242,4661,49,7
Dengue,Shimla,Jammu & Kashmir,2021-05-01,867,80,787,160,1
Dengue,Shimla,Jammu & Kashmir,2021-06-01,4279,349,3930,139,7
Dengue,Shimla,Jammu & Kashmir,2021-07-01,1571,167,1404,153,4
Dengue,Shimla,Jammu & Kashmir,2021-08-01,188,10,178,44,2
Dengue,Shimla,Jammu & Kashmir,2021-09-01,2917,71,2846,164,4
Dengue,Shimla,Jammu & Kashmir,2021-10-01,2256,84,2172,158,7
Dengue,Shimla,Jammu & Kashmir,2021-11-01,1109,17,1092,94,7
Dengue,Shimla,Jammu & Kashmir,2021-12-01,342,24,318,152,6
Dengue,Shimla,Jammu & Kashmir,2022-01-01,2586,85,2501,120,6
Dengue,Shimla,Jammu & Kashmir,2022-02-01,3906,0,3906,25,2
Dengue,Shimla,Jammu & Kashmir,2022-03-01,3382,411,2971,97,6
Dengue,Shimla,Jammu & Kashmir,2022-04-01,2673,89,2584,82,3
Dengue,Shimla,Jammu & Kashmir,2022-05-01,3240,107,3133,111,10
Dengue,Shimla,Jammu & Kashmir,2022-06-01,2561,252,2309,158,4
Dengue,Shimla,Jammu & Kashmir,2022-07-01,679,10,669,23,10
Dengue,Shimla,Jammu & Kashmir,2022-08-01,691,57,634,84,4
Dengue,Shimla,Jammu & Kashmir,2022-09-01,2325,76,2249,64,5
Dengue,Shimla,Jammu & Kashmir,2022-10-01,2382,27,2355,67,4
Dengue,Shimla,Jammu & Kashmir,2022-11-01,3739,372,3367,64,1
Dengue,Shimla,Jammu & Kashmir,2022-12-01,3613,277,3336,110,9
Dengue,Shimla,Jammu & Kashmir,2023-01-01,3409,261,3148,133,5
Dengue,Shimla,Jammu & Kashmir,2023-02-01,2221,134,2087,124,7
Dengue,Shimla,Jammu & Kashmir,2023-03-01,745,50,695,116,10
Dengue,Shimla,Jammu & Kashmir,2023-04-01,3150,44,3106,138,4
Dengue,Shimla,Jammu & Kashmir,2023-05-01,3302,176,3126,200,5
Dengue,Shimla,Jammu & Kashmir,2023-06-01,78,0,78,113,5
Dengue,Shimla,Jammu & Kashmir,2023-07-01,1478,14,1464,158,1
Dengue,Shimla,Jammu & Kashmir,2023-08-01,1670,103,1567,155,1
Dengue,Shimla,Jammu & Kashmir,2023-09-01,2756,230,2526,197,1
Dengue,Shimla,Jammu & Kashmir,2023-10-01,1520,59,1461,135,8
Dengue,Shimla,Jammu & Kashmir,2023-11-01,2546,111,2435,63,4
Dengue,Shimla,Jammu & Kashmir,2023-12-01,2315,39,2276,122,7
Dengue,Shimla,Jammu & Kashmir,2024-01-01,2384,119,2265,119,4
Dengue,Shimla,Jammu & Kashmir,2024-02-01,1636,118,1518,148,1
Dengue,Shimla,Jammu & Kashmir,2024-03-01,1740,127,1613,62,7
Dengue,Shimla,Jammu & Kashmir,2024-04-01,1148,75,1073,171,2
Dengue,Shimla,Jammu & Kashmir,2024-05-01,3107,99,3008,106,7
Dengue,Shimla,Jammu & Kashmir,2024-06-01,3364,104,3260,149,8
Dengue,Shimla,Jammu & Kashmir,2024-07-01,1564,114,1450,122,5
Dengue,Shimla,Jammu & Kashmir,2024-08-01,4637,341,4296,112,6
Dengue,Shimla,Jammu & Kashmir,2024-09-01,2175,98,2077,118,1
Dengue,Shimla,Jammu & Kashmir,2024-10-01,4650,175,4475,140,10
Dengue,Shimla,Jammu & Kashmir,2024-11-01,1736,145,1591,200,6
Dengue,Shimla,Jammu & Kashmir,2024-12-01,78,0,78,11,7
Dengue,Shimla,Jammu & Kashmir,2025-01-01,3137,225,2912,134,8
Dengue,Shimla,Jammu & Kashmir,2025-02-01,2931,135,2796,108,4
Dengue,Shimla,Jammu & Kashmir,2025-03-01,2644,51,2593,97,5
Dengue,Shimla,Jammu & Kashmir,2025-04-01,1736,168,1568,11,8
Dengue,Shimla,Jammu & Kashmir,2025-05-01,2551,136,2415,136,4
Dengue,Shimla,Jammu & Kashmir,2025-06-01,1912,56,1856,100,6
Dengue,Shimla,Jammu & Kashmir,2025-07-01,2192,21,2171,64,6
Dengue,Shimla,Jammu & Kashmir,2025-08-01,3726,46,3680,108,3
Dengue,Shimla,Jammu & Kashmir,2025-09-01,2845,111,2734,91,6
Dengue,Shimla,Jammu & Kashmir,2025-10-01,3416,362,3054,17,1
Dengue,Shimla,Jammu & Kashmir,2025-11-01,2286,75,2211,111,7
Dengue,Shimla,Jammu & Kashmir,2025-12-01,2139,197,1942,136,9
Dengue,Shimla,Haryana,2018-01-01,1050,48,1002,78,7
Dengue,Shimla,Haryana,2018-02-01,2101,32,2069,120,9
Dengue,Shimla,Haryana,2018-03-01,78,0,78,112,3
Dengue,Shimla,Haryana,2018-04-01,1806,23,1783,159,4
Dengue,Shimla,Haryana,2018-05-01,2488,62,2426,101,5
Dengue,Shimla,Haryana,2018-06-01,3354,81,3273,147,5
Dengue,Shimla,Haryana,2018-07-01,2237,0,2237,90,4
Dengue,Shimla,Haryana,2018-08-01,3064,288,2776,200,2
Dengue,Shimla,Haryana,2018-09-01,78,0,78,84,10
Dengue,Shimla,Haryana,2018-10-01,2521,75,2446,71,2
Dengue,Shimla,Haryana,2018-11-01,344,19,325,101,10
Dengue,Shimla,Haryana,2018-12-01,976,25,951,69,6
Dengue,Shimla,Haryana,2019-01-01,2346,0,2346,43,5
Dengue,Shimla,Haryana,2019-02-01,4310,442,3868,143,6
Dengue,Shimla,Haryana,2019-03-01,3095,172,2923,11,9
Dengue,Shimla,Haryana,2019-04-01,2622,86,2536,70,1
Dengue,Shimla,Haryana,2019-05-01,2571,0,2571,38,6
Dengue,Shimla,Haryana,2019-06-01,1640,10,1630,113,5
Dengue,Shimla,Haryana,2019-07-01,1868,183,1685,11,5
Dengue,Shimla,Haryana,2019-08-01,3171,297,2874,134,8
Dengue,Shimla,Haryana,2019-09-01,739,53,686,140,3
Dengue,Shimla,Haryana,2019-10-01,3393,59,3334,23,1
Dengue,Shimla,Haryana,2019-11-01,2076,195,1881,116,1
Dengue,Shimla,Haryana,2019-12-01,3705,234,3471,133,2
Dengue,Shimla,Haryana,2020-01-01,3887,268,3619,154,7
Dengue,Shimla,Haryana,2020-02-01,353,22,331,31,6
Dengue,Shimla,Haryana,2020-03-01,1817,11,1806,24,7
Dengue,Shimla,Haryana,2020-04-01,1450,22,1428,183,3
Dengue,Shimla,Haryana,2020-05-01,166,5,161,64,4
Dengue,Shimla,Haryana,2020-06-01,1212,83,1129,79,10
Dengue,Shimla,Haryana,2020-07-01,4989,49,4940,138,8
Dengue,Shimla,Haryana,2020-08-01,3415,153,3262,47,7
Dengue,Shimla,Haryana,2020-09-01,4989,224,4765,93,1
Dengue,Shimla,Haryana,2020-10-01,3710,271,3439,152,10
Dengue,Shimla,Haryana,2020-11-01,1602,111,1491,34,5
Dengue,Shimla,Haryana,2020-12-01,2085,43,2042,81,5
Dengue,Shimla,Haryana,2021-01-01,3387,312,3075,49,6
Dengue,Shimla,Haryana,2021-02-01,3184,51,3133,67,5
Dengue,Shimla,Haryana,2021-03-01,1823,149,1674,167,4
Dengue,Shimla,Haryana,2021-04-01,572,19,553,178,5
Dengue,Shimla,Haryana,2021-05-01,4989,273,4716,119,7
Dengue,Shimla,Haryana,2021-06-01,2408,136,2272,133,7
Dengue,Shimla,Haryana,2021-07-01,2160,120,2040,132,8
Dengue,Shimla,Haryana,2021-08-01,2749,191,2558,72,2
Dengue,Shimla,Haryana,2021-09-01,2272,139,2133,118,3
Dengue,Shimla,Haryana,2021-10-01,2762,201,2561,40,7
Dengue,Shimla,Haryana,2021-11-01,4324,274,4050,57,1
Dengue,Shimla,Haryana,2021-12-01,2430,32,2398,102,5
Dengue,Shimla,Haryana,2022-01-01,1038,60,978,52,3
Dengue,Shimla,Haryana,2022-02-01,2381,80,2301,41,6
Dengue,Shimla,Haryana,2022-03-01,1974,35,1939,70,2
Dengue,Shimla,Haryana,2022-04-01,4508,187,4321,165,4
Dengue,Shimla,Haryana,2022-05-01,4168,230,3938,186,4
Dengue,Shimla,Haryana,2022-06-01,2742,157,2585,105,6
Dengue,Shimla,Haryana,2022-07-01,882,71,811,136,8
Dengue,Shimla,Haryana,2022-08-01,953,83,870,78,8
Dengue,Shimla,Haryana,2022-09-01,2618,156,2462,11,5
Dengue,Shimla,Haryana,2022-10-01,3049,198,2851,61,2
Dengue,Shimla,Haryana,2022-11-01,2095,110,1985,91,10
Dengue,Shimla,Haryana,2022-12-01,1953,141,1812,113,5
Dengue,Shimla,Haryana,2023-01-01,1802,115,1687,101,6
Dengue,Shimla,Haryana,2023-02-01,2566,124,2442,92,6
Dengue,Shimla,Haryana,2023-03-01,78,0,78,77,6
Dengue,Shimla,Haryana,2023-04-01,1120,38,1082,124,2
Dengue,Shimla,Haryana,2023-05-01,1756,162,1594,37,6
Dengue,Shimla,Haryana,2023-06-01,4217,44,4173,147,10
Dengue,Shimla,Haryana,2023-07-01,1506,111,1395,76,1
Dengue,Shimla,Haryana,2023-08-01,2840,260,2580,200,5
Dengue,Shimla,Haryana,2023-09-01,2901,0,2901,90,2
Dengue,Shimla,Haryana,2023-10-01,4339,234,4105,82,8
Dengue,Shimla,Haryana,2023-11-01,4291,304,3987,78,8
Dengue,Shimla,Haryana,2023-12-01,2520,144,2376,82,4
Dengue,Shimla,Haryana,2024-01-01,1960,119,1841,137,5
Dengue,Shimla,Haryana,2024-02-01,1707,92,1615,104,2
Dengue,Shimla,Haryana,2024-03-01,2274,41,2233,156,1
Dengue,Shimla,Haryana,2024-04-01,2015,239,1776,130,4
Dengue,Shimla,Haryana,2024-05-01,3340,118,3222,108,4
Dengue,Shimla,Haryana,2024-06-01,3161,198,2963,125,5
Dengue,Shimla,Haryana,2024-07-01,3391,105,3286,167,1
Dengue,Shimla,Haryana,2024-08-01,4287,0,4287,140,1
Dengue,Shimla,Haryana,2024-09-01,4989,115,4874,121,1
Dengue,Shimla,Haryana,2024-10-01,2765,21,2744,128,5
Dengue,Shimla,Haryana,2024-11-01,4072,333,3739,47,7
Dengue,Shimla,Haryana,2024-12-01,2126,68,2058,200,1
Dengue,Shimla,Haryana,2025-01-01,4187,147,4040,133,4
Dengue,Shimla,Haryana,2025-02-01,4021,76,3945,138,3
Dengue,Shimla,Haryana,2025-03-01,3950,208,3742,105,10
Dengue,Shimla,Haryana,2025-04-01,2724,79,2645,11,4
Dengue,Shimla,Haryana,2025-05-01,1701,134,1567,93,4
Dengue,Shimla,Haryana,2025-06-01,727,42,685,110,2
Dengue,Shimla,Haryana,2025-07-01,2544,85,2459,64,1
Dengue,Shimla,Haryana,2025-08-01,4654,348,4306,64,7
Dengue,Shimla,Haryana,2025-09-01,2182,109,2073,89,4
Dengue,Shimla,Haryana,2025-10-01,3651,185,3466,146,4
Dengue,Shimla,Haryana,2025-11-01,3730,27,3703,170,5
Dengue,Shimla,Haryana,2025-12-01,2217,106,2111,115,1
Dengue,Manali,Punjab,2018-01-01,4363,259,4104,77,10
Dengue,Manali,Punjab,2018-02-01,78,0,78,88,1
Dengue,Manali,Punjab,2018-03-01,957,26,931,111,10
Dengue,Manali,Punjab,2018-04-01,1369,159,1210,117,5
Dengue,Manali,Punjab,2018-05-01,1498,99,1399,128,4
Dengue,Manali,Punjab,2018-06-01,3049,17,3032,84,7
Dengue,Manali,Punjab,2018-07-01,2986,76,2910,133,4
Dengue,Manali,Punjab,2018-08-01,3126,285,2841,129,8
Dengue,Manali,Punjab,2018-09-01,3397,293,3104,86,6
Dengue,Manali,Punjab,2018-10-01,1323,66,1257,19,7
Dengue,Manali,Punjab,2018-11-01,963,52,911,61,8
Dengue,Manali,Punjab,2018-12-01,3129,50,3079,186,4
Dengue,Manali,Punjab,2019-01-01,1752,155,1597,20,8
Dengue,Manali,Punjab,2019-02-01,491,10,481,173,6
Dengue,Manali,Punjab,2019-03-01,3900,291,3609,18,9
Dengue,Manali,Punjab,2019-04-01,4469,399,4070,67,4
Dengue,Manali,Punjab,2019-05-01,4686,241,4445,87,9
Dengue,Manali,Punjab,2019-06-01,2848,222,2626,197,3
Dengue,Manali,Punjab,2019-07-01,3437,356,3081,108,1
Dengue,Manali,Punjab,2019-08-01,4435,256,4179,95,1
Dengue,Manali,Punjab,2019-09-01,1737,78,1659,59,4
Dengue,Manali,Punjab,2019-10-01,4087,196,3891,133,6
Dengue,Manali,Punjab,2019-11-01,2967,84,2883,80,5
Dengue,Manali,Punjab,2019-12-01,3823,106,3717,95,7
Dengue,Manali,Punjab,2020-01-01,2847,179,2668,88,1
Dengue,Manali,Punjab,2020-02-01,4336,196,4140,143,10
Dengue,Manali,Punjab,2020-03-01,2897,172,2725,145,9
Dengue,Manali,Punjab,2020-04-01,607,4,603,61,8
Dengue,Manali,Punjab,2020-05-01,4545,215,4330,74,8
Dengue,Manali,Punjab,2020-06-01,1326,106,1220,69,1
Dengue,Manali,Punjab,2020-07-01,4278,74,4204,116,7
Dengue,Manali,Punjab,2020-08-01,2476,125,2351,152,7
Dengue,Manali,Punjab,2020-09-01,4175,0,4175,116,8
Dengue,Manali,Punjab,2020-10-01,4120,49,4071,11,7
Dengue,Manali,Punjab,2020-11-01,3174,233,2941,145,6
Dengue,Manali,Punjab,2020-12-01,3280,134,3146,37,6
Dengue,Manali,Punjab,2021-01-01,3164,326,2838,70,8
Dengue,Manali,Punjab,2021-02-01,78,0,78,116,3
Dengue,Manali,Punjab,2021-03-01,2756,180,2576,102,6
Dengue,Manali,Punjab,2021-04-01,1100,20,1080,151,3
Dengue,Manali,Punjab,2021-05-01,2827,109,2718,75,4
Dengue,Manali,Punjab,2021-06-01,1064,30,1034,57,1
Dengue,Manali,Punjab,2021-07-01,1008,19,989,90,2
Dengue,Manali,Punjab,2021-08-01,4750,329,4421,156,4
Dengue,Manali,Punjab,2021-09-01,4032,303,3729,138,4
Dengue,Manali,Punjab,2021-10-01,2592,159,2433,111,4
Dengue,Manali,Punjab,2021-11-01,2845,73,2772,174,1
Dengue,Manali,Punjab,2021-12-01,2265,135,2130,165,4
Dengue,Manali,Punjab,2022-01-01,3362,0,3362,146,8
Dengue,Manali,Punjab,2022-02-01,1690,149,1541,46,4
Dengue,Manali,Punjab,2022-03-01,3931,48,3883,146,9
Dengue,Manali,Punjab,2022-04-01,2258,39,2219,96,8
Dengue,Manali,Punjab,2022-05-01,2034,108,1926,86,3
Dengue,Manali,Punjab,2022-06-01,2627,147,2480,71,6
Dengue,Manali,Punjab,2022-07-01,1804,86,1718,97,1
Dengue,Manali,Punjab,2022-08-01,3038,53,2985,74,2
Dengue,Manali,Punjab,2022-09-01,1877,155,1722,115,5
Dengue,Manali,Punjab,2022-10-01,3226,3,3223,97,6
Dengue,Manali,Punjab,2022-11-01,4229,29,4200,117,10
Dengue,Manali,Punjab,2022-12-01,1632,76,1556,134,4
Dengue,Manali,Punjab,2023-01-01,2422,32,2390,91,5
Dengue,Manali,Punjab,2023-02-01,3216,275,2941,69,5
Dengue,Manali,Punjab,2023-03-01,2013,31,1982,11,10
Dengue,Manali,Punjab,2023-04-01,3220,307,2913,145,9
Dengue,Manali,Punjab,2023-05-01,3342,268,3074,110,6
Dengue,Manali,Punjab,2023-06-01,4051,348,3703,97,7
Dengue,Manali,Punjab,2023-07-01,1784,187,1597,166,6
Dengue,Manali,Punjab,2023-08-01,1333,69,1264,41,8
Dengue,Manali,Punjab,2023-09-01,2185,44,2141,109,7
Dengue,Manali,Punjab,2023-10-01,1299,61,1238,57,4
Dengue,Manali,Punjab,2023-11-01,3355,112,3243,140,5
Dengue,Manali,Punjab,2023-12-01,1039,30,1009,11,5
Dengue,Manali,Punjab,2024-01-01,4989,271,4718,147,5
Dengue,Manali,Punjab,2024-02-01,4336,177,4159,145,3
Dengue,Manali,Punjab,2024-03-01,2614,73,2541,59,6
Dengue,Manali,Punjab,2024-04-01,3761,161,3600,110,3
Dengue,Manali,Punjab,2024-05-01,402,26,376,60,3
Dengue,Manali,Punjab,2024-06-01,4989,388,4601,128,4
Dengue,Manali,Punjab,2024-07-01,1806,6,1800,148,6
Dengue,Manali,Punjab,2024-08-01,2436,100,2336,55,8
Dengue,Manali,Punjab,2024-09-01,108,4,104,40,7
Dengue,Manali,Punjab,2024-10-01,3250,50,3200,162,8
Dengue,Manali,Punjab,2024-11-01,1113,51,1062,200,10
Dengue,Manali,Punjab,2024-12-01,2734,148,2586,131,3
Dengue,Manali,Punjab,2025-01-01,1867,121,1746,135,7
Dengue,Manali,Punjab,2025-02-01,1152,60,1092,89,7
Dengue,Manali,Punjab,2025-03-01,1518,37,1481,115,6
Dengue,Manali,Punjab,2025-04-01,2900,315,2585,124,7
Dengue,Manali,Punjab,2025-05-01,878,65,813,97,5
Dengue,Manali,Punjab,2025-06-01,1593,105,1488,175,7
Dengue,Manali,Punjab,2025-07-01,3487,276,3211,115,1
Dengue,Manali,Punjab,2025-08-01,4989,285,4704,122,5
Dengue,Manali,Punjab,2025-09-01,3238,283,2955,98,7
Dengue,Manali,Punjab,2025-10-01,1367,70,1297,103,8
Dengue,Manali,Punjab,2025-11-01,2105,105,2000,168,2
Dengue,Manali,Punjab,2025-12-01,2640,180,2460,114,5
Dengue,Manali,Chandigarh,2018-01-01,2129,204,1925,115,2
Dengue,Manali,Chandigarh,2018-02-01,3809,358,3451,115,4
Dengue,Manali,Chandigarh,2018-03-01,2889,194,2695,88,6
Dengue,Manali,Chandigarh,2018-04-01,3815,248,3567,34,8
Dengue,Manali,Chandigarh,2018-05-01,2176,153,2023,186,7
Dengue,Manali,Chandigarh,2018-06-01,4376,344,4032,161,5
Dengue,Manali,Chandigarh,2018-07-01,2374,208,2166,170,3
Dengue,Manali,Chandigarh,2018-08-01,1295,55,1240,52,4
Dengue,Manali,Chandigarh,2018-09-01,4989,441,4548,180,10
Dengue,Manali,Chandigarh,2018-10-01,149,8,141,200,1
Dengue,Manali,Chandigarh,2018-11-01,1606,110,1496,159,1
Dengue,Manali,Chandigarh,2018-12-01,1756,158,1598,190,5
Dengue,Manali,Chandigarh,2019-01-01,4989,358,4631,147,7
Dengue,Manali,Chandigarh,2019-02-01,4989,382,4607,63,7
Dengue,Manali,Chandigarh,2019-03-01,4602,178,4424,132,6
Dengue,Manali,Chandigarh,2019-04-01,2154,201,1953,54,1
Dengue,Manali,Chandigarh,2019-05-01,4989,350,4639,76,4
Dengue,Manali,Chandigarh,2019-06-01,3092,166,2926,122,1
Dengue,Manali,Chandigarh,2019-07-01,3908,320,3588,115,6
Dengue,Manali,Chandigarh,2019-08-01,2838,355,2483,130,6
Dengue,Manali,Chandigarh,2019-09-01,2531,40,2491,15,4
Dengue,Manali,Chandigarh,2019-10-01,2260,60,2200,98,1
Dengue,Manali,Chandigarh,2019-11-01,2316,296,2020,134,2
Dengue,Manali,Chandigarh,2019-12-01,3414,213,3201,144,1
Dengue,Manali,Chandigarh,2020-01-01,3090,171,2919,148,5
Dengue,Manali,Chandigarh,2020-02-01,2555,119,2436,119,10
Dengue,Manali,Chandigarh,2020-03-01,4622,393,4229,87,5
Dengue,Manali,Chandigarh,2020-04-01,78,0,78,132,4
Dengue,Manali,Chandigarh,2020-05-01,3281,100,3181,91,5
Dengue,Manali,Chandigarh,2020-06-01,3560,168,3392,152,1
Dengue,Manali,Chandigarh,2020-07-01,4136,164,3972,128,2
Dengue,Manali,Chandigarh,2020-08-01,2510,179,2331,103,3
Dengue,Manali,Chandigarh,2020-09-01,2876,246,2630,67,7
Dengue,Manali,Chandigarh,2020-10-01,3920,381,3539,163,6
Dengue,Manali,Chandigarh,2020-11-01,4598,332,4266,135,4
Dengue,Manali,Chandigarh,2020-12-01,2194,270,1924,200,7
Dengue,Manali,Chandigarh,2021-01-01,2956,98,2858,133,10
Dengue,Manali,Chandigarh,2021-02-01,4849,125,4724,137,7
Dengue,Manali,Chandigarh,2021-03-01,78,0,78,32,2
Dengue,Manali,Chandigarh,2021-04-01,1672,89,1583,122,1
Dengue,Manali,Chandigarh,2021-05-01,4564,45,4519,90,1
Dengue,Manali,Chandigarh,2021-06-01,4063,166,3897,148,7
Dengue,Manali,Chandigarh,2021-07-01,3298,189,3109,123,3
Dengue,Manali,Chandigarh,2021-08-01,1996,62,1934,156,7
Dengue,Manali,Chandigarh,2021-09-01,1414,29,1385,200,3
Dengue,Manali,Chandigarh,2021-10-01,1804,79,1725,66,6
Dengue,Manali,Chandigarh,2021-11-01,4674,89,4585,154,7
Dengue,Manali,Chandigarh,2021-12-01,1754,120,1634,141,3
Dengue,Manali,Chandigarh,2022-01-01,2733,0,2733,200,7
Dengue,Manali,Chandigarh,2022-02-01,1586,83,1503,142,3
Dengue,Manali,Chandigarh,2022-03-01,3728,243,3485,137,3
Dengue,Manali,Chandigarh,2022-04-01,1875,88,1787,150,7
Dengue,Manali,Chandigarh,2022-05-01,2466,201,2265,153,7
Dengue,Manali,Chandigarh,2022-06-01,339,3,336,180,6
Dengue,Manali,Chandigarh,2022-07-01,433,12,421,64,2
Dengue,Manali,Chandigarh,2022-08-01,2608,105,2503,86,4
Dengue,Manali,Chandigarh,2022-09-01,820,58,762,195,7
Dengue,Manali,Chandigarh,2022-10-01,4989,281,4708,11,10
Dengue,Manali,Chandigarh,2022-11-01,78,0,78,102,10
Dengue,Manali,Chandigarh,2022-12-01,1524,40,1484,114,3
Dengue,Manali,Chandigarh,2023-01-01,2620,24,2596,97,3
Dengue,Manali,Chandigarh,2023-02-01,2108,215,1893,187,10
Dengue,Manali,Chandigarh,2023-03-01,1116,9,1107,130,7
Dengue,Manali,Chandigarh,2023-04-01,1312,91,1221,86,3
Dengue,Manali,Chandigarh,2023-05-01,1268,27,1241,74,5
Dengue,Manali,Chandigarh,2023-06-01,2213,0,2213,121,1
Dengue,Manali,Chandigarh,2023-07-01,4989,195,4794,166,8
Dengue,Manali,Chandigarh,2023-08-01,2702,206,2496,113,9
Dengue,Manali,Chandigarh,2023-09-01,4184,60,4124,99,9
Dengue,Manali,Chandigarh,2023-10-01,3278,219,3059,71,8
Dengue,Manali,Chandigarh,2023-11-01,4092,295,3797,125,4
Dengue,Manali,Chandigarh,2023-12-01,78,0,78,122,7
Dengue,Manali,Chandigarh,2024-01-01,2189,95,2094,69,9
Dengue,Manali,Chandigarh,2024-02-01,4351,417,3934,159,8
Dengue,Manali,Chandigarh,2024-03-01,1830,126,1704,193,7
Dengue,Manali,Chandigarh,2024-04-01,4962,210,4752,109,5
Dengue,Manali,Chandigarh,2024-05-01,4588,285,4303,122,2
Dengue,Manali,Chandigarh,2024-06-01,1968,59,1909,50,10
Dengue,Manali,Chandigarh,2024-07-01,1922,158,1764,144,5
Dengue,Manali,Chandigarh,2024-08-01,1238,102,1136,130,8
Dengue,Manali,Chandigarh,2024-09-01,1753,93,1660,90,10
Dengue,Manali,Chandigarh,2024-10-01,944,53,891,68,7
Dengue,Manali,Chandigarh,2024-11-01,3173,66,3107,200,8
Dengue,Manali,Chandigarh,2024-12-01,644,6,638,126,2
Dengue,Manali,Chandigarh,2025-01-01,3407,133,3274,59,3
Dengue,Manali,Chandigarh,2025-02-01,3440,163,3277,150,8
Dengue,Manali,Chandigarh,2025-03-01,369,29,340,118,3
Dengue,Manali,Chandigarh,2025-04-01,4676,359,4317,109,1
Dengue,Manali,Chandigarh,2025-05-01,3286,182,3104,156,1
Dengue,Manali,Chandigarh,2025-06-01,3603,305,3298,11,4
Dengue,Manali,Chandigarh,2025-07-01,1580,35,1545,14,4
Dengue,Manali,Chandigarh,2025-08-01,3432,279,3153,176,8
Dengue,Manali,Chandigarh,2025-09-01,4108,111,3997,100,2
Dengue,Manali,Chandigarh,2025-10-01,2465,212,2253,84,9
Dengue,Manali,Chandigarh,2025-11-01,4989,247,4742,38,1
Dengue,Manali,Chandigarh,2025-12-01,2657,0,2657,116,1
Dengue,Manali,Himachal Pradesh,2018-01-01,4128,294,3834,122,5
Dengue,Manali,Himachal Pradesh,2018-02-01,2990,220,2770,180,5
Dengue,Manali,Himachal Pradesh,2018-03-01,3383,124,3259,125,7
Dengue,Manali,Himachal Pradesh,2018-04-01,355,13,342,91,1
Dengue,Manali,Himachal Pradesh,2018-05-01,3095,140,2955,127,6
Dengue,Manali,Himachal Pradesh,2018-06-01,1611,0,1611,163,1
Dengue,Manali,Himachal Pradesh,2018-07-01,1462,0,1462,152,1
Dengue,Manali,Himachal Pradesh,2018-08-01,4937,434,4503,138,10
Dengue,Manali,Himachal Pradesh,2018-09-01,2311,60,2251,120,8
Dengue,Manali,Himachal Pradesh,2018-10-01,1251,130,1121,77,5
Dengue,Manali,Himachal Pradesh,2018-11-01,2116,190,1926,54,1
Dengue,Manali,Himachal Pradesh,2018-12-01,853,81,772,46,3
Dengue,Manali,Himachal Pradesh,2019-01-01,4521,140,4381,126,6
Dengue,Manali,Himachal Pradesh,2019-02-01,1664,5,1659,132,3
Dengue,Manali,Himachal Pradesh,2019-03-01,3307,60,3247,162,9
Dengue,Manali,Himachal Pradesh,2019-04-01,4417,163,4254,135,7
Dengue,Manali,Himachal Pradesh,2019-05-01,1926,0,1926,160,2
Dengue,Manali,Himachal Pradesh,2019-06-01,3311,119,3192,100,1
Dengue,Manali,Himachal Pradesh,2019-07-01,1216,53,1163,145,7
Dengue,Manali,Himachal Pradesh,2019-08-01,4989,61,4928,55,7
Dengue,Manali,Himachal Pradesh,2019-09-01,3854,76,3778,103,7
Dengue,Manali,Himachal Pradesh,2019-10-01,2339,102,2237,13,10
Dengue,Manali,Himachal Pradesh,2019-11-01,1561,94,1467,108,6
Dengue,Manali,Himachal Pradesh,2019-12-01,2444,59,2385,169,5
Dengue,Manali,Himachal Pradesh,2020-01-01,2141,125,2016,110,7
Dengue,Manali,Himachal Pradesh,2020-02-01,4989,269,4720,143,8
Dengue,Manali,Himachal Pradesh,2020-03-01,953,49,904,120,7
Dengue,Manali,Himachal Pradesh,2020-04-01,2778,86,2692,77,5
Dengue,Manali,Himachal Pradesh,2020-05-01,2573,28,2545,97,8
Dengue,Manali,Himachal Pradesh,2020-06-01,2440,242,2198,166,5
Dengue,Manali,Himachal Pradesh,2020-07-01,2452,167,2285,143,3
Dengue,Manali,Himachal Pradesh,2020-08-01,2442,193,2249,75,5
Dengue,Manali,Himachal Pradesh,2020-09-01,3769,179,3590,36,4
Dengue,Manali,Himachal Pradesh,2020-10-01,3414,154,3260,117,5
Dengue,Manali,Himachal Pradesh,2020-11-01,3159,203,2956,77,2
Dengue,Manali,Himachal Pradesh,2020-12-01,78,0,78,97,8
Dengue,Manali,Himachal Pradesh,2021-01-01,3000,52,2948,32,5
Dengue,Manali,Himachal Pradesh,2021-02-01,376,10,366,159,7
Dengue,Manali,Himachal Pradesh,2021-03-01,3464,127,3337,101,6
Dengue,Manali,Himachal Pradesh,2021-04-01,4575,111,4464,109,2
Dengue,Manali,Himachal Pradesh,2021-05-01,1355,80,1275,64,9
Dengue,Manali,Himachal Pradesh,2021-06-01,2246,117,2129,92,4
Dengue,Manali,Himachal Pradesh,2021-07-01,1793,162,1631,112,4
Dengue,Manali,Himachal Pradesh,2021-08-01,4255,442,3813,75,5
Dengue,Manali,Himachal Pradesh,2021-09-01,2725,36,2689,95,5
Dengue,Manali,Himachal Pradesh,2021-10-01,4916,267,4649,177,10
Dengue,Manali,Himachal Pradesh,2021-11-01,3152,171,2981,17,7
Dengue,Manali,Himachal Pradesh,2021-12-01,2923,145,2778,116,3
Dengue,Manali,Himachal Pradesh,2022-01-01,2689,49,2640,66,10
Dengue,Manali,Himachal Pradesh,2022-02-01,3695,86,3609,174,1
Dengue,Manali,Himachal Pradesh,2022-03-01,266,15,251,97,3
Dengue,Manali,Himachal Pradesh,2022-04-01,2712,61,2651,53,3
Dengue,Manali,Himachal Pradesh,2022-05-01,2503,136,2367,95,5
Dengue,Manali,Himachal Pradesh,2022-06-01,3571,153,3418,124,6
Dengue,Manali,Himachal Pradesh,2022-07-01,2346,127,2219,200,6
Dengue,Manali,Himachal Pradesh,2022-08-01,1204,26,1178,11,6
Dengue,Manali,Himachal Pradesh,2022-09-01,2607,142,2465,45,7
Dengue,Manali,Himachal Pradesh,2022-10-01,1145,27,1118,173,5
Dengue,Manali,Himachal Pradesh,2022-11-01,78,0,78,29,9
Dengue,Manali,Himachal Pradesh,2022-12-01,3573,318,3255,107,1
Dengue,Manali,Himachal Pradesh,2023-01-01,3374,194,3180,82,1
Dengue,Manali,Himachal Pradesh,2023-02-01,3224,191,3033,74,7
Dengue,Manali,Himachal Pradesh,2023-03-01,4345,320,4025,97,4
Dengue,Manali,Himachal Pradesh,2023-04-01,1705,15,1690,89,10
Dengue,Manali,Himachal Pradesh,2023-05-01,678,67,611,160,8
Dengue,Manali,Himachal Pradesh,2023-06-01,2503,48,2455,174,7
Dengue,Manali,Himachal Pradesh,2023-07-01,2131,161,1970,128,3
Dengue,Manali,Himachal Pradesh,2023-08-01,1467,105,1362,94,7
Dengue,Manali,Himachal Pradesh,2023-09-01,2490,59,2431,119,4
Dengue,Manali,Himachal Pradesh,2023-10-01,1777,141,1636,147,5
Dengue,Manali,Himachal Pradesh,2023-11-01,134,8,126,157,4
Dengue,Manali,Himachal Pradesh,2023-12-01,2006,210,1796,125,6
Dengue,Manali,Himachal Pradesh,2024-01-01,1073,59,1014,184,4
Dengue,Manali,Himachal Pradesh,2024-02-01,2908,136,2772,75,8
Dengue,Manali,Himachal Pradesh,2024-03-01,1717,60,1657,164,6
Dengue,Manali,Himachal Pradesh,2024-04-01,4089,0,4089,142,3
Dengue,Manali,Himachal Pradesh,2024-05-01,4749,193,4556,75,4
Dengue,Manali,Himachal Pradesh,2024-06-01,3509,147,3362,118,1
Dengue,Manali,Himachal Pradesh,2024-07-01,517,29,488,122,1
Dengue,Manali,Himachal Pradesh,2024-08-01,4617,39,4578,99,8
Dengue,Manali,Himachal Pradesh,2024-09-01,4711,203,4508,98,4
Dengue,Manali,Himachal Pradesh,2024-10-01,2623,175,2448,29,1
Dengue,Manali,Himachal Pradesh,2024-11-01,4372,304,4068,71,6
Dengue,Manali,Himachal Pradesh,2024-12-01,1857,0,1857,94,3
Dengue,Manali,Himachal Pradesh,2025-01-01,94,6,88,77,5
Dengue,Manali,Himachal Pradesh,2025-02-01,1577,67,1510,63,1
Dengue,Manali,Himachal Pradesh,2025-03-01,4917,219,4698,160,7
Dengue,Manali,Himachal Pradesh,2025-04-01,597,0,597,101,5
Dengue,Manali,Himachal Pradesh,2025-05-01,2597,242,2355,200,6
Dengue,Manali,Himachal Pradesh,2025-06-01,2643,145,2498,118,4
Dengue,Manali,Himachal Pradesh,2025-07-01,1909,10,1899,159,6
Dengue,Manali,Himachal Pradesh,2025-08-01,2002,122,1880,96,1
Dengue,Manali,Himachal Pradesh,2025-09-01,2694,161,2533,73,10
Dengue,Manali,Himachal Pradesh,2025-10-01,1843,157,1686,120,6
Dengue,Manali,Himachal Pradesh,2025-11-01,690,28,662,172,10
Dengue,Manali,Himachal Pradesh,2025-12-01,2886,145,2741,102,4
Dengue,Manali,Jammu & Kashmir,2018-01-01,4037,126,3911,129,2
Dengue,Manali,Jammu & Kashmir,2018-02-01,3764,253,3511,119,3
Dengue,Manali,Jammu & Kashmir,2018-03-01,1511,41,1470,101,5
Dengue,Manali,Jammu & Kashmir,2018-04-01,919,22,897,104,4
Dengue,Manali,Jammu & Kashmir,2018-05-01,2216,106,2110,55,10
Dengue,Manali,Jammu & Kashmir,2018-06-01,4701,67,4634,106,2
Dengue,Manali,Jammu & Kashmir,2018-07-01,3463,334,3129,139,3
Dengue,Manali,Jammu & Kashmir,2018-08-01,3542,376,3166,121,7
Dengue,Manali,Jammu & Kashmir,2018-09-01,3791,139,3652,116,1
Dengue,Manali,Jammu & Kashmir,2018-10-01,3162,30,3132,143,5
Dengue,Manali,Jammu & Kashmir,2018-11-01,2759,165,2594,116,5
Dengue,Manali,Jammu & Kashmir,2018-12-01,3486,125,3361,107,6
Dengue,Manali,Jammu & Kashmir,2019-01-01,1865,157,1708,144,6
Dengue,Manali,Jammu & Kashmir,2019-02-01,700,19,681,113,10
Dengue,Manali,Jammu & Kashmir,2019-03-01,3567,235,3332,94,2
Dengue,Manali,Jammu & Kashmir,2019-04-01,4258,227,4031,130,3
Dengue,Manali,Jammu & Kashmir,2019-05-01,1097,33,1064,104,7
Dengue,Manali,Jammu & Kashmir,2019-06-01,3700,211,3489,92,5
Dengue,Manali,Jammu & Kashmir,2019-07-01,4852,367,4485,114,6
Dengue,Manali,Jammu & Kashmir,2019-08-01,2594,136,2458,115,1
Dengue,Manali,Jammu & Kashmir,2019-09-01,1500,79,1421,50,10
Dengue,Manali,Jammu & Kashmir,2019-10-01,2762,68,2694,123,6
Dengue,Manali,Jammu & Kashmir,2019-11-01,1859,154,1705,200,1
Dengue,Manali,Jammu & Kashmir,2019-12-01,1770,142,1628,56,7
Dengue,Manali,Jammu & Kashmir,2020-01-01,3179,121,3058,81,2
Dengue,Manali,Jammu & Kashmir,2020-02-01,446,20,426,200,8
Dengue,Manali,Jammu & Kashmir,2020-03-01,660,60,600,64,1
Dengue,Manali,Jammu & Kashmir,2020-04-01,2623,44,2579,172,8
Dengue,Manali,Jammu & Kashmir,2020-05-01,2567,173,2394,95,1
Dengue,Manali,Jammu & Kashmir,2020-06-01,3058,103,2955,109,2
Dengue,Manali,Jammu & Kashmir,2020-07-01,4989,442,4547,100,5
Dengue,Manali,Jammu & Kashmir,2020-08-01,2738,142,2596,128,3
Dengue,Manali,Jammu & Kashmir,2020-09-01,3400,294,3106,26,3
Dengue,Manali,Jammu & Kashmir,2020-10-01,1289,35,1254,116,1
Dengue,Manali,Jammu & Kashmir,2020-11-01,3628,49,3579,86,4
Dengue,Manali,Jammu & Kashmir,2020-12-01,1891,81,1810,11,7
Dengue,Manali,Jammu & Kashmir,2021-01-01,2693,155,2538,163,10
Dengue,Manali,Jammu & Kashmir,2021-02-01,2451,86,2365,11,7
Dengue,Manali,Jammu & Kashmir,2021-03-01,3983,287,3696,200,7
Dengue,Manali,Jammu & Kashmir,2021-04-01,840,36,804,138,1
Dengue,Manali,Jammu & Kashmir,2021-05-01,78,0,78,37,5
Dengue,Manali,Jammu & Kashmir,2021-06-01,2311,152,2159,174,3
Dengue,Manali,Jammu & Kashmir,2021-07-01,3226,78,3148,68,1
Dengue,Manali,Jammu & Kashmir,2021-08-01,2802,110,2692,70,1
Dengue,Manali,Jammu & Kashmir,2021-09-01,4250,404,3846,14,7
Dengue,Manali,Jammu & Kashmir,2021-10-01,3184,323,2861,62,3
Dengue,Manali,Jammu & Kashmir,2021-11-01,1841,61,1780,68,1
Dengue,Manali,Jammu & Kashmir,2021-12-01,78,0,78,148,3
Dengue,Manali,Jammu & Kashmir,2022-01-01,2279,77,2202,166,6
Dengue,Manali,Jammu & Kashmir,2022-02-01,3976,165,3811,43,3
Dengue,Manali,Jammu & Kashmir,2022-03-01,2071,67,2004,120,1
Dengue,Manali,Jammu & Kashmir,2022-04-01,2635,0,2635,12,2
Dengue,Manali,Jammu & Kashmir,2022-05-01,3163,167,2996,120,7
Dengue,Manali,Jammu & Kashmir,2022-06-01,1235,72,1163,200,1
Dengue,Manali,Jammu & Kashmir,2022-07-01,3433,104,3329,16,4
Dengue,Manali,Jammu & Kashmir,2022-08-01,4794,391,4403,55,4
Dengue,Manali,Jammu & Kashmir,2022-09-01,2366,88,2278,143,3
Dengue,Manali,Jammu & Kashmir,2022-10-01,1083,34,1049,149,2
Dengue,Manali,Jammu & Kashmir,2022-11-01,2508,164,2344,58,8
Dengue,Manali,Jammu & Kashmir,2022-12-01,78,0,78,181,8
Dengue,Manali,Jammu & Kashmir,2023-01-01,3049,233,2816,65,5
Dengue,Manali,Jammu & Kashmir,2023-02-01,3204,122,3082,191,3
Dengue,Manali,Jammu & Kashmir,2023-03-01,4845,382,4463,130,5
Dengue,Manali,Jammu & Kashmir,2023-04-01,2337,204,2133,171,6
Dengue,Manali,Jammu & Kashmir,2023-05-01,3145,216,2929,125,4
Dengue,Manali,Jammu & Kashmir,2023-06-01,1442,38,1404,140,6
Dengue,Manali,Jammu & Kashmir,2023-07-01,2119,28,2091,142,4
Dengue,Manali,Jammu & Kashmir,2023-08-01,551,4,547,165,1
Dengue,Manali,Jammu & Kashmir,2023-09-01,2336,191,2145,105,4
Dengue,Manali,Jammu & Kashmir,2023-10-01,2188,100,2088,60,7
Dengue,Manali,Jammu & Kashmir,2023-11-01,2999,97,2902,102,5
Dengue,Manali,Jammu & Kashmir,2023-12-01,1761,81,1680,72,6
Dengue,Manali,Jammu & Kashmir,2024-01-01,2709,220,2489,76,4
Dengue,Manali,Jammu & Kashmir,2024-02-01,2150,156,1994,191,4
Dengue,Manali,Jammu & Kashmir,2024-03-01,2153,135,2018,138,5
Dengue,Manali,Jammu & Kashmir,2024-04-01,2705,185,2520,136,10
Dengue,Manali,Jammu & Kashmir,2024-05-01,2652,146,2506,161,7
Dengue,Manali,Jammu & Kashmir,2024-06-01,3619,213,3406,138,7
Dengue,Manali,Jammu & Kashmir,2024-07-01,2436,137,2299,200,5
Dengue,Manali,Jammu & Kashmir,2024-08-01,2128,106,2022,11,1
Dengue,Manali,Jammu & Kashmir,2024-09-01,2355,169,2186,55,8
Dengue,Manali,Jammu & Kashmir,2024-10-01,1639,99,1540,71,7
Dengue,Manali,Jammu & Kashmir,2024-11-01,2115,51,2064,36,6
Dengue,Manali,Jammu & Kashmir,2024-12-01,4989,326,4663,112,5
Dengue,Manali,Jammu & Kashmir,2025-01-01,1373,78,1295,114,6
Dengue,Manali,Jammu & Kashmir,2025-02-01,2224,150,2074,200,4
Dengue,Manali,Jammu & Kashmir,2025-03-01,2078,97,1981,152,7
Dengue,Manali,Jammu & Kashmir,2025-04-01,2266,166,2100,80,2
Dengue,Manali,Jammu & Kashmir,2025-05-01,2153,103,2050,131,1
Dengue,Manali,Jammu & Kashmir,2025-06-01,2972,211,2761,13,1
Dengue,Manali,Jammu & Kashmir,2025-07-01,303,11,292,113,5
Dengue,Manali,Jammu & Kashmir,2025-08-01,3989,154,3835,111,4
Dengue,Manali,Jammu & Kashmir,2025-09-01,3446,232,3214,60,4
Dengue,Manali,Jammu & Kashmir,2025-10-01,930,37,893,96,1
Dengue,Manali,Jammu & Kashmir,2025-11-01,78,0,78,71,6
Dengue,Manali,Jammu & Kashmir,2025-12-01,1287,85,1202,59,2
Dengue,Manali,Haryana,2018-01-01,2272,115,2157,141,6
Dengue,Manali,Haryana,2018-02-01,4989,368,4621,159,1
Dengue,Manali,Haryana,2018-03-01,3326,120,3206,132,2
Dengue,Manali,Haryana,2018-04-01,173,13,160,84,2
Dengue,Manali,Haryana,2018-05-01,1672,127,1545,72,6
Dengue,Manali,Haryana,2018-06-01,2526,218,2308,85,3
Dengue,Manali,Haryana,2018-07-01,2938,109,2829,95,6
Dengue,Manali,Haryana,2018-08-01,834,12,822,62,8
Dengue,Manali,Haryana,2018-09-01,2416,78,2338,160,10
Dengue,Manali,Haryana,2018-10-01,1635,68,1567,96,5
Dengue,Manali,Haryana,2018-11-01,1117,110,1007,145,2
Dengue,Manali,Haryana,2018-12-01,2946,335,2611,35,8
Dengue,Manali,Haryana,2019-01-01,3636,218,3418,71,9
Dengue,Manali,Haryana,2019-02-01,3726,187,3539,150,5
Dengue,Manali,Haryana,2019-03-01,3368,134,3234,151,9
Dengue,Manali,Haryana,2019-04-01,1930,142,1788,45,6
Dengue,Manali,Haryana,2019-05-01,3556,404,3152,122,1
Dengue,Manali,Haryana,2019-06-01,3012,307,2705,123,3
Dengue,Manali,Haryana,2019-07-01,2777,231,2546,70,3
Dengue,Manali,Haryana,2019-08-01,1777,147,1630,124,4
Dengue,Manali,Haryana,2019-09-01,1931,143,1788,26,2
Dengue,Manali,Haryana,2019-10-01,2697,131,2566,59,2
Dengue,Manali,Haryana,2019-11-01,4989,142,4847,137,9
Dengue,Manali,Haryana,2019-12-01,3002,148,2854,108,1
Dengue,Manali,Haryana,2020-01-01,1777,110,1667,110,3
Dengue,Manali,Haryana,2020-02-01,1481,11,1470,97,7
Dengue,Manali,Haryana,2020-03-01,1938,88,1850,134,3
Dengue,Manali,Haryana,2020-04-01,4989,129,4860,136,6
Dengue,Manali,Haryana,2020-05-01,2062,164,1898,147,4
Dengue,Manali,Haryana,2020-06-01,3814,129,3685,113,6
Dengue,Manali,Haryana,2020-07-01,2093,124,1969,86,2
Dengue,Manali,Haryana,2020-08-01,2948,87,2861,78,1
Dengue,Manali,Haryana,2020-09-01,3660,353,3307,52,4
Dengue,Manali,Haryana,2020-10-01,1830,1,1829,86,1
Dengue,Manali,Haryana,2020-11-01,1737,111,1626,75,5
Dengue,Manali,Haryana,2020-12-01,4823,62,4761,188,2
Dengue,Manali,Haryana,2021-01-01,3918,138,3780,53,2
Dengue,Manali,Haryana,2021-02-01,3658,205,3453,159,9
Dengue,Manali,Haryana,2021-03-01,3654,210,3444,93,6
Dengue,Manali,Haryana,2021-04-01,3214,182,3032,96,1
Dengue,Manali,Haryana,2021-05-01,4989,271,4718,127,5
Dengue,Manali,Haryana,2021-06-01,2656,83,2573,34,4
Dengue,Manali,Haryana,2021-07-01,3372,152,3220,65,1
Dengue,Manali,Haryana,2021-08-01,651,33,618,43,6
Dengue,Manali,Haryana,2021-09-01,1491,83,1408,87,8
Dengue,Manali,Haryana,2021-10-01,986,47,939,60,4
Dengue,Manali,Haryana,2021-11-01,4307,307,4000,173,4
Dengue,Manali,Haryana,2021-12-01,78,0,78,76,3
Dengue,Manali,Haryana,2022-01-01,2058,115,1943,11,6
Dengue,Manali,Haryana,2022-02-01,78,0,78,89,4
Dengue,Manali,Haryana,2022-03-01,1482,28,1454,147,4
Dengue,Manali,Haryana,2022-04-01,1939,105,1834,189,2
Dengue,Manali,Haryana,2022-05-01,4455,379,4076,95,10
Dengue,Manali,Haryana,2022-06-01,3129,197,2932,80,4
Dengue,Manali,Haryana,2022-07-01,1480,38,1442,105,7
Dengue,Manali,Haryana,2022-08-01,4027,297,3730,127,6
Dengue,Manali,Haryana,2022-09-01,2621,105,2516,49,1
Dengue,Manali,Haryana,2022-10-01,2648,187,2461,94,4
Dengue,Manali,Haryana,2022-11-01,984,38,946,104,1
Dengue,Manali,Haryana,2022-12-01,1269,76,1193,109,8
Dengue,Manali,Haryana,2023-01-01,1491,52,1439,99,1
Dengue,Manali,Haryana,2023-02-01,2660,95,2565,59,6
Dengue,Manali,Haryana,2023-03-01,2702,12,2690,123,8
Dengue,Manali,Haryana,2023-04-01,4669,303,4366,104,6
Dengue,Manali,Haryana,2023-05-01,3114,189,2925,104,5
Dengue,Manali,Haryana,2023-06-01,78,0,78,51,4
Dengue,Manali,Haryana,2023-07-01,2950,171,2779,139,4
Dengue,Manali,Haryana,2023-08-01,652,18,634,58,1
Dengue,Manali,Haryana,2023-09-01,1302,101,1201,189,5
Dengue,Manali,Haryana,2023-10-01,1508,119,1389,46,8
Dengue,Manali,Haryana,2023-11-01,1708,46,1662,145,2
Dengue,Manali,Haryana,2023-12-01,753,49,704,11,5
Dengue,Manali,Haryana,2024-01-01,2870,216,2654,11,5
Dengue,Manali,Haryana,2024-02-01,705,25,680,78,6
Dengue,Manali,Haryana,2024-03-01,3076,127,2949,11,3
Dengue,Manali,Haryana,2024-04-01,4989,327,4662,143,1
Dengue,Manali,Haryana,2024-05-01,814,4,810,105,2
Dengue,Manali,Haryana,2024-06-01,2216,40,2176,178,1
Dengue,Manali,Haryana,2024-07-01,78,0,78,98,7
Dengue,Manali,Haryana,2024-08-01,2194,0,2194,119,6
Dengue,Manali,Haryana,2024-09-01,3460,282,3178,93,5
Dengue,Manali,Haryana,2024-10-01,3564,0,3564,62,3
Dengue,Manali,Haryana,2024-11-01,2701,162,2539,85,4
Dengue,Manali,Haryana,2024-12-01,3790,279,3511,45,5
Dengue,Manali,Haryana,2025-01-01,4989,207,4782,126,3
Dengue,Manali,Haryana,2025-02-01,4894,149,4745,91,3
Dengue,Manali,Haryana,2025-03-01,1896,107,1789,101,9
Dengue,Manali,Haryana,2025-04-01,651,32,619,200,1
Dengue,Manali,Haryana,2025-05-01,2053,162,1891,86,8
Dengue,Manali,Haryana,2025-06-01,1327,0,1327,122,1
Dengue,Manali,Haryana,2025-07-01,3203,74,3129,103,9
Dengue,Manali,Haryana,2025-08-01,1013,67,946,165,1
Dengue,Manali,Haryana,2025-09-01,2500,128,2372,118,6
Dengue,Manali,Haryana,2025-10-01,3722,267,3455,92,3
Dengue,Manali,Haryana,2025-11-01,2462,142,2320,200,4
Dengue,Manali,Haryana,2025-12-01,1328,61,1267,62,4
Dengue,Jammu,Punjab,2018-01-01,4173,172,4001,96,7
Dengue,Jammu,Punjab,2018-02-01,78,0,78,153,1
Dengue,Jammu,Punjab,2018-03-01,2158,204,1954,65,5
Dengue,Jammu,Punjab,2018-04-01,2542,163,2379,145,5
Dengue,Jammu,Punjab,2018-05-01,2619,137,2482,82,3
Dengue,Jammu,Punjab,2018-06-01,2840,186,2654,157,4
Dengue,Jammu,Punjab,2018-07-01,3416,253,3163,156,3
Dengue,Jammu,Punjab,2018-08-01,2550,158,2392,102,6
Dengue,Jammu,Punjab,2018-09-01,2104,59,2045,55,6
Dengue,Jammu,Punjab,2018-10-01,2051,209,1842,86,5
Dengue,Jammu,Punjab,2018-11-01,1777,101,1676,105,7
Dengue,Jammu,Punjab,2018-12-01,3654,397,3257,151,8
Dengue,Jammu,Punjab,2019-01-01,1730,96,1634,123,2
Dengue,Jammu,Punjab,2019-02-01,3733,160,3573,134,10
Dengue,Jammu,Punjab,2019-03-01,2623,237,2386,124,6
Dengue,Jammu,Punjab,2019-04-01,1898,111,1787,149,3
Dengue,Jammu,Punjab,2019-05-01,3427,184,3243,96,10
Dengue,Jammu,Punjab,2019-06-01,1622,24,1598,115,4
Dengue,Jammu,Punjab,2019-07-01,3454,239,3215,108,1
Dengue,Jammu,Punjab,2019-08-01,2883,102,2781,84,3
Dengue,Jammu,Punjab,2019-09-01,1797,66,1731,158,3
Dengue,Jammu,Punjab,2019-10-01,3307,118,3189,157,8
Dengue,Jammu,Punjab,2019-11-01,3331,209,3122,168,4
Dengue,Jammu,Punjab,2019-12-01,4150,22,4128,67,5
Dengue,Jammu,Punjab,2020-01-01,3893,171,3722,124,5
Dengue,Jammu,Punjab,2020-02-01,3256,255,3001,162,8
Dengue,Jammu,Punjab,2020-03-01,1085,14,1071,183,4
Dengue,Jammu,Punjab,2020-04-01,4989,274,4715,29,4
Dengue,Jammu,Punjab,2020-05-01,714,22,692,106,3
Dengue,Jammu,Punjab,2020-06-01,3871,148,3723,97,4
Dengue,Jammu,Punjab,2020-07-01,3176,312,2864,187,6
Dengue,Jammu,Punjab,2020-08-01,1022,2,1020,11,7
Dengue,Jammu,Punjab,2020-09-01,2431,175,2256,53,10
Dengue,Jammu,Punjab,2020-10-01,2492,90,2402,179,5
Dengue,Jammu,Punjab,2020-11-01,4349,150,4199,82,4
Dengue,Jammu,Punjab,2020-12-01,1640,29,1611,40,6
Dengue,Jammu,Punjab,2021-01-01,2246,161,2085,183,3
Dengue,Jammu,Punjab,2021-02-01,78,0,78,33,3
Dengue,Jammu,Punjab,2021-03-01,4925,201,4724,158,6
Dengue,Jammu,Punjab,2021-04-01,1161,61,1100,27,4
Dengue,Jammu,Punjab,2021-05-01,3036,136,2900,33,4
Dengue,Jammu,Punjab,2021-06-01,2461,0,2461,116,7
Dengue,Jammu,Punjab,2021-07-01,2466,88,2378,63,6
Dengue,Jammu,Punjab,2021-08-01,3684,280,3404,120,10
Dengue,Jammu,Punjab,2021-09-01,4839,30,4809,198,7
Dengue,Jammu,Punjab,2021-10-01,2935,53,2882,98,3
Dengue,Jammu,Punjab,2021-11-01,3476,130,3346,189,4
Dengue,Jammu,Punjab,2021-12-01,3039,87,2952,123,1
Dengue,Jammu,Punjab,2022-01-01,3962,195,3767,155,2
Dengue,Jammu,Punjab,2022-02-01,1976,36,1940,11,8
Dengue,Jammu,Punjab,2022-03-01,4040,156,3884,139,4
Dengue,Jammu,Punjab,2022-04-01,4087,198,3889,131,1
Dengue,Jammu,Punjab,2022-05-01,4050,279,3771,88,1
Dengue,Jammu,Punjab,2022-06-01,1712,147,1565,200,1
Dengue,Jammu,Punjab,2022-07-01,2372,100,2272,81,2
Dengue,Jammu,Punjab,2022-08-01,2919,306,2613,24,5
Dengue,Jammu,Punjab,2022-09-01,758,33,725,146,4
Dengue,Jammu,Punjab,2022-10-01,4737,351,4386,34,7
Dengue,Jammu,Punjab,2022-11-01,2581,274,2307,110,2
Dengue,Jammu,Punjab,2022-12-01,2978,161,2817,174,8
Dengue,Jammu,Punjab,2023-01-01,1823,18,1805,132,4
Dengue,Jammu,Punjab,2023-02-01,817,43,774,94,6
Dengue,Jammu,Punjab,2023-03-01,1787,57,1730,88,3
Dengue,Jammu,Punjab,2023-04-01,2891,121,2770,171,8
Dengue,Jammu,Punjab,2023-05-01,3501,377,3124,44,1
Dengue,Jammu,Punjab,2023-06-01,2814,40,2774,146,1
Dengue,Jammu,Punjab,2023-07-01,3063,180,2883,200,2
Dengue,Jammu,Punjab,2023-08-01,2145,52,2093,134,8
Dengue,Jammu,Punjab,2023-09-01,3263,134,3129,94,4
Dengue,Jammu,Punjab,2023-10-01,4587,329,4258,98,2
Dengue,Jammu,Punjab,2023-11-01,3543,210,3333,82,4
Dengue,Jammu,Punjab,2023-12-01,3683,160,3523,73,5
Dengue,Jammu,Punjab,2024-01-01,2992,93,2899,112,2
Dengue,Jammu,Punjab,2024-02-01,581,34,547,141,5
Dengue,Jammu,Punjab,2024-03-01,1196,119,1077,188,4
Dengue,Jammu,Punjab,2024-04-01,3208,76,3132,11,3
Dengue,Jammu,Punjab,2024-05-01,2583,273,2310,11,1
Dengue,Jammu,Punjab,2024-06-01,3187,270,2917,189,7
Dengue,Jammu,Punjab,2024-07-01,4846,435,4411,109,3
Dengue,Jammu,Punjab,2024-08-01,3571,210,3361,112,1
Dengue,Jammu,Punjab,2024-09-01,4286,360,3926,132,6
Dengue,Jammu,Punjab,2024-10-01,2724,56,2668,97,6
Dengue,Jammu,Punjab,2024-11-01,1515,46,1469,200,8
Dengue,Jammu,Punjab,2024-12-01,2520,182,2338,131,6
Dengue,Jammu,Punjab,2025-01-01,1518,89,1429,83,5
Dengue,Jammu,Punjab,2025-02-01,4688,214,4474,88,3
Dengue,Jammu,Punjab,2025-03-01,3658,0,3658,99,3
Dengue,Jammu,Punjab,2025-04-01,3296,123,3173,67,7
Dengue,Jammu,Punjab,2025-05-01,4255,67,4188,192,4
Dengue,Jammu,Punjab,2025-06-01,78,0,78,113,1
Dengue,Jammu,Punjab,2025-07-01,3386,150,3236,47,4
Dengue,Jammu,Punjab,2025-08-01,839,26,813,127,5
Dengue,Jammu,Punjab,2025-09-01,2588,328,2260,180,1
Dengue,Jammu,Punjab,2025-10-01,2179,174,2005,160,7
Dengue,Jammu,Punjab,2025-11-01,3485,281,3204,68,5
Dengue,Jammu,Punjab,2025-12-01,2904,331,2573,50,1
Dengue,Jammu,Chandigarh,2018-01-01,4402,323,4079,179,4
Dengue,Jammu,Chandigarh,2018-02-01,1790,49,1741,23,5
Dengue,Jammu,Chandigarh,2018-03-01,3549,85,3464,125,8
Dengue,Jammu,Chandigarh,2018-04-01,2815,220,2595,77,7
Dengue,Jammu,Chandigarh,2018-05-01,404,0,404,173,8
Dengue,Jammu,Chandigarh,2018-06-01,1365,65,1300,52,6
Dengue,Jammu,Chandigarh,2018-07-01,2396,0,2396,66,3
Dengue,Jammu,Chandigarh,2018-08-01,4090,216,3874,138,2
Dengue,Jammu,Chandigarh,2018-09-01,3219,241,2978,147,3
Dengue,Jammu,Chandigarh,2018-10-01,1031,60,971,175,5
Dengue,Jammu,Chandigarh,2018-11-01,2409,186,2223,130,5
Dengue,Jammu,Chandigarh,2018-12-01,4989,442,4547,124,8
Dengue,Jammu,Chandigarh,2019-01-01,2747,126,2621,160,4
Dengue,Jammu,Chandigarh,2019-02-01,2158,284,1874,36,1
Dengue,Jammu,Chandigarh,2019-03-01,3257,183,3074,61,1
Dengue,Jammu,Chandigarh,2019-04-01,3622,281,3341,41,2
Dengue,Jammu,Chandigarh,2019-05-01,1985,64,1921,11,2
Dengue,Jammu,Chandigarh,2019-06-01,3272,318,2954,149,1
Dengue,Jammu,Chandigarh,2019-07-01,2156,173,1983,179,9
Dengue,Jammu,Chandigarh,2019-08-01,3562,330,3232,135,1
Dengue,Jammu,Chandigarh,2019-09-01,2825,145,2680,126,3
Dengue,Jammu,Chandigarh,2019-10-01,3244,43,3201,111,7
Dengue,Jammu,Chandigarh,2019-11-01,1579,100,1479,109,7
Dengue,Jammu,Chandigarh,2019-12-01,1496,1,1495,193,1
Dengue,Jammu,Chandigarh,2020-01-01,3866,155,3711,185,8
Dengue,Jammu,Chandigarh,2020-02-01,2491,138,2353,76,8
Dengue,Jammu,Chandigarh,2020-03-01,2980,355,2625,163,4
Dengue,Jammu,Chandigarh,2020-04-01,2186,129,2057,169,5
Dengue,Jammu,Chandigarh,2020-05-01,3803,205,3598,139,2
Dengue,Jammu,Chandigarh,2020-06-01,1782,85,1697,126,6
Dengue,Jammu,Chandigarh,2020-07-01,2415,26,2389,124,5
Dengue,Jammu,Chandigarh,2020-08-01,3652,191,3461,31,3
Dengue,Jammu,Chandigarh,2020-09-01,4171,221,3950,26,7
Dengue,Jammu,Chandigarh,2020-10-01,1895,41,1854,146,6
Dengue,Jammu,Chandigarh,2020-11-01,4989,77,4912,50,10
Dengue,Jammu,Chandigarh,2020-12-01,3018,108,2910,35,2
Dengue,Jammu,Chandigarh,2021-01-01,1198,62,1136,11,9
Dengue,Jammu,Chandigarh,2021-02-01,3092,113,2979,82,2
Dengue,Jammu,Chandigarh,2021-03-01,2084,40,2044,125,6
Dengue,Jammu,Chandigarh,2021-04-01,3180,185,2995,129,1
Dengue,Jammu,Chandigarh,2021-05-01,2540,167,2373,150,3
Dengue,Jammu,Chandigarh,2021-06-01,2697,144,2553,86,6
Dengue,Jammu,Chandigarh,2021-07-01,1374,46,1328,112,6
Dengue,Jammu,Chandigarh,2021-08-01,3926,264,3662,149,1
Dengue,Jammu,Chandigarh,2021-09-01,1046,46,1000,130,4
Dengue,Jammu,Chandigarh,2021-10-01,1110,17,1093,76,9
Dengue,Jammu,Chandigarh,2021-11-01,3090,247,2843,121,8
Dengue,Jammu,Chandigarh,2021-12-01,4748,286,4462,11,8
Dengue,Jammu,Chandigarh,2022-01-01,2124,98,2026,106,10
Dengue,Jammu,Chandigarh,2022-02-01,3538,15,3523,75,1
Dengue,Jammu,Chandigarh,2022-03-01,4037,114,3923,184,4
Dengue,Jammu,Chandigarh,2022-04-01,3690,401,3289,56,5
Dengue,Jammu,Chandigarh,2022-05-01,2180,13,2167,112,3
Dengue,Jammu,Chandigarh,2022-06-01,1134,48,1086,84,5
Dengue,Jammu,Chandigarh,2022-07-01,78,0,78,78,9
Dengue,Jammu,Chandigarh,2022-08-01,2245,133,2112,125,5
Dengue,Jammu,Chandigarh,2022-09-01,4178,27,4151,85,1
Dengue,Jammu,Chandigarh,2022-10-01,1089,60,1029,200,7
Dengue,Jammu,Chandigarh,2022-11-01,3537,3,3534,11,5
Dengue,Jammu,Chandigarh,2022-12-01,1323,69,1254,138,1
Dengue,Jammu,Chandigarh,2023-01-01,2740,85,2655,102,3
Dengue,Jammu,Chandigarh,2023-02-01,3547,88,3459,104,1
Dengue,Jammu,Chandigarh,2023-03-01,1713,127,1586,122,4
Dengue,Jammu,Chandigarh,2023-04-01,2826,122,2704,157,3
Dengue,Jammu,Chandigarh,2023-05-01,2041,130,1911,120,1
Dengue,Jammu,Chandigarh,2023-06-01,3543,229,3314,157,6
Dengue,Jammu,Chandigarh,2023-07-01,2913,253,2660,109,2
Dengue,Jammu,Chandigarh,2023-08-01,2673,39,2634,54,9
Dengue,Jammu,Chandigarh,2023-09-01,4688,360,4328,102,5
Dengue,Jammu,Chandigarh,2023-10-01,3486,176,3310,165,4
Dengue,Jammu,Chandigarh,2023-11-01,1671,65,1606,85,8
Dengue,Jammu,Chandigarh,2023-12-01,2482,41,2441,51,6
Dengue,Jammu,Chandigarh,2024-01-01,2496,169,2327,138,6
Dengue,Jammu,Chandigarh,2024-02-01,2705,62,2643,123,5
Dengue,Jammu,Chandigarh,2024-03-01,4989,324,4665,67,4
Dengue,Jammu,Chandigarh,2024-04-01,3095,328,2767,94,6
Dengue,Jammu,Chandigarh,2024-05-01,78,0,78,97,9
Dengue,Jammu,Chandigarh,2024-06-01,1869,169,1700,107,1
Dengue,Jammu,Chandigarh,2024-07-01,78,0,78,139,10
Dengue,Jammu,Chandigarh,2024-08-01,2155,155,2000,86,2
Dengue,Jammu,Chandigarh,2024-09-01,78,0,78,142,5
Dengue,Jammu,Chandigarh,2024-10-01,1428,61,1367,79,1
Dengue,Jammu,Chandigarh,2024-11-01,557,56,501,191,9
Dengue,Jammu,Chandigarh,2024-12-01,3113,100,3013,192,1
Dengue,Jammu,Chandigarh,2025-01-01,2598,214,2384,63,8
Dengue,Jammu,Chandigarh,2025-02-01,3004,239,2765,44,4
Dengue,Jammu,Chandigarh,2025-03-01,2457,199,2258,156,4
Dengue,Jammu,Chandigarh,2025-04-01,727,9,718,119,1
Dengue,Jammu,Chandigarh,2025-05-01,3286,214,3072,134,8
Dengue,Jammu,Chandigarh,2025-06-01,4989,227,4762,73,4
Dengue,Jammu,Chandigarh,2025-07-01,3146,257,2889,99,7
Dengue,Jammu,Chandigarh,2025-08-01,2026,3,2023,89,1
Dengue,Jammu,Chandigarh,2025-09-01,682,41,641,122,2
Dengue,Jammu,Chandigarh,2025-10-01,1379,78,1301,43,6
Dengue,Jammu,Chandigarh,2025-11-01,3205,0,3205,101,1
Dengue,Jammu,Chandigarh,2025-12-01,4037,98,3939,42,6
Dengue,Jammu,Himachal Pradesh,2018-01-01,2947,0,2947,80,3
Dengue,Jammu,Himachal Pradesh,2018-02-01,3670,106,3564,101,3
Dengue,Jammu,Himachal Pradesh,2018-03-01,3547,234,3313,132,6
Dengue,Jammu,Himachal Pradesh,2018-04-01,3277,182,3095,136,5
Dengue,Jammu,Himachal Pradesh,2018-05-01,1714,94,1620,145,2
Dengue,Jammu,Himachal Pradesh,2018-06-01,2831,56,2775,31,8
Dengue,Jammu,Himachal Pradesh,2018-07-01,1459,120,1339,171,6
Dengue,Jammu,Himachal Pradesh,2018-08-01,2621,129,2492,73,1
Dengue,Jammu,Himachal Pradesh,2018-09-01,3041,155,2886,77,4
Dengue,Jammu,Himachal Pradesh,2018-10-01,4850,375,4475,120,6
Dengue,Jammu,Himachal Pradesh,2018-11-01,840,17,823,89,4
Dengue,Jammu,Himachal Pradesh,2018-12-01,3243,183,3060,125,1
Dengue,Jammu,Himachal Pradesh,2019-01-01,4584,286,4298,134,5
Dengue,Jammu,Himachal Pradesh,2019-02-01,3615,123,3492,67,7
Dengue,Jammu,Himachal Pradesh,2019-03-01,3715,256,3459,97,5
Dengue,Jammu,Himachal Pradesh,2019-04-01,3386,216,3170,98,5
Dengue,Jammu,Himachal Pradesh,2019-05-01,4339,204,4135,155,8
Dengue,Jammu,Himachal Pradesh,2019-06-01,1139,52,1087,83,1
Dengue,Jammu,Himachal Pradesh,2019-07-01,738,48,690,80,7
Dengue,Jammu,Himachal Pradesh,2019-08-01,2589,189,2400,54,6
Dengue,Jammu,Himachal Pradesh,2019-09-01,78,0,78,60,1
Dengue,Jammu,Himachal Pradesh,2019-10-01,4248,351,3897,37,7
Dengue,Jammu,Himachal Pradesh,2019-11-01,4235,293,3942,70,10
Dengue,Jammu,Himachal Pradesh,2019-12-01,2016,0,2016,187,6
Dengue,Jammu,Himachal Pradesh,2020-01-01,2100,19,2081,141,6
Dengue,Jammu,Himachal Pradesh,2020-02-01,2500,211,2289,171,2
Dengue,Jammu,Himachal Pradesh,2020-03-01,2667,114,2553,58,3
Dengue,Jammu,Himachal Pradesh,2020-04-01,2768,151,2617,11,2
Dengue,Jammu,Himachal Pradesh,2020-05-01,3346,278,3068,122,6
Dengue,Jammu,Himachal Pradesh,2020-06-01,2366,118,2248,200,3
Dengue,Jammu,Himachal Pradesh,2020-07-01,3863,197,3666,81,3
Dengue,Jammu,Himachal Pradesh,2020-08-01,3196,79,3117,111,7
Dengue,Jammu,Himachal Pradesh,2020-09-01,1783,108,1675,26,10
Dengue,Jammu,Himachal Pradesh,2020-10-01,4388,294,4094,108,5
Dengue,Jammu,Himachal Pradesh,2020-11-01,775,25,750,100,1
Dengue,Jammu,Himachal Pradesh,2020-12-01,2474,57,2417,11,5
Dengue,Jammu,Himachal Pradesh,2021-01-01,3895,442,3453,53,5
Dengue,Jammu,Himachal Pradesh,2021-02-01,1627,77,1550,49,7
Dengue,Jammu,Himachal Pradesh,2021-03-01,3013,90,2923,26,4
Dengue,Jammu,Himachal Pradesh,2021-04-01,3326,234,3092,69,7
Dengue,Jammu,Himachal Pradesh,2021-05-01,1443,70,1373,132,7
Dengue,Jammu,Himachal Pradesh,2021-06-01,2500,46,2454,74,4
Dengue,Jammu,Himachal Pradesh,2021-07-01,2387,153,2234,165,7
Dengue,Jammu,Himachal Pradesh,2021-08-01,1857,46,1811,88,8
Dengue,Jammu,Himachal Pradesh,2021-09-01,4989,442,4547,123,2
Dengue,Jammu,Himachal Pradesh,2021-10-01,1574,101,1473,132,8
Dengue,Jammu,Himachal Pradesh,2021-11-01,3946,165,3781,184,4
Dengue,Jammu,Himachal Pradesh,2021-12-01,2070,110,1960,70,4
Dengue,Jammu,Himachal Pradesh,2022-01-01,1140,87,1053,129,5
Dengue,Jammu,Himachal Pradesh,2022-02-01,2735,151,2584,58,8
Dengue,Jammu,Himachal Pradesh,2022-03-01,3468,387,3081,194,8
Dengue,Jammu,Himachal Pradesh,2022-04-01,3832,318,3514,53,6
Dengue,Jammu,Himachal Pradesh,2022-05-01,4693,301,4392,126,6
Dengue,Jammu,Himachal Pradesh,2022-06-01,4989,113,4876,186,5
Dengue,Jammu,Himachal Pradesh,2022-07-01,2933,134,2799,45,10
Dengue,Jammu,Himachal Pradesh,2022-08-01,1708,109,1599,137,3
Dengue,Jammu,Himachal Pradesh,2022-09-01,3205,83,3122,56,4
Dengue,Jammu,Himachal Pradesh,2022-10-01,2240,196,2044,200,6
Dengue,Jammu,Himachal Pradesh,2022-11-01,3840,83,3757,11,2
Dengue,Jammu,Himachal Pradesh,2022-12-01,857,27,830,29,8
Dengue,Jammu,Himachal Pradesh,2023-01-01,4989,168,4821,49,1
Dengue,Jammu,Himachal Pradesh,2023-02-01,3746,268,3478,51,3
Dengue,Jammu,Himachal Pradesh,2023-03-01,338,9,329,133,4
Dengue,Jammu,Himachal Pradesh,2023-04-01,1646,0,1646,198,2
Dengue,Jammu,Himachal Pradesh,2023-05-01,3692,301,3391,165,8
Dengue,Jammu,Himachal Pradesh,2023-06-01,4175,155,4020,118,1
Dengue,Jammu,Himachal Pradesh,2023-07-01,891,16,875,107,2
Dengue,Jammu,Himachal Pradesh,2023-08-01,3554,99,3455,75,3
Dengue,Jammu,Himachal Pradesh,2023-09-01,78,0,78,126,7
Dengue,Jammu,Himachal Pradesh,2023-10-01,2478,76,2402,96,9
Dengue,Jammu,Himachal Pradesh,2023-11-01,4089,190,3899,116,6
Dengue,Jammu,Himachal Pradesh,2023-12-01,1858,68,1790,68,1
Dengue,Jammu,Himachal Pradesh,2024-01-01,576,8,568,45,3
Dengue,Jammu,Himachal Pradesh,2024-02-01,2794,79,2715,108,9
Dengue,Jammu,Himachal Pradesh,2024-03-01,1786,21,1765,106,5
Dengue,Jammu,Himachal Pradesh,2024-04-01,3442,268,3174,76,1
Dengue,Jammu,Himachal Pradesh,2024-05-01,1410,74,1336,67,10
Dengue,Jammu,Himachal Pradesh,2024-06-01,1561,190,1371,135,3
Dengue,Jammu,Himachal Pradesh,2024-07-01,78,0,78,129,5
Dengue,Jammu,Himachal Pradesh,2024-08-01,2825,70,2755,200,3
Dengue,Jammu,Himachal Pradesh,2024-09-01,2382,225,2157,177,2
Dengue,Jammu,Himachal Pradesh,2024-10-01,1003,81,922,45,9
Dengue,Jammu,Himachal Pradesh,2024-11-01,2857,175,2682,96,5
Dengue,Jammu,Himachal Pradesh,2024-12-01,3975,70,3905,37,6
Dengue,Jammu,Himachal Pradesh,2025-01-01,2308,232,2076,13,1
Dengue,Jammu,Himachal Pradesh,2025-02-01,2957,141,2816,200,4
Dengue,Jammu,Himachal Pradesh,2025-03-01,2964,111,2853,182,3
Dengue,Jammu,Himachal Pradesh,2025-04-01,982,81,901,74,2
Dengue,Jammu,Himachal Pradesh,2025-05-01,4989,246,4743,170,6
Dengue,Jammu,Himachal Pradesh,2025-06-01,1966,31,1935,177,4
Dengue,Jammu,Himachal Pradesh,2025-07-01,3478,178,3300,11,7
Dengue,Jammu,Himachal Pradesh,2025-08-01,3629,99,3530,150,7
Dengue,Jammu,Himachal Pradesh,2025-09-01,2410,0,2410,81,4
Dengue,Jammu,Himachal Pradesh,2025-10-01,3411,83,3328,126,6
Dengue,Jammu,Himachal Pradesh,2025-11-01,2927,101,2826,200,3
Dengue,Jammu,Himachal Pradesh,2025-12-01,696,11,685,187,3
Dengue,Jammu,Jammu & Kashmir,2018-01-01,2152,143,2009,100,2
Dengue,Jammu,Jammu & Kashmir,2018-02-01,1776,48,1728,179,5
Dengue,Jammu,Jammu & Kashmir,2018-03-01,1978,126,1852,11,3
Dengue,Jammu,Jammu & Kashmir,2018-04-01,848,12,836,132,9
Dengue,Jammu,Jammu & Kashmir,2018-05-01,4109,314,3795,133,10
Dengue,Jammu,Jammu & Kashmir,2018-06-01,4746,61,4685,142,6
Dengue,Jammu,Jammu & Kashmir,2018-07-01,3909,0,3909,80,6
Dengue,Jammu,Jammu & Kashmir,2018-08-01,4302,370,3932,126,5
Dengue,Jammu,Jammu & Kashmir,2018-09-01,2135,53,2082,150,10
Dengue,Jammu,Jammu & Kashmir,2018-10-01,1744,176,1568,11,10
Dengue,Jammu,Jammu & Kashmir,2018-11-01,1553,103,1450,90,4
Dengue,Jammu,Jammu & Kashmir,2018-12-01,3461,252,3209,60,4
Dengue,Jammu,Jammu & Kashmir,2019-01-01,2902,233,2669,140,6
Dengue,Jammu,Jammu & Kashmir,2019-02-01,2494,133,2361,176,1
Dengue,Jammu,Jammu & Kashmir,2019-03-01,4335,232,4103,75,1
Dengue,Jammu,Jammu & Kashmir,2019-04-01,3141,274,2867,51,1
Dengue,Jammu,Jammu & Kashmir,2019-05-01,1472,78,1394,112,4
Dengue,Jammu,Jammu & Kashmir,2019-06-01,1684,48,1636,47,2
Dengue,Jammu,Jammu & Kashmir,2019-07-01,3512,235,3277,95,9
Dengue,Jammu,Jammu & Kashmir,2019-08-01,3995,0,3995,89,1
Dengue,Jammu,Jammu & Kashmir,2019-09-01,3337,295,3042,136,1
Dengue,Jammu,Jammu & Kashmir,2019-10-01,4989,442,4547,122,1
Dengue,Jammu,Jammu & Kashmir,2019-11-01,4791,406,4385,114,3
Dengue,Jammu,Jammu & Kashmir,2019-12-01,3189,267,2922,190,4
Dengue,Jammu,Jammu & Kashmir,2020-01-01,1472,70,1402,120,5
Dengue,Jammu,Jammu & Kashmir,2020-02-01,840,39,801,85,5
Dengue,Jammu,Jammu & Kashmir,2020-03-01,2078,29,2049,91,3
Dengue,Jammu,Jammu & Kashmir,2020-04-01,3608,364,3244,67,2
Dengue,Jammu,Jammu & Kashmir,2020-05-01,4989,179,4810,54,6
Dengue,Jammu,Jammu & Kashmir,2020-06-01,3157,189,2968,35,2
Dengue,Jammu,Jammu & Kashmir,2020-07-01,4165,239,3926,164,7
Dengue,Jammu,Jammu & Kashmir,2020-08-01,2268,25,2243,70,1
Dengue,Jammu,Jammu & Kashmir,2020-09-01,3433,0,3433,122,3
Dengue,Jammu,Jammu & Kashmir,2020-10-01,3702,185,3517,91,10
Dengue,Jammu,Jammu & Kashmir,2020-11-01,78,0,78,105,10
Dengue,Jammu,Jammu & Kashmir,2020-12-01,2043,96,1947,165,1
Dengue,Jammu,Jammu & Kashmir,2021-01-01,3871,313,3558,115,8
Dengue,Jammu,Jammu & Kashmir,2021-02-01,2966,167,2799,59,10
Dengue,Jammu,Jammu & Kashmir,2021-03-01,992,71,921,77,8
Dengue,Jammu,Jammu & Kashmir,2021-04-01,78,0,78,150,5
Dengue,Jammu,Jammu & Kashmir,2021-05-01,2107,86,2021,131,1
Dengue,Jammu,Jammu & Kashmir,2021-06-01,2501,52,2449,153,5
Dengue,Jammu,Jammu & Kashmir,2021-07-01,1412,81,1331,94,6
Dengue,Jammu,Jammu & Kashmir,2021-08-01,2789,146,2643,35,6
Dengue,Jammu,Jammu & Kashmir,2021-09-01,3277,251,3026,132,6
Dengue,Jammu,Jammu & Kashmir,2021-10-01,3497,159,3338,119,2
Dengue,Jammu,Jammu & Kashmir,2021-11-01,78,0,78,120,3
Dengue,Jammu,Jammu & Kashmir,2021-12-01,834,36,798,36,1
Dengue,Jammu,Jammu & Kashmir,2022-01-01,2189,51,2138,74,7
Dengue,Jammu,Jammu & Kashmir,2022-02-01,3365,310,3055,58,2
Dengue,Jammu,Jammu & Kashmir,2022-03-01,3254,270,2984,127,4
Dengue,Jammu,Jammu & Kashmir,2022-04-01,3230,47,3183,128,6
Dengue,Jammu,Jammu & Kashmir,2022-05-01,2083,153,1930,104,3
Dengue,Jammu,Jammu & Kashmir,2022-06-01,2158,0,2158,156,2
Dengue,Jammu,Jammu & Kashmir,2022-07-01,1620,127,1493,182,6
Dengue,Jammu,Jammu & Kashmir,2022-08-01,3628,108,3520,124,1
Dengue,Jammu,Jammu & Kashmir,2022-09-01,1363,82,1281,140,7
Dengue,Jammu,Jammu & Kashmir,2022-10-01,3738,0,3738,79,7
Dengue,Jammu,Jammu & Kashmir,2022-11-01,2876,43,2833,69,3
Dengue,Jammu,Jammu & Kashmir,2022-12-01,2537,161,2376,158,3
Dengue,Jammu,Jammu & Kashmir,2023-01-01,1716,50,1666,62,2
Dengue,Jammu,Jammu & Kashmir,2023-02-01,779,19,760,142,4
Dengue,Jammu,Jammu & Kashmir,2023-03-01,1729,156,1573,194,4
Dengue,Jammu,Jammu & Kashmir,2023-04-01,2155,246,1909,140,4
Dengue,Jammu,Jammu & Kashmir,2023-05-01,78,0,78,102,9
Dengue,Jammu,Jammu & Kashmir,2023-06-01,2333,42,2291,38,1
Dengue,Jammu,Jammu & Kashmir,2023-07-01,3837,389,3448,115,2
Dengue,Jammu,Jammu & Kashmir,2023-08-01,3358,15,3343,158,7
Dengue,Jammu,Jammu & Kashmir,2023-09-01,1932,79,1853,97,10
Dengue,Jammu,Jammu & Kashmir,2023-10-01,2660,137,2523,158,2
Dengue,Jammu,Jammu & Kashmir,2023-11-01,1851,196,1655,125,8
Dengue,Jammu,Jammu & Kashmir,2023-12-01,2797,214,2583,121,1
Dengue,Jammu,Jammu & Kashmir,2024-01-01,4663,170,4493,90,4
Dengue,Jammu,Jammu & Kashmir,2024-02-01,3897,87,3810,32,5
Dengue,Jammu,Jammu & Kashmir,2024-03-01,3296,261,3035,85,3
Dengue,Jammu,Jammu & Kashmir,2024-04-01,1936,66,1870,84,4
Dengue,Jammu,Jammu & Kashmir,2024-05-01,3603,203,3400,136,1
Dengue,Jammu,Jammu & Kashmir,2024-06-01,334,3,331,105,7
Dengue,Jammu,Jammu & Kashmir,2024-07-01,2259,150,2109,161,2
Dengue,Jammu,Jammu & Kashmir,2024-08-01,3380,217,3163,121,3
Dengue,Jammu,Jammu & Kashmir,2024-09-01,3591,50,3541,81,3
Dengue,Jammu,Jammu & Kashmir,2024-10-01,3496,280,3216,65,3
Dengue,Jammu,Jammu & Kashmir,2024-11-01,2993,198,2795,75,5
Dengue,Jammu,Jammu & Kashmir,2024-12-01,2335,167,2168,114,5
Dengue,Jammu,Jammu & Kashmir,2025-01-01,3319,129,3190,87,10
Dengue,Jammu,Jammu & Kashmir,2025-02-01,1319,72,1247,51,4
Dengue,Jammu,Jammu & Kashmir,2025-03-01,1464,76,1388,157,5
Dengue,Jammu,Jammu & Kashmir,2025-04-01,2680,122,2558,114,9
Dengue,Jammu,Jammu & Kashmir,2025-05-01,2830,155,2675,120,5
Dengue,Jammu,Jammu & Kashmir,2025-06-01,148,12,136,64,5
Dengue,Jammu,Jammu & Kashmir,2025-07-01,3208,260,2948,53,4
Dengue,Jammu,Jammu & Kashmir,2025-08-01,3634,56,3578,98,5
Dengue,Jammu,Jammu & Kashmir,2025-09-01,2494,196,2298,11,8
Dengue,Jammu,Jammu & Kashmir,2025-10-01,4989,422,4567,146,9
Dengue,Jammu,Jammu & Kashmir,2025-11-01,1681,76,1605,70,8
Dengue,Jammu,Jammu & Kashmir,2025-12-01,2113,137,1976,93,6
Dengue,Jammu,Haryana,2018-01-01,2067,133,1934,128,5
Dengue,Jammu,Haryana,2018-02-01,2495,63,2432,95,10
Dengue,Jammu,Haryana,2018-03-01,2156,83,2073,47,3
Dengue,Jammu,Haryana,2018-04-01,710,51,659,183,7
Dengue,Jammu,Haryana,2018-05-01,1864,66,1798,28,8
Dengue,Jammu,Haryana,2018-06-01,2466,193,2273,11,8
Dengue,Jammu,Haryana,2018-07-01,4246,373,3873,151,3
Dengue,Jammu,Haryana,2018-08-01,4989,415,4574,32,10
Dengue,Jammu,Haryana,2018-09-01,4389,442,3947,170,10
Dengue,Jammu,Haryana,2018-10-01,1557,73,1484,125,8
Dengue,Jammu,Haryana,2018-11-01,1664,91,1573,121,2
Dengue,Jammu,Haryana,2018-12-01,2384,141,2243,77,8
Dengue,Jammu,Haryana,2019-01-01,4989,241,4748,64,1
Dengue,Jammu,Haryana,2019-02-01,2375,156,2219,87,4
Dengue,Jammu,Haryana,2019-03-01,817,0,817,62,5
Dengue,Jammu,Haryana,2019-04-01,1925,107,1818,168,4
Dengue,Jammu,Haryana,2019-05-01,3613,36,3577,68,9
Dengue,Jammu,Haryana,2019-06-01,3523,77,3446,132,5
Dengue,Jammu,Haryana,2019-07-01,2329,166,2163,157,2
Dengue,Jammu,Haryana,2019-08-01,3514,155,3359,61,7
Dengue,Jammu,Haryana,2019-09-01,78,0,78,125,6
Dengue,Jammu,Haryana,2019-10-01,2737,119,2618,61,1
Dengue,Jammu,Haryana,2019-11-01,3752,308,3444,97,9
Dengue,Jammu,Haryana,2019-12-01,1480,63,1417,83,5
Dengue,Jammu,Haryana,2020-01-01,1475,0,1475,71,8
Dengue,Jammu,Haryana,2020-02-01,94,5,89,114,6
Dengue,Jammu,Haryana,2020-03-01,4730,0,4730,44,4
Dengue,Jammu,Haryana,2020-04-01,1631,12,1619,154,6
Dengue,Jammu,Haryana,2020-05-01,2921,71,2850,51,5
Dengue,Jammu,Haryana,2020-06-01,3408,70,3338,42,6
Dengue,Jammu,Haryana,2020-07-01,4626,158,4468,93,7
Dengue,Jammu,Haryana,2020-08-01,2391,47,2344,87,5
Dengue,Jammu,Haryana,2020-09-01,1874,17,1857,124,6
Dengue,Jammu,Haryana,2020-10-01,2830,268,2562,111,4
Dengue,Jammu,Haryana,2020-11-01,4320,131,4189,23,3
Dengue,Jammu,Haryana,2020-12-01,2369,0,2369,156,7
Dengue,Jammu,Haryana,2021-01-01,1316,52,1264,92,9
Dengue,Jammu,Haryana,2021-02-01,530,9,521,119,3
Dengue,Jammu,Haryana,2021-03-01,959,23,936,200,6
Dengue,Jammu,Haryana,2021-04-01,3757,265,3492,172,1
Dengue,Jammu,Haryana,2021-05-01,2167,80,2087,117,10
Dengue,Jammu,Haryana,2021-06-01,1782,29,1753,36,8
Dengue,Jammu,Haryana,2021-07-01,1637,103,1534,37,3
Dengue,Jammu,Haryana,2021-08-01,2711,226,2485,165,4
Dengue,Jammu,Haryana,2021-09-01,2276,149,2127,86,8
Dengue,Jammu,Haryana,2021-10-01,2231,0,2231,98,5
Dengue,Jammu,Haryana,2021-11-01,4408,77,4331,48,7
Dengue,Jammu,Haryana,2021-12-01,4661,239,4422,129,2
Dengue,Jammu,Haryana,2022-01-01,438,18,420,164,6
Dengue,Jammu,Haryana,2022-02-01,3037,123,2914,184,4
Dengue,Jammu,Haryana,2022-03-01,1555,33,1522,83,6
Dengue,Jammu,Haryana,2022-04-01,2264,20,2244,139,4
Dengue,Jammu,Haryana,2022-05-01,3012,326,2686,101,4
Dengue,Jammu,Haryana,2022-06-01,2312,117,2195,151,5
Dengue,Jammu,Haryana,2022-07-01,2907,199,2708,106,3
Dengue,Jammu,Haryana,2022-08-01,3500,175,3325,64,10
Dengue,Jammu,Haryana,2022-09-01,2993,153,2840,173,2
Dengue,Jammu,Haryana,2022-10-01,1730,83,1647,111,6
Dengue,Jammu,Haryana,2022-11-01,1753,30,1723,88,6
Dengue,Jammu,Haryana,2022-12-01,666,3,663,115,7
Dengue,Jammu,Haryana,2023-01-01,1452,89,1363,69,1
Dengue,Jammu,Haryana,2023-02-01,4989,277,4712,127,1
Dengue,Jammu,Haryana,2023-03-01,1535,118,1417,96,3
Dengue,Jammu,Haryana,2023-04-01,996,71,925,66,7
Dengue,Jammu,Haryana,2023-05-01,3027,80,2947,200,4
Dengue,Jammu,Haryana,2023-06-01,2449,203,2246,55,4
Dengue,Jammu,Haryana,2023-07-01,2335,168,2167,124,5
Dengue,Jammu,Haryana,2023-08-01,4488,314,4174,109,2
Dengue,Jammu,Haryana,2023-09-01,3334,385,2949,54,6
Dengue,Jammu,Haryana,2023-10-01,1886,206,1680,89,5
Dengue,Jammu,Haryana,2023-11-01,2028,142,1886,38,6
Dengue,Jammu,Haryana,2023-12-01,1923,127,1796,200,9
Dengue,Jammu,Haryana,2024-01-01,3771,307,3464,93,4
Dengue,Jammu,Haryana,2024-02-01,2184,72,2112,97,5
Dengue,Jammu,Haryana,2024-03-01,192,6,186,200,2
Dengue,Jammu,Haryana,2024-04-01,2533,176,2357,64,1
Dengue,Jammu,Haryana,2024-05-01,535,13,522,172,5
Dengue,Jammu,Haryana,2024-06-01,4989,335,4654,136,5
Dengue,Jammu,Haryana,2024-07-01,1302,71,1231,11,7
Dengue,Jammu,Haryana,2024-08-01,2380,59,2321,87,6
Dengue,Jammu,Haryana,2024-09-01,2944,149,2795,128,6
Dengue,Jammu,Haryana,2024-10-01,2210,194,2016,108,10
Dengue,Jammu,Haryana,2024-11-01,2208,115,2093,108,4
Dengue,Jammu,Haryana,2024-12-01,3163,166,2997,75,4
Dengue,Jammu,Haryana,2025-01-01,4645,277,4368,70,6
Dengue,Jammu,Haryana,2025-02-01,3627,230,3397,90,1
Dengue,Jammu,Haryana,2025-03-01,4581,185,4396,200,7
Dengue,Jammu,Haryana,2025-04-01,1193,71,1122,60,5
Dengue,Jammu,Haryana,2025-05-01,3023,59,2964,82,5
Dengue,Jammu,Haryana,2025-06-01,2806,75,2731,108,6
Dengue,Jammu,Haryana,2025-07-01,3068,93,2975,32,6
Dengue,Jammu,Haryana,2025-08-01,4444,283,4161,128,6
Dengue,Jammu,Haryana,2025-09-01,2301,125,2176,41,4
Dengue,Jammu,Haryana,2025-10-01,2053,94,1959,51,9
Dengue,Jammu,Haryana,2025-11-01,3314,232,3082,48,1
Dengue,Jammu,Haryana,2025-12-01,212,12,200,23,3
Dengue,Srinagar,Punjab,2018-01-01,2280,94,2186,171,3
Dengue,Srinagar,Punjab,2018-02-01,2417,48,2369,133,3
Dengue,Srinagar,Punjab,2018-03-01,1363,35,1328,153,1
Dengue,Srinagar,Punjab,2018-04-01,4015,29,3986,149,10
Dengue,Srinagar,Punjab,2018-05-01,1172,63,1109,98,7
Dengue,Srinagar,Punjab,2018-06-01,2415,60,2355,105,3
Dengue,Srinagar,Punjab,2018-07-01,2991,106,2885,158,7
Dengue,Srinagar,Punjab,2018-08-01,4413,204,4209,190,4
Dengue,Srinagar,Punjab,2018-09-01,2583,207,2376,42,4
Dengue,Srinagar,Punjab,2018-10-01,3853,297,3556,200,2
Dengue,Srinagar,Punjab,2018-11-01,3537,171,3366,39,5
Dengue,Srinagar,Punjab,2018-12-01,2763,240,2523,83,3
Dengue,Srinagar,Punjab,2019-01-01,1136,0,1136,110,2
Dengue,Srinagar,Punjab,2019-02-01,673,70,603,115,8
Dengue,Srinagar,Punjab,2019-03-01,2740,192,2548,200,2
Dengue,Srinagar,Punjab,2019-04-01,1869,99,1770,158,9
Dengue,Srinagar,Punjab,2019-05-01,3831,92,3739,127,3
Dengue,Srinagar,Punjab,2019-06-01,3598,134,3464,159,1
Dengue,Srinagar,Punjab,2019-07-01,2350,159,2191,124,6
Dengue,Srinagar,Punjab,2019-08-01,1044,71,973,72,4
Dengue,Srinagar,Punjab,2019-09-01,3283,228,3055,131,1
Dengue,Srinagar,Punjab,2019-10-01,1232,35,1197,110,6
Dengue,Srinagar,Punjab,2019-11-01,1580,36,1544,63,1
Dengue,Srinagar,Punjab,2019-12-01,1284,71,1213,171,1
Dengue,Srinagar,Punjab,2020-01-01,2412,174,2238,103,7
Dengue,Srinagar,Punjab,2020-02-01,4167,209,3958,49,9
Dengue,Srinagar,Punjab,2020-03-01,2591,241,2350,57,4
Dengue,Srinagar,Punjab,2020-04-01,2003,102,1901,133,8
Dengue,Srinagar,Punjab,2020-05-01,551,27,524,160,7
Dengue,Srinagar,Punjab,2020-06-01,3338,232,3106,131,7
Dengue,Srinagar,Punjab,2020-07-01,1550,132,1418,131,4
Dengue,Srinagar,Punjab,2020-08-01,2755,29,2726,65,3
Dengue,Srinagar,Punjab,2020-09-01,2122,37,2085,111,6
Dengue,Srinagar,Punjab,2020-10-01,3722,152,3570,89,7
Dengue,Srinagar,Punjab,2020-11-01,2386,338,2048,96,1
Dengue,Srinagar,Punjab,2020-12-01,2518,106,2412,101,4
Dengue,Srinagar,Punjab,2021-01-01,3249,151,3098,73,4
Dengue,Srinagar,Punjab,2021-02-01,4989,339,4650,145,4
Dengue,Srinagar,Punjab,2021-03-01,3789,297,3492,55,3
Dengue,Srinagar,Punjab,2021-04-01,2479,136,2343,40,1
Dengue,Srinagar,Punjab,2021-05-01,2602,218,2384,66,4
Dengue,Srinagar,Punjab,2021-06-01,1893,29,1864,151,4
Dengue,Srinagar,Punjab,2021-07-01,1323,36,1287,123,3
Dengue,Srinagar,Punjab,2021-08-01,1856,155,1701,15,7
Dengue,Srinagar,Punjab,2021-09-01,1562,78,1484,137,1
Dengue,Srinagar,Punjab,2021-10-01,3474,46,3428,104,6
Dengue,Srinagar,Punjab,2021-11-01,1160,13,1147,85,1
Dengue,Srinagar,Punjab,2021-12-01,4386,116,4270,94,5
Dengue,Srinagar,Punjab,2022-01-01,3606,180,3426,38,1
Dengue,Srinagar,Punjab,2022-02-01,2625,167,2458,115,2
Dengue,Srinagar,Punjab,2022-03-01,2598,105,2493,42,5
Dengue,Srinagar,Punjab,2022-04-01,1850,113,1737,88,1
Dengue,Srinagar,Punjab,2022-05-01,2960,110,2850,88,1
Dengue,Srinagar,Punjab,2022-06-01,4057,347,3710,145,8
Dengue,Srinagar,Punjab,2022-07-01,1654,205,1449,108,1
Dengue,Srinagar,Punjab,2022-08-01,540,20,520,142,4
Dengue,Srinagar,Punjab,2022-09-01,3541,226,3315,45,9
Dengue,Srinagar,Punjab,2022-10-01,3033,187,2846,101,5
Dengue,Srinagar,Punjab,2022-11-01,1095,59,1036,133,5
Dengue,Srinagar,Punjab,2022-12-01,1614,111,1503,170,3
Dengue,Srinagar,Punjab,2023-01-01,1445,92,1353,48,3
Dengue,Srinagar,Punjab,2023-02-01,1625,59,1566,63,4
Dengue,Srinagar,Punjab,2023-03-01,2163,191,1972,132,1
Dengue,Srinagar,Punjab,2023-04-01,2240,125,2115,188,8
Dengue,Srinagar,Punjab,2023-05-01,1724,67,1657,121,5
Dengue,Srinagar,Punjab,2023-06-01,1580,191,1389,50,1
Dengue,Srinagar,Punjab,2023-07-01,2290,106,2184,51,8
Dengue,Srinagar,Punjab,2023-08-01,2822,162,2660,113,7
Dengue,Srinagar,Punjab,2023-09-01,2173,119,2054,124,6
Dengue,Srinagar,Punjab,2023-10-01,4152,192,3960,95,10
Dengue,Srinagar,Punjab,2023-11-01,3279,207,3072,51,5
Dengue,Srinagar,Punjab,2023-12-01,463,11,452,162,9
Dengue,Srinagar,Punjab,2024-01-01,3300,222,3078,88,5
Dengue,Srinagar,Punjab,2024-02-01,3410,0,3410,133,6
Dengue,Srinagar,Punjab,2024-03-01,2014,24,1990,16,3
Dengue,Srinagar,Punjab,2024-04-01,592,61,531,167,1
Dengue,Srinagar,Punjab,2024-05-01,2608,35,2573,71,1
Dengue,Srinagar,Punjab,2024-06-01,2587,0,2587,175,5
Dengue,Srinagar,Punjab,2024-07-01,1093,15,1078,137,4
Dengue,Srinagar,Punjab,2024-08-01,651,65,586,33,1
Dengue,Srinagar,Punjab,2024-09-01,2480,0,2480,119,4
Dengue,Srinagar,Punjab,2024-10-01,2285,50,2235,191,6
Dengue,Srinagar,Punjab,2024-11-01,2038,15,2023,76,9
Dengue,Srinagar,Punjab,2024-12-01,2486,104,2382,191,3
Dengue,Srinagar,Punjab,2025-01-01,1118,41,1077,126,6
Dengue,Srinagar,Punjab,2025-02-01,2014,72,1942,174,10
Dengue,Srinagar,Punjab,2025-03-01,3313,344,2969,114,7
Dengue,Srinagar,Punjab,2025-04-01,2128,32,2096,100,3
Dengue,Srinagar,Punjab,2025-05-01,354,16,338,200,5
Dengue,Srinagar,Punjab,2025-06-01,1963,117,1846,143,5
Dengue,Srinagar,Punjab,2025-07-01,1162,25,1137,94,7
Dengue,Srinagar,Punjab,2025-08-01,2956,189,2767,128,5
Dengue,Srinagar,Punjab,2025-09-01,3025,116,2909,77,6
Dengue,Srinagar,Punjab,2025-10-01,372,22,350,112,8
Dengue,Srinagar,Punjab,2025-11-01,3616,169,3447,167,2
Dengue,Srinagar,Punjab,2025-12-01,1105,0,1105,98,1
Dengue,Srinagar,Chandigarh,2018-01-01,4689,413,4276,62,7
Dengue,Srinagar,Chandigarh,2018-02-01,2532,279,2253,57,4
Dengue,Srinagar,Chandigarh,2018-03-01,925,41,884,110,7
Dengue,Srinagar,Chandigarh,2018-04-01,1065,25,1040,65,8
Dengue,Srinagar,Chandigarh,2018-05-01,3064,287,2777,33,1
Dengue,Srinagar,Chandigarh,2018-06-01,2072,217,1855,45,2
Dengue,Srinagar,Chandigarh,2018-07-01,2468,111,2357,166,4
Dengue,Srinagar,Chandigarh,2018-08-01,4761,208,4553,99,2
Dengue,Srinagar,Chandigarh,2018-09-01,1659,79,1580,109,3
Dengue,Srinagar,Chandigarh,2018-10-01,2678,3,2675,57,1
Dengue,Srinagar,Chandigarh,2018-11-01,4502,187,4315,77,4
Dengue,Srinagar,Chandigarh,2018-12-01,2960,295,2665,75,2
Dengue,Srinagar,Chandigarh,2019-01-01,442,19,423,92,6
Dengue,Srinagar,Chandigarh,2019-02-01,3275,64,3211,22,7
Dengue,Srinagar,Chandigarh,2019-03-01,1037,66,971,162,6
Dengue,Srinagar,Chandigarh,2019-04-01,4485,137,4348,105,10
Dengue,Srinagar,Chandigarh,2019-05-01,1494,71,1423,117,8
Dengue,Srinagar,Chandigarh,2019-06-01,4989,65,4924,153,7
Dengue,Srinagar,Chandigarh,2019-07-01,4566,90,4476,149,5
Dengue,Srinagar,Chandigarh,2019-08-01,1529,109,1420,77,4
Dengue,Srinagar,Chandigarh,2019-09-01,2624,140,2484,137,9
Dengue,Srinagar,Chandigarh,2019-10-01,3608,99,3509,136,4
Dengue,Srinagar,Chandigarh,2019-11-01,3649,195,3454,122,5
Dengue,Srinagar,Chandigarh,2019-12-01,3191,103,3088,160,4
Dengue,Srinagar,Chandigarh,2020-01-01,4277,116,4161,147,6
Dengue,Srinagar,Chandigarh,2020-02-01,2432,204,2228,143,7
Dengue,Srinagar,Chandigarh,2020-03-01,2105,153,1952,176,8
Dengue,Srinagar,Chandigarh,2020-04-01,2132,105,2027,108,4
Dengue,Srinagar,Chandigarh,2020-05-01,3749,203,3546,109,5
Dengue,Srinagar,Chandigarh,2020-06-01,3087,153,2934,148,6
Dengue,Srinagar,Chandigarh,2020-07-01,2988,191,2797,97,9
Dengue,Srinagar,Chandigarh,2020-08-01,3664,98,3566,131,1
Dengue,Srinagar,Chandigarh,2020-09-01,78,0,78,78,5
Dengue,Srinagar,Chandigarh,2020-10-01,3013,181,2832,11,3
Dengue,Srinagar,Chandigarh,2020-11-01,2891,122,2769,137,3
Dengue,Srinagar,Chandigarh,2020-12-01,4836,173,4663,27,2
Dengue,Srinagar,Chandigarh,2021-01-01,547,40,507,71,6
Dengue,Srinagar,Chandigarh,2021-02-01,4686,214,4472,148,1
Dengue,Srinagar,Chandigarh,2021-03-01,2699,80,2619,149,4
Dengue,Srinagar,Chandigarh,2021-04-01,3253,126,3127,166,1
Dengue,Srinagar,Chandigarh,2021-05-01,4846,351,4495,11,3
Dengue,Srinagar,Chandigarh,2021-06-01,3350,10,3340,121,4
Dengue,Srinagar,Chandigarh,2021-07-01,3135,124,3011,93,4
Dengue,Srinagar,Chandigarh,2021-08-01,2922,237,2685,157,7
Dengue,Srinagar,Chandigarh,2021-09-01,1949,88,1861,181,8
Dengue,Srinagar,Chandigarh,2021-10-01,2559,148,2411,40,10
Dengue,Srinagar,Chandigarh,2021-11-01,1638,133,1505,107,5
Dengue,Srinagar,Chandigarh,2021-12-01,2538,192,2346,149,8
Dengue,Srinagar,Chandigarh,2022-01-01,78,0,78,89,9
Dengue,Srinagar,Chandigarh,2022-02-01,3173,146,3027,195,3
Dengue,Srinagar,Chandigarh,2022-03-01,2434,185,2249,86,8
Dengue,Srinagar,Chandigarh,2022-04-01,2146,166,1980,91,1
Dengue,Srinagar,Chandigarh,2022-05-01,2892,137,2755,52,6
Dengue,Srinagar,Chandigarh,2022-06-01,674,32,642,114,9
Dengue,Srinagar,Chandigarh,2022-07-01,4989,288,4701,11,5
Dengue,Srinagar,Chandigarh,2022-08-01,2460,221,2239,94,4
Dengue,Srinagar,Chandigarh,2022-09-01,2402,194,2208,171,4
Dengue,Srinagar,Chandigarh,2022-10-01,1302,91,1211,35,9
Dengue,Srinagar,Chandigarh,2022-11-01,2630,49,2581,24,1
Dengue,Srinagar,Chandigarh,2022-12-01,4458,187,4271,163,4
Dengue,Srinagar,Chandigarh,2023-01-01,3987,173,3814,170,7
Dengue,Srinagar,Chandigarh,2023-02-01,3744,342,3402,37,6
Dengue,Srinagar,Chandigarh,2023-03-01,3330,143,3187,194,8
Dengue,Srinagar,Chandigarh,2023-04-01,2116,183,1933,128,7
Dengue,Srinagar,Chandigarh,2023-05-01,652,21,631,160,3
Dengue,Srinagar,Chandigarh,2023-06-01,2328,83,2245,66,7
Dengue,Srinagar,Chandigarh,2023-07-01,2281,146,2135,182,1
Dengue,Srinagar,Chandigarh,2023-08-01,4004,383,3621,93,1
Dengue,Srinagar,Chandigarh,2023-09-01,3012,132,2880,90,3
Dengue,Srinagar,Chandigarh,2023-10-01,4760,0,4760,131,5
Dengue,Srinagar,Chandigarh,2023-11-01,4204,19,4185,86,2
Dengue,Srinagar,Chandigarh,2023-12-01,1985,116,1869,29,5
Dengue,Srinagar,Chandigarh,2024-01-01,189,1,188,113,5
Dengue,Srinagar,Chandigarh,2024-02-01,4456,110,4346,90,1
Dengue,Srinagar,Chandigarh,2024-03-01,4421,222,4199,67,3
Dengue,Srinagar,Chandigarh,2024-04-01,765,0,765,169,8
Dengue,Srinagar,Chandigarh,2024-05-01,4622,180,4442,200,6
Dengue,Srinagar,Chandigarh,2024-06-01,3110,50,3060,59,3
Dengue,Srinagar,Chandigarh,2024-07-01,2813,18,2795,116,7
Dengue,Srinagar,Chandigarh,2024-08-01,4764,127,4637,86,10
Dengue,Srinagar,Chandigarh,2024-09-01,4401,83,4318,200,4
Dengue,Srinagar,Chandigarh,2024-10-01,3471,221,3250,131,7
Dengue,Srinagar,Chandigarh,2024-11-01,3232,274,2958,153,7
Dengue,Srinagar,Chandigarh,2024-12-01,3424,135,3289,166,3
Dengue,Srinagar,Chandigarh,2025-01-01,2061,67,1994,113,2
Dengue,Srinagar,Chandigarh,2025-02-01,2523,95,2428,97,10
Dengue,Srinagar,Chandigarh,2025-03-01,1387,24,1363,184,8
Dengue,Srinagar,Chandigarh,2025-04-01,2151,27,2124,146,4
Dengue,Srinagar,Chandigarh,2025-05-01,2106,4,2102,63,8
Dengue,Srinagar,Chandigarh,2025-06-01,1745,19,1726,69,6
Dengue,Srinagar,Chandigarh,2025-07-01,2781,271,2510,86,8
Dengue,Srinagar,Chandigarh,2025-08-01,2163,64,2099,165,1
Dengue,Srinagar,Chandigarh,2025-09-01,3271,0,3271,181,4
Dengue,Srinagar,Chandigarh,2025-10-01,421,13,408,200,9
Dengue,Srinagar,Chandigarh,2025-11-01,2445,9,2436,70,10
Dengue,Srinagar,Chandigarh,2025-12-01,2774,143,2631,113,4
Dengue,Srinagar,Himachal Pradesh,2018-01-01,2181,106,2075,86,4
Dengue,Srinagar,Himachal Pradesh,2018-02-01,2366,122,2244,97,7
Dengue,Srinagar,Himachal Pradesh,2018-03-01,471,23,448,154,6
Dengue,Srinagar,Himachal Pradesh,2018-04-01,3076,120,2956,104,6
Dengue,Srinagar,Himachal Pradesh,2018-05-01,3466,26,3440,173,1
Dengue,Srinagar,Himachal Pradesh,2018-06-01,3259,156,3103,80,4
Dengue,Srinagar,Himachal Pradesh,2018-07-01,3991,318,3673,144,7
Dengue,Srinagar,Himachal Pradesh,2018-08-01,2868,294,2574,84,1
Dengue,Srinagar,Himachal Pradesh,2018-09-01,3240,139,3101,13,1
Dengue,Srinagar,Himachal Pradesh,2018-10-01,2807,129,2678,54,1
Dengue,Srinagar,Himachal Pradesh,2018-11-01,3520,227,3293,113,7
Dengue,Srinagar,Himachal Pradesh,2018-12-01,482,45,437,200,2
Dengue,Srinagar,Himachal Pradesh,2019-01-01,1399,50,1349,83,1
Dengue,Srinagar,Himachal Pradesh,2019-02-01,4726,331,4395,98,5
Dengue,Srinagar,Himachal Pradesh,2019-03-01,78,0,78,131,1
Dengue,Srinagar,Himachal Pradesh,2019-04-01,2409,143,2266,76,6
Dengue,Srinagar,Himachal Pradesh,2019-05-01,4170,326,3844,82,10
Dengue,Srinagar,Himachal Pradesh,2019-06-01,2472,30,2442,110,4
Dengue,Srinagar,Himachal Pradesh,2019-07-01,2054,71,1983,84,1
Dengue,Srinagar,Himachal Pradesh,2019-08-01,2771,215,2556,15,4
Dengue,Srinagar,Himachal Pradesh,2019-09-01,2124,144,1980,73,6
Dengue,Srinagar,Himachal Pradesh,2019-10-01,2639,211,2428,138,6
Dengue,Srinagar,Himachal Pradesh,2019-11-01,1681,125,1556,139,7
Dengue,Srinagar,Himachal Pradesh,2019-12-01,4085,163,3922,174,3
Dengue,Srinagar,Himachal Pradesh,2020-01-01,4507,442,4065,170,4
Dengue,Srinagar,Himachal Pradesh,2020-02-01,2418,130,2288,60,1
Dengue,Srinagar,Himachal Pradesh,2020-03-01,737,0,737,68,7
Dengue,Srinagar,Himachal Pradesh,2020-04-01,1895,79,1816,70,1
Dengue,Srinagar,Himachal Pradesh,2020-05-01,2351,85,2266,98,5
Dengue,Srinagar,Himachal Pradesh,2020-06-01,3276,239,3037,74,2
Dengue,Srinagar,Himachal Pradesh,2020-07-01,1245,45,1200,97,5
Dengue,Srinagar,Himachal Pradesh,2020-08-01,1566,128,1438,62,8
Dengue,Srinagar,Himachal Pradesh,2020-09-01,3282,217,3065,146,4
Dengue,Srinagar,Himachal Pradesh,2020-10-01,3857,80,3777,58,3
Dengue,Srinagar,Himachal Pradesh,2020-11-01,1764,81,1683,55,5
Dengue,Srinagar,Himachal Pradesh,2020-12-01,809,22,787,133,3
Dengue,Srinagar,Himachal Pradesh,2021-01-01,4989,276,4713,143,2
Dengue,Srinagar,Himachal Pradesh,2021-02-01,3648,99,3549,95,10
Dengue,Srinagar,Himachal Pradesh,2021-03-01,2239,116,2123,150,1
Dengue,Srinagar,Himachal Pradesh,2021-04-01,3763,158,3605,147,7
Dengue,Srinagar,Himachal Pradesh,2021-05-01,2430,110,2320,200,4
Dengue,Srinagar,Himachal Pradesh,2021-06-01,3761,412,3349,144,2
Dengue,Srinagar,Himachal Pradesh,2021-07-01,2811,111,2700,193,6
Dengue,Srinagar,Himachal Pradesh,2021-08-01,2720,0,2720,109,5
Dengue,Srinagar,Himachal Pradesh,2021-09-01,2445,194,2251,178,9
Dengue,Srinagar,Himachal Pradesh,2021-10-01,656,52,604,179,2
Dengue,Srinagar,Himachal Pradesh,2021-11-01,4989,20,4969,99,3
Dengue,Srinagar,Himachal Pradesh,2021-12-01,1334,39,1295,71,8
Dengue,Srinagar,Himachal Pradesh,2022-01-01,773,48,725,80,4
Dengue,Srinagar,Himachal Pradesh,2022-02-01,2312,151,2161,127,6
Dengue,Srinagar,Himachal Pradesh,2022-03-01,1308,65,1243,48,8
Dengue,Srinagar,Himachal Pradesh,2022-04-01,2528,127,2401,83,6
Dengue,Srinagar,Himachal Pradesh,2022-05-01,3520,80,3440,167,3
Dengue,Srinagar,Himachal Pradesh,2022-06-01,3933,0,3933,140,4
Dengue,Srinagar,Himachal Pradesh,2022-07-01,3690,404,3286,11,8
Dengue,Srinagar,Himachal Pradesh,2022-08-01,2187,47,2140,38,5
Dengue,Srinagar,Himachal Pradesh,2022-09-01,2664,147,2517,200,4
Dengue,Srinagar,Himachal Pradesh,2022-10-01,3145,142,3003,166,6
Dengue,Srinagar,Himachal Pradesh,2022-11-01,239,18,221,77,1
Dengue,Srinagar,Himachal Pradesh,2022-12-01,3363,179,3184,30,4
Dengue,Srinagar,Himachal Pradesh,2023-01-01,642,35,607,43,5
Dengue,Srinagar,Himachal Pradesh,2023-02-01,4989,20,4969,132,5
Dengue,Srinagar,Himachal Pradesh,2023-03-01,2055,53,2002,200,4
Dengue,Srinagar,Himachal Pradesh,2023-04-01,2349,168,2181,200,4
Dengue,Srinagar,Himachal Pradesh,2023-05-01,1565,108,1457,26,4
Dengue,Srinagar,Himachal Pradesh,2023-06-01,1752,39,1713,91,9
Dengue,Srinagar,Himachal Pradesh,2023-07-01,4989,20,4969,63,1
Dengue,Srinagar,Himachal Pradesh,2023-08-01,3859,207,3652,113,7
Dengue,Srinagar,Himachal Pradesh,2023-09-01,519,0,519,38,5
Dengue,Srinagar,Himachal Pradesh,2023-10-01,4615,76,4539,78,5
Dengue,Srinagar,Himachal Pradesh,2023-11-01,4198,425,3773,62,4
Dengue,Srinagar,Himachal Pradesh,2023-12-01,2220,204,2016,133,6
Dengue,Srinagar,Himachal Pradesh,2024-01-01,3009,193,2816,80,8
Dengue,Srinagar,Himachal Pradesh,2024-02-01,2577,152,2425,87,1
Dengue,Srinagar,Himachal Pradesh,2024-03-01,4989,20,4969,132,10
Dengue,Srinagar,Himachal Pradesh,2024-04-01,1529,43,1486,190,5
Dengue,Srinagar,Himachal Pradesh,2024-05-01,2793,115,2678,200,5
Dengue,Srinagar,Himachal Pradesh,2024-06-01,2023,58,1965,129,1
Dengue,Srinagar,Himachal Pradesh,2024-07-01,675,26,649,102,3
Dengue,Srinagar,Himachal Pradesh,2024-08-01,4989,438,4551,173,9
Dengue,Srinagar,Himachal Pradesh,2024-09-01,1012,34,978,166,5
Dengue,Srinagar,Himachal Pradesh,2024-10-01,2893,116,2777,151,6
Dengue,Srinagar,Himachal Pradesh,2024-11-01,262,18,244,26,3
Dengue,Srinagar,Himachal Pradesh,2024-12-01,2062,18,2044,168,10
Dengue,Srinagar,Himachal Pradesh,2025-01-01,3163,81,3082,124,4
Dengue,Srinagar,Himachal Pradesh,2025-02-01,1491,42,1449,61,8
Dengue,Srinagar,Himachal Pradesh,2025-03-01,3385,174,3211,72,4
Dengue,Srinagar,Himachal Pradesh,2025-04-01,2236,89,2147,136,6
Dengue,Srinagar,Himachal Pradesh,2025-05-01,4154,170,3984,11,6
Dengue,Srinagar,Himachal Pradesh,2025-06-01,4424,135,4289,100,8
Dengue,Srinagar,Himachal Pradesh,2025-07-01,1810,34,1776,73,7
Dengue,Srinagar,Himachal Pradesh,2025-08-01,2700,183,2517,68,3
Dengue,Srinagar,Himachal Pradesh,2025-09-01,2844,114,2730,83,8
Dengue,Srinagar,Himachal Pradesh,2025-10-01,3428,233,3195,31,2
Dengue,Srinagar,Himachal Pradesh,2025-11-01,2617,46,2571,160,1
Dengue,Srinagar,Himachal Pradesh,2025-12-01,2853,87,2766,11,4
Dengue,Srinagar,Jammu & Kashmir,2018-01-01,2271,99,2172,115,6
Dengue,Srinagar,Jammu & Kashmir,2018-02-01,2752,127,2625,63,2
Dengue,Srinagar,Jammu & Kashmir,2018-03-01,4339,312,4027,200,5
Dengue,Srinagar,Jammu & Kashmir,2018-04-01,3464,130,3334,107,1
Dengue,Srinagar,Jammu & Kashmir,2018-05-01,3538,254,3284,11,4
Dengue,Srinagar,Jammu & Kashmir,2018-06-01,3567,217,3350,134,8
Dengue,Srinagar,Jammu & Kashmir,2018-07-01,2391,112,2279,51,2
Dengue,Srinagar,Jammu & Kashmir,2018-08-01,3025,67,2958,156,1
Dengue,Srinagar,Jammu & Kashmir,2018-09-01,1142,82,1060,138,6
Dengue,Srinagar,Jammu & Kashmir,2018-10-01,4300,99,4201,181,3
Dengue,Srinagar,Jammu & Kashmir,2018-11-01,78,0,78,116,10
Dengue,Srinagar,Jammu & Kashmir,2018-12-01,2480,120,2360,148,5
Dengue,Srinagar,Jammu & Kashmir,2019-01-01,4128,181,3947,108,8
Dengue,Srinagar,Jammu & Kashmir,2019-02-01,768,29,739,76,1
Dengue,Srinagar,Jammu & Kashmir,2019-03-01,3134,81,3053,161,6
Dengue,Srinagar,Jammu & Kashmir,2019-04-01,1684,5,1679,44,2
Dengue,Srinagar,Jammu & Kashmir,2019-05-01,2103,191,1912,104,4
Dengue,Srinagar,Jammu & Kashmir,2019-06-01,3866,138,3728,77,3
Dengue,Srinagar,Jammu & Kashmir,2019-07-01,2863,132,2731,149,8
Dengue,Srinagar,Jammu & Kashmir,2019-08-01,78,0,78,58,6
Dengue,Srinagar,Jammu & Kashmir,2019-09-01,1288,105,1183,85,5
Dengue,Srinagar,Jammu & Kashmir,2019-10-01,3906,415,3491,108,9
Dengue,Srinagar,Jammu & Kashmir,2019-11-01,3200,175,3025,182,5
Dengue,Srinagar,Jammu & Kashmir,2019-12-01,4943,224,4719,79,8
Dengue,Srinagar,Jammu & Kashmir,2020-01-01,4855,84,4771,86,10
Dengue,Srinagar,Jammu & Kashmir,2020-02-01,2138,17,2121,38,5
Dengue,Srinagar,Jammu & Kashmir,2020-03-01,4989,20,4969,56,6
Dengue,Srinagar,Jammu & Kashmir,2020-04-01,2630,70,2560,127,8
Dengue,Srinagar,Jammu & Kashmir,2020-05-01,1306,0,1306,108,9
Dengue,Srinagar,Jammu & Kashmir,2020-06-01,1747,142,1605,109,5
Dengue,Srinagar,Jammu & Kashmir,2020-07-01,78,0,78,195,3
Dengue,Srinagar,Jammu & Kashmir,2020-08-01,4753,203,4550,21,7
Dengue,Srinagar,Jammu & Kashmir,2020-09-01,4737,390,4347,200,6
Dengue,Srinagar,Jammu & Kashmir,2020-10-01,1235,23,1212,166,7
Dengue,Srinagar,Jammu & Kashmir,2020-11-01,2292,60,2232,90,7
Dengue,Srinagar,Jammu & Kashmir,2020-12-01,2726,0,2726,126,5
Dengue,Srinagar,Jammu & Kashmir,2021-01-01,1309,95,1214,71,6
Dengue,Srinagar,Jammu & Kashmir,2021-02-01,243,6,237,122,7
Dengue,Srinagar,Jammu & Kashmir,2021-03-01,2315,116,2199,200,1
Dengue,Srinagar,Jammu & Kashmir,2021-04-01,2167,171,1996,73,9
Dengue,Srinagar,Jammu & Kashmir,2021-05-01,2076,186,1890,94,6
Dengue,Srinagar,Jammu & Kashmir,2021-06-01,2896,142,2754,68,2
Dengue,Srinagar,Jammu & Kashmir,2021-07-01,4515,276,4239,76,5
Dengue,Srinagar,Jammu & Kashmir,2021-08-01,2191,52,2139,86,9
Dengue,Srinagar,Jammu & Kashmir,2021-09-01,2826,279,2547,50,6
Dengue,Srinagar,Jammu & Kashmir,2021-10-01,3573,161,3412,93,3
Dengue,Srinagar,Jammu & Kashmir,2021-11-01,3341,175,3166,109,1
Dengue,Srinagar,Jammu & Kashmir,2021-12-01,1773,67,1706,86,10
Dengue,Srinagar,Jammu & Kashmir,2022-01-01,2727,231,2496,11,1
Dengue,Srinagar,Jammu & Kashmir,2022-02-01,3332,186,3146,98,6
Dengue,Srinagar,Jammu & Kashmir,2022-03-01,1084,78,1006,104,3
Dengue,Srinagar,Jammu & Kashmir,2022-04-01,4292,259,4033,200,8
Dengue,Srinagar,Jammu & Kashmir,2022-05-01,4518,197,4321,108,1
Dengue,Srinagar,Jammu & Kashmir,2022-06-01,1628,125,1503,154,9
Dengue,Srinagar,Jammu & Kashmir,2022-07-01,2857,171,2686,85,4
Dengue,Srinagar,Jammu & Kashmir,2022-08-01,3459,76,3383,172,4
Dengue,Srinagar,Jammu & Kashmir,2022-09-01,1865,39,1826,58,4
Dengue,Srinagar,Jammu & Kashmir,2022-10-01,3243,176,3067,132,3
Dengue,Srinagar,Jammu & Kashmir,2022-11-01,2816,215,2601,149,4
Dengue,Srinagar,Jammu & Kashmir,2022-12-01,628,61,567,142,7
Dengue,Srinagar,Jammu & Kashmir,2023-01-01,3213,0,3213,200,1
Dengue,Srinagar,Jammu & Kashmir,2023-02-01,1122,57,1065,76,3
Dengue,Srinagar,Jammu & Kashmir,2023-03-01,3857,248,3609,178,9
Dengue,Srinagar,Jammu & Kashmir,2023-04-01,1697,99,1598,165,5
Dengue,Srinagar,Jammu & Kashmir,2023-05-01,2381,189,2192,109,3
Dengue,Srinagar,Jammu & Kashmir,2023-06-01,4438,306,4132,200,1
Dengue,Srinagar,Jammu & Kashmir,2023-07-01,3263,69,3194,99,1
Dengue,Srinagar,Jammu & Kashmir,2023-08-01,1149,23,1126,107,8
Dengue,Srinagar,Jammu & Kashmir,2023-09-01,1236,73,1163,106,2
Dengue,Srinagar,Jammu & Kashmir,2023-10-01,1793,141,1652,41,7
Dengue,Srinagar,Jammu & Kashmir,2023-11-01,3127,169,2958,145,2
Dengue,Srinagar,Jammu & Kashmir,2023-12-01,3078,12,3066,137,4
Dengue,Srinagar,Jammu & Kashmir,2024-01-01,1466,28,1438,101,5
Dengue,Srinagar,Jammu & Kashmir,2024-02-01,1032,72,960,196,3
Dengue,Srinagar,Jammu & Kashmir,2024-03-01,2975,118,2857,84,5
Dengue,Srinagar,Jammu & Kashmir,2024-04-01,2353,125,2228,18,1
Dengue,Srinagar,Jammu & Kashmir,2024-05-01,4989,404,4585,200,5
Dengue,Srinagar,Jammu & Kashmir,2024-06-01,2647,39,2608,158,6
Dengue,Srinagar,Jammu & Kashmir,2024-07-01,4989,189,4800,138,2
Dengue,Srinagar,Jammu & Kashmir,2024-08-01,1027,35,992,89,5
Dengue,Srinagar,Jammu & Kashmir,2024-09-01,487,29,458,124,5
Dengue,Srinagar,Jammu & Kashmir,2024-10-01,1095,79,1016,42,5
Dengue,Srinagar,Jammu & Kashmir,2024-11-01,4193,29,4164,95,1
Dengue,Srinagar,Jammu & Kashmir,2024-12-01,4953,247,4706,60,5
Dengue,Srinagar,Jammu & Kashmir,2025-01-01,1548,116,1432,120,1
Dengue,Srinagar,Jammu & Kashmir,2025-02-01,1980,0,1980,153,3
Dengue,Srinagar,Jammu & Kashmir,2025-03-01,1029,49,980,53,5
Dengue,Srinagar,Jammu & Kashmir,2025-04-01,167,2,165,143,5
Dengue,Srinagar,Jammu & Kashmir,2025-05-01,3561,111,3450,116,1
Dengue,Srinagar,Jammu & Kashmir,2025-06-01,2897,0,2897,141,4
Dengue,Srinagar,Jammu & Kashmir,2025-07-01,2611,236,2375,94,7
Dengue,Srinagar,Jammu & Kashmir,2025-08-01,719,28,691,142,2
Dengue,Srinagar,Jammu & Kashmir,2025-09-01,4797,127,4670,71,1
Dengue,Srinagar,Jammu & Kashmir,2025-10-01,1922,114,1808,21,6
Dengue,Srinagar,Jammu & Kashmir,2025-11-01,3313,65,3248,32,2
Dengue,Srinagar,Jammu & Kashmir,2025-12-01,646,10,636,81,3
Dengue,Srinagar,Haryana,2018-01-01,2342,220,2122,24,5
Dengue,Srinagar,Haryana,2018-02-01,2988,306,2682,185,5
Dengue,Srinagar,Haryana,2018-03-01,3036,99,2937,102,8
Dengue,Srinagar,Haryana,2018-04-01,2805,227,2578,153,4
Dengue,Srinagar,Haryana,2018-05-01,3261,197,3064,146,5
Dengue,Srinagar,Haryana,2018-06-01,1081,9,1072,107,1
Dengue,Srinagar,Haryana,2018-07-01,2862,65,2797,200,7
Dengue,Srinagar,Haryana,2018-08-01,2750,261,2489,200,3
Dengue,Srinagar,Haryana,2018-09-01,2908,24,2884,177,10
Dengue,Srinagar,Haryana,2018-10-01,2694,313,2381,60,4
Dengue,Srinagar,Haryana,2018-11-01,889,29,860,179,6
Dengue,Srinagar,Haryana,2018-12-01,830,79,751,17,7
Dengue,Srinagar,Haryana,2019-01-01,78,0,78,177,5
Dengue,Srinagar,Haryana,2019-02-01,3694,270,3424,11,6
Dengue,Srinagar,Haryana,2019-03-01,3708,336,3372,90,10
Dengue,Srinagar,Haryana,2019-04-01,3729,337,3392,168,3
Dengue,Srinagar,Haryana,2019-05-01,3009,99,2910,126,1
Dengue,Srinagar,Haryana,2019-06-01,78,0,78,31,1
Dengue,Srinagar,Haryana,2019-07-01,1220,58,1162,115,8
Dengue,Srinagar,Haryana,2019-08-01,2826,34,2792,126,3
Dengue,Srinagar,Haryana,2019-09-01,2779,158,2621,117,10
Dengue,Srinagar,Haryana,2019-10-01,2299,60,2239,85,7
Dengue,Srinagar,Haryana,2019-11-01,3092,252,2840,150,3
Dengue,Srinagar,Haryana,2019-12-01,2613,87,2526,165,3
Dengue,Srinagar,Haryana,2020-01-01,2759,0,2759,98,4
Dengue,Srinagar,Haryana,2020-02-01,1740,158,1582,184,1
Dengue,Srinagar,Haryana,2020-03-01,3915,216,3699,98,6
Dengue,Srinagar,Haryana,2020-04-01,2020,102,1918,81,7
Dengue,Srinagar,Haryana,2020-05-01,812,66,746,175,2
Dengue,Srinagar,Haryana,2020-06-01,1563,117,1446,173,1
Dengue,Srinagar,Haryana,2020-07-01,2130,59,2071,75,2
Dengue,Srinagar,Haryana,2020-08-01,3931,145,3786,67,8
Dengue,Srinagar,Haryana,2020-09-01,2541,44,2497,196,7
Dengue,Srinagar,Haryana,2020-10-01,2348,17,2331,101,5
Dengue,Srinagar,Haryana,2020-11-01,922,61,861,106,10
Dengue,Srinagar,Haryana,2020-12-01,3651,224,3427,93,1
Dengue,Srinagar,Haryana,2021-01-01,1723,124,1599,174,4
Dengue,Srinagar,Haryana,2021-02-01,2463,215,2248,200,6
Dengue,Srinagar,Haryana,2021-03-01,4583,332,4251,110,7
Dengue,Srinagar,Haryana,2021-04-01,3280,246,3034,200,7
Dengue,Srinagar,Haryana,2021-05-01,413,0,413,78,7
Dengue,Srinagar,Haryana,2021-06-01,224,9,215,92,9
Dengue,Srinagar,Haryana,2021-07-01,2511,196,2315,141,7
Dengue,Srinagar,Haryana,2021-08-01,971,15,956,65,1
Dengue,Srinagar,Haryana,2021-09-01,3467,182,3285,140,3
Dengue,Srinagar,Haryana,2021-10-01,2654,173,2481,80,1
Dengue,Srinagar,Haryana,2021-11-01,2819,177,2642,28,8
Dengue,Srinagar,Haryana,2021-12-01,1649,100,1549,17,8
Dengue,Srinagar,Haryana,2022-01-01,4933,332,4601,90,1
Dengue,Srinagar,Haryana,2022-02-01,4989,276,4713,127,4
Dengue,Srinagar,Haryana,2022-03-01,2224,16,2208,37,1
Dengue,Srinagar,Haryana,2022-04-01,3071,199,2872,115,4
Dengue,Srinagar,Haryana,2022-05-01,2728,159,2569,115,2
Dengue,Srinagar,Haryana,2022-06-01,2249,17,2232,98,1
Dengue,Srinagar,Haryana,2022-07-01,1481,133,1348,59,5
Dengue,Srinagar,Haryana,2022-08-01,1142,74,1068,118,10
Dengue,Srinagar,Haryana,2022-09-01,1074,10,1064,99,7
Dengue,Srinagar,Haryana,2022-10-01,3141,82,3059,156,4
Dengue,Srinagar,Haryana,2022-11-01,1900,63,1837,40,5
Dengue,Srinagar,Haryana,2022-12-01,78,0,78,112,10
Dengue,Srinagar,Haryana,2023-01-01,3194,187,3007,41,8
Dengue,Srinagar,Haryana,2023-02-01,2546,55,2491,94,4
Dengue,Srinagar,Haryana,2023-03-01,4404,365,4039,50,6
Dengue,Srinagar,Haryana,2023-04-01,3098,249,2849,59,2
Dengue,Srinagar,Haryana,2023-05-01,614,41,573,106,5
Dengue,Srinagar,Haryana,2023-06-01,78,0,78,77,7
Dengue,Srinagar,Haryana,2023-07-01,1632,126,1506,181,8
Dengue,Srinagar,Haryana,2023-08-01,1759,73,1686,166,3
Dengue,Srinagar,Haryana,2023-09-01,3863,111,3752,147,8
Dengue,Srinagar,Haryana,2023-10-01,2586,219,2367,146,5
Dengue,Srinagar,Haryana,2023-11-01,4118,244,3874,113,4
Dengue,Srinagar,Haryana,2023-12-01,820,24,796,173,10
Dengue,Srinagar,Haryana,2024-01-01,3892,147,3745,91,4
Dengue,Srinagar,Haryana,2024-02-01,3565,102,3463,200,2
Dengue,Srinagar,Haryana,2024-03-01,78,0,78,58,3
Dengue,Srinagar,Haryana,2024-04-01,4372,219,4153,49,7
Dengue,Srinagar,Haryana,2024-05-01,2723,148,2575,35,2
Dengue,Srinagar,Haryana,2024-06-01,3123,221,2902,44,7
Dengue,Srinagar,Haryana,2024-07-01,1437,21,1416,23,2
Dengue,Srinagar,Haryana,2024-08-01,4308,353,3955,117,5
Dengue,Srinagar,Haryana,2024-09-01,1007,32,975,150,10
Dengue,Srinagar,Haryana,2024-10-01,3714,383,3331,108,2
Dengue,Srinagar,Haryana,2024-11-01,3698,151,3547,36,1
Dengue,Srinagar,Haryana,2024-12-01,1291,103,1188,82,9
Dengue,Srinagar,Haryana,2025-01-01,4989,20,4969,149,1
Dengue,Srinagar,Haryana,2025-02-01,2908,46,2862,89,2
Dengue,Srinagar,Haryana,2025-03-01,3475,144,3331,66,7
Dengue,Srinagar,Haryana,2025-04-01,549,0,549,29,7
Dengue,Srinagar,Haryana,2025-05-01,4989,337,4652,85,1
Dengue,Srinagar,Haryana,2025-06-01,955,56,899,70,4
Dengue,Srinagar,Haryana,2025-07-01,3972,84,3888,102,7
Dengue,Srinagar,Haryana,2025-08-01,1263,62,1201,130,10
Dengue,Srinagar,Haryana,2025-09-01,1767,129,1638,92,1
Dengue,Srinagar,Haryana,2025-10-01,3656,0,3656,116,8
Dengue,Srinagar,Haryana,2025-11-01,3976,51,3925,130,3
Dengue,Srinagar,Haryana,2025-12-01,892,35,857,44,8
Dengue,Gurugram,Punjab,2018-01-01,4060,206,3854,200,2
Dengue,Gurugram,Punjab,2018-02-01,3999,193,3806,68,4
Dengue,Gurugram,Punjab,2018-03-01,1339,101,1238,133,6
Dengue,Gurugram,Punjab,2018-04-01,4742,303,4439,48,8
Dengue,Gurugram,Punjab,2018-05-01,643,45,598,112,6
Dengue,Gurugram,Punjab,2018-06-01,1759,16,1743,114,4
Dengue,Gurugram,Punjab,2018-07-01,3240,175,3065,191,3
Dengue,Gurugram,Punjab,2018-08-01,1452,59,1393,94,10
Dengue,Gurugram,Punjab,2018-09-01,2951,273,2678,172,6
Dengue,Gurugram,Punjab,2018-10-01,2921,161,2760,121,3
Dengue,Gurugram,Punjab,2018-11-01,2346,71,2275,200,6
Dengue,Gurugram,Punjab,2018-12-01,3714,278,3436,16,7
Dengue,Gurugram,Punjab,2019-01-01,2291,152,2139,131,1
Dengue,Gurugram,Punjab,2019-02-01,2908,76,2832,11,6
Dengue,Gurugram,Punjab,2019-03-01,4135,165,3970,103,1
Dengue,Gurugram,Punjab,2019-04-01,3658,147,3511,158,3
Dengue,Gurugram,Punjab,2019-05-01,3652,313,3339,180,2
Dengue,Gurugram,Punjab,2019-06-01,1056,59,997,144,4
Dengue,Gurugram,Punjab,2019-07-01,3301,235,3066,91,4
Dengue,Gurugram,Punjab,2019-08-01,1419,50,1369,134,4
Dengue,Gurugram,Punjab,2019-09-01,878,52,826,200,1
Dengue,Gurugram,Punjab,2019-10-01,2501,220,2281,110,5
Dengue,Gurugram,Punjab,2019-11-01,1384,54,1330,155,2
Dengue,Gurugram,Punjab,2019-12-01,3658,195,3463,84,10
Dengue,Gurugram,Punjab,2020-01-01,3690,38,3652,161,4
Dengue,Gurugram,Punjab,2020-02-01,78,0,78,152,4
Dengue,Gurugram,Punjab,2020-03-01,1486,59,1427,75,7
Dengue,Gurugram,Punjab,2020-04-01,639,12,627,146,9
Dengue,Gurugram,Punjab,2020-05-01,1977,175,1802,148,1
Dengue,Gurugram,Punjab,2020-06-01,3208,82,3126,144,6
Dengue,Gurugram,Punjab,2020-07-01,2272,165,2107,104,8
Dengue,Gurugram,Punjab,2020-08-01,1806,100,1706,169,5
Dengue,Gurugram,Punjab,2020-09-01,4342,221,4121,59,5
Dengue,Gurugram,Punjab,2020-10-01,78,0,78,107,3
Dengue,Gurugram,Punjab,2020-11-01,4257,0,4257,112,4
Dengue,Gurugram,Punjab,2020-12-01,1867,82,1785,166,5
Dengue,Gurugram,Punjab,2021-01-01,2493,46,2447,57,4
Dengue,Gurugram,Punjab,2021-02-01,1890,0,1890,118,7
Dengue,Gurugram,Punjab,2021-03-01,4667,71,4596,81,2
Dengue,Gurugram,Punjab,2021-04-01,946,47,899,112,7
Dengue,Gurugram,Punjab,2021-05-01,2613,75,2538,126,9
Dengue,Gurugram,Punjab,2021-06-01,3305,251,3054,41,6
Dengue,Gurugram,Punjab,2021-07-01,436,19,417,171,1
Dengue,Gurugram,Punjab,2021-08-01,1363,55,1308,128,7
Dengue,Gurugram,Punjab,2021-09-01,2399,97,2302,62,3
Dengue,Gurugram,Punjab,2021-10-01,1408,66,1342,89,3
Dengue,Gurugram,Punjab,2021-11-01,1503,56,1447,182,6
Dengue,Gurugram,Punjab,2021-12-01,2128,53,2075,127,8
Dengue,Gurugram,Punjab,2022-01-01,3469,273,3196,57,1
Dengue,Gurugram,Punjab,2022-02-01,2138,68,2070,66,5
Dengue,Gurugram,Punjab,2022-03-01,4044,157,3887,138,10
Dengue,Gurugram,Punjab,2022-04-01,1259,78,1181,144,2
Dengue,Gurugram,Punjab,2022-05-01,918,54,864,125,4
Dengue,Gurugram,Punjab,2022-06-01,4989,120,4869,91,3
Dengue,Gurugram,Punjab,2022-07-01,1715,123,1592,147,7
Dengue,Gurugram,Punjab,2022-08-01,839,55,784,90,1
Dengue,Gurugram,Punjab,2022-09-01,260,14,246,63,1
Dengue,Gurugram,Punjab,2022-10-01,4040,151,3889,187,7
Dengue,Gurugram,Punjab,2022-11-01,2140,81,2059,131,6
Dengue,Gurugram,Punjab,2022-12-01,2257,99,2158,66,1
Dengue,Gurugram,Punjab,2023-01-01,2384,33,2351,113,5
Dengue,Gurugram,Punjab,2023-02-01,3956,193,3763,108,1
Dengue,Gurugram,Punjab,2023-03-01,2357,179,2178,88,7
Dengue,Gurugram,Punjab,2023-04-01,4989,377,4612,118,6
Dengue,Gurugram,Punjab,2023-05-01,2777,108,2669,59,3
Dengue,Gurugram,Punjab,2023-06-01,4022,325,3697,151,3
Dengue,Gurugram,Punjab,2023-07-01,3678,388,3290,106,3
Dengue,Gurugram,Punjab,2023-08-01,2549,104,2445,24,2
Dengue,Gurugram,Punjab,2023-09-01,1810,127,1683,95,9
Dengue,Gurugram,Punjab,2023-10-01,3043,0,3043,75,8
Dengue,Gurugram,Punjab,2023-11-01,3282,44,3238,11,4
Dengue,Gurugram,Punjab,2023-12-01,1829,96,1733,98,4
Dengue,Gurugram,Punjab,2024-01-01,2821,58,2763,159,2
Dengue,Gurugram,Punjab,2024-02-01,4256,442,3814,101,4
Dengue,Gurugram,Punjab,2024-03-01,4989,336,4653,142,6
Dengue,Gurugram,Punjab,2024-04-01,3744,292,3452,107,8
Dengue,Gurugram,Punjab,2024-05-01,4989,245,4744,83,2
Dengue,Gurugram,Punjab,2024-06-01,1753,36,1717,69,1
Dengue,Gurugram,Punjab,2024-07-01,3539,123,3416,41,2
Dengue,Gurugram,Punjab,2024-08-01,4393,252,4141,153,6
Dengue,Gurugram,Punjab,2024-09-01,1395,43,1352,143,5
Dengue,Gurugram,Punjab,2024-10-01,1946,135,1811,92,8
Dengue,Gurugram,Punjab,2024-11-01,4929,348,4581,11,5
Dengue,Gurugram,Punjab,2024-12-01,1289,64,1225,130,10
Dengue,Gurugram,Punjab,2025-01-01,798,0,798,60,1
Dengue,Gurugram,Punjab,2025-02-01,4647,442,4205,114,1
Dengue,Gurugram,Punjab,2025-03-01,4203,184,4019,28,9
Dengue,Gurugram,Punjab,2025-04-01,3177,409,2768,111,3
Dengue,Gurugram,Punjab,2025-05-01,2536,175,2361,100,5
Dengue,Gurugram,Punjab,2025-06-01,2009,88,1921,11,5
Dengue,Gurugram,Punjab,2025-07-01,2976,187,2789,189,6
Dengue,Gurugram,Punjab,2025-08-01,4717,0,4717,90,3
Dengue,Gurugram,Punjab,2025-09-01,2917,233,2684,93,2
Dengue,Gurugram,Punjab,2025-10-01,4989,442,4547,133,2
Dengue,Gurugram,Punjab,2025-11-01,1393,0,1393,104,7
Dengue,Gurugram,Punjab,2025-12-01,2571,107,2464,125,7
Dengue,Gurugram,Chandigarh,2018-01-01,2097,98,1999,48,4
Dengue,Gurugram,Chandigarh,2018-02-01,1142,86,1056,99,3
Dengue,Gurugram,Chandigarh,2018-03-01,2392,266,2126,11,6
Dengue,Gurugram,Chandigarh,2018-04-01,3157,193,2964,94,1
Dengue,Gurugram,Chandigarh,2018-05-01,3301,371,2930,180,10
Dengue,Gurugram,Chandigarh,2018-06-01,4989,274,4715,29,6
Dengue,Gurugram,Chandigarh,2018-07-01,3220,203,3017,88,4
Dengue,Gurugram,Chandigarh,2018-08-01,4140,246,3894,11,7
Dengue,Gurugram,Chandigarh,2018-09-01,2686,229,2457,107,7
Dengue,Gurugram,Chandigarh,2018-10-01,4849,183,4666,130,6
Dengue,Gurugram,Chandigarh,2018-11-01,4989,368,4621,126,1
Dengue,Gurugram,Chandigarh,2018-12-01,3310,47,3263,76,6
Dengue,Gurugram,Chandigarh,2019-01-01,1266,52,1214,11,9
Dengue,Gurugram,Chandigarh,2019-02-01,1861,58,1803,43,3
Dengue,Gurugram,Chandigarh,2019-03-01,2976,156,2820,170,8
Dengue,Gurugram,Chandigarh,2019-04-01,3210,131,3079,151,7
Dengue,Gurugram,Chandigarh,2019-05-01,3534,293,3241,102,6
Dengue,Gurugram,Chandigarh,2019-06-01,3215,78,3137,114,5
Dengue,Gurugram,Chandigarh,2019-07-01,2607,0,2607,54,6
Dengue,Gurugram,Chandigarh,2019-08-01,1744,18,1726,172,6
Dengue,Gurugram,Chandigarh,2019-09-01,3136,247,2889,70,10
Dengue,Gurugram,Chandigarh,2019-10-01,4989,109,4880,128,8
Dengue,Gurugram,Chandigarh,2019-11-01,3966,244,3722,39,7
Dengue,Gurugram,Chandigarh,2019-12-01,3315,137,3178,97,8
Dengue,Gurugram,Chandigarh,2020-01-01,3979,294,3685,170,7
Dengue,Gurugram,Chandigarh,2020-02-01,2100,91,2009,58,1
Dengue,Gurugram,Chandigarh,2020-03-01,1916,250,1666,144,4
Dengue,Gurugram,Chandigarh,2020-04-01,1594,167,1427,51,3
Dengue,Gurugram,Chandigarh,2020-05-01,2429,99,2330,60,6
Dengue,Gurugram,Chandigarh,2020-06-01,2031,74,1957,106,3
Dengue,Gurugram,Chandigarh,2020-07-01,4218,442,3776,156,7
Dengue,Gurugram,Chandigarh,2020-08-01,1960,36,1924,91,4
Dengue,Gurugram,Chandigarh,2020-09-01,1521,73,1448,138,10
Dengue,Gurugram,Chandigarh,2020-10-01,4989,253,4736,164,10
Dengue,Gurugram,Chandigarh,2020-11-01,1992,99,1893,67,1
Dengue,Gurugram,Chandigarh,2020-12-01,2803,0,2803,29,6
Dengue,Gurugram,Chandigarh,2021-01-01,3203,206,2997,88,3
Dengue,Gurugram,Chandigarh,2021-02-01,1073,23,1050,171,6
Dengue,Gurugram,Chandigarh,2021-03-01,4255,390,3865,65,7
Dengue,Gurugram,Chandigarh,2021-04-01,3452,26,3426,158,1
Dengue,Gurugram,Chandigarh,2021-05-01,4688,242,4446,93,2
Dengue,Gurugram,Chandigarh,2021-06-01,1686,0,1686,196,2
Dengue,Gurugram,Chandigarh,2021-07-01,2730,0,2730,200,3
Dengue,Gurugram,Chandigarh,2021-08-01,2650,67,2583,159,3
Dengue,Gurugram,Chandigarh,2021-09-01,2951,87,2864,22,7
Dengue,Gurugram,Chandigarh,2021-10-01,646,59,587,11,5
Dengue,Gurugram,Chandigarh,2021-11-01,2746,134,2612,109,2
Dengue,Gurugram,Chandigarh,2021-12-01,684,59,625,152,4
Dengue,Gurugram,Chandigarh,2022-01-01,3078,120,2958,132,1
Dengue,Gurugram,Chandigarh,2022-02-01,78,0,78,69,10
Dengue,Gurugram,Chandigarh,2022-03-01,113,3,110,31,5
Dengue,Gurugram,Chandigarh,2022-04-01,3695,99,3596,154,8
Dengue,Gurugram,Chandigarh,2022-05-01,1864,0,1864,200,7
Dengue,Gurugram,Chandigarh,2022-06-01,1272,76,1196,72,5
Dengue,Gurugram,Chandigarh,2022-07-01,4302,248,4054,148,1
Dengue,Gurugram,Chandigarh,2022-08-01,3037,220,2817,200,3
Dengue,Gurugram,Chandigarh,2022-09-01,3767,212,3555,97,6
Dengue,Gurugram,Chandigarh,2022-10-01,2374,258,2116,98,5
Dengue,Gurugram,Chandigarh,2022-11-01,4989,275,4714,135,8
Dengue,Gurugram,Chandigarh,2022-12-01,1786,140,1646,92,5
Dengue,Gurugram,Chandigarh,2023-01-01,4938,200,4738,174,10
Dengue,Gurugram,Chandigarh,2023-02-01,2515,59,2456,86,2
Dengue,Gurugram,Chandigarh,2023-03-01,378,26,352,105,6
Dengue,Gurugram,Chandigarh,2023-04-01,3245,154,3091,33,2
Dengue,Gurugram,Chandigarh,2023-05-01,3020,224,2796,94,7
Dengue,Gurugram,Chandigarh,2023-06-01,1187,71,1116,55,3
Dengue,Gurugram,Chandigarh,2023-07-01,1360,36,1324,124,1
Dengue,Gurugram,Chandigarh,2023-08-01,2564,208,2356,21,1
Dengue,Gurugram,Chandigarh,2023-09-01,3067,75,2992,156,3
Dengue,Gurugram,Chandigarh,2023-10-01,78,0,78,62,9
Dengue,Gurugram,Chandigarh,2023-11-01,4010,350,3660,197,7
Dengue,Gurugram,Chandigarh,2023-12-01,1934,75,1859,176,6
Dengue,Gurugram,Chandigarh,2024-01-01,811,67,744,133,5
Dengue,Gurugram,Chandigarh,2024-02-01,3860,237,3623,28,2
Dengue,Gurugram,Chandigarh,2024-03-01,2566,192,2374,74,2
Dengue,Gurugram,Chandigarh,2024-04-01,4229,108,4121,61,3
Dengue,Gurugram,Chandigarh,2024-05-01,3185,179,3006,67,3
Dengue,Gurugram,Chandigarh,2024-06-01,2595,23,2572,187,3
Dengue,Gurugram,Chandigarh,2024-07-01,2393,239,2154,98,2
Dengue,Gurugram,Chandigarh,2024-08-01,3245,0,3245,73,5
Dengue,Gurugram,Chandigarh,2024-09-01,2043,81,1962,68,3
Dengue,Gurugram,Chandigarh,2024-10-01,1454,33,1421,79,8
Dengue,Gurugram,Chandigarh,2024-11-01,3416,238,3178,133,8
Dengue,Gurugram,Chandigarh,2024-12-01,2404,254,2150,23,7
Dengue,Gurugram,Chandigarh,2025-01-01,2642,182,2460,111,6
Dengue,Gurugram,Chandigarh,2025-02-01,4059,442,3617,128,1
Dengue,Gurugram,Chandigarh,2025-03-01,2445,24,2421,18,10
Dengue,Gurugram,Chandigarh,2025-04-01,2618,31,2587,34,4
Dengue,Gurugram,Chandigarh,2025-05-01,1793,43,1750,104,7
Dengue,Gurugram,Chandigarh,2025-06-01,3175,170,3005,180,7
Dengue,Gurugram,Chandigarh,2025-07-01,3067,61,3006,167,2
Dengue,Gurugram,Chandigarh,2025-08-01,3806,107,3699,75,3
Dengue,Gurugram,Chandigarh,2025-09-01,1821,124,1697,178,6
Dengue,Gurugram,Chandigarh,2025-10-01,1983,27,1956,90,1
Dengue,Gurugram,Chandigarh,2025-11-01,3660,62,3598,89,5
Dengue,Gurugram,Chandigarh,2025-12-01,2936,112,2824,111,1
Dengue,Gurugram,Himachal Pradesh,2018-01-01,1382,56,1326,149,5
Dengue,Gurugram,Himachal Pradesh,2018-02-01,4350,345,4005,75,9
Dengue,Gurugram,Himachal Pradesh,2018-03-01,319,7,312,86,5
Dengue,Gurugram,Himachal Pradesh,2018-04-01,3650,106,3544,43,1
Dengue,Gurugram,Himachal Pradesh,2018-05-01,900,60,840,124,3
Dengue,Gurugram,Himachal Pradesh,2018-06-01,4989,366,4623,154,7
Dengue,Gurugram,Himachal Pradesh,2018-07-01,525,48,477,157,5
Dengue,Gurugram,Himachal Pradesh,2018-08-01,4143,264,3879,37,6
Dengue,Gurugram,Himachal Pradesh,2018-09-01,2488,134,2354,87,4
Dengue,Gurugram,Himachal Pradesh,2018-10-01,2106,140,1966,170,3
Dengue,Gurugram,Himachal Pradesh,2018-11-01,2846,120,2726,118,5
Dengue,Gurugram,Himachal Pradesh,2018-12-01,3445,144,3301,108,5
Dengue,Gurugram,Himachal Pradesh,2019-01-01,1384,0,1384,107,8
Dengue,Gurugram,Himachal Pradesh,2019-02-01,1503,114,1389,134,3
Dengue,Gurugram,Himachal Pradesh,2019-03-01,3469,195,3274,121,5
Dengue,Gurugram,Himachal Pradesh,2019-04-01,307,22,285,77,4
Dengue,Gurugram,Himachal Pradesh,2019-05-01,1814,0,1814,151,10
Dengue,Gurugram,Himachal Pradesh,2019-06-01,4989,242,4747,45,3
Dengue,Gurugram,Himachal Pradesh,2019-07-01,1299,32,1267,174,4
Dengue,Gurugram,Himachal Pradesh,2019-08-01,4137,387,3750,61,2
Dengue,Gurugram,Himachal Pradesh,2019-09-01,1811,123,1688,134,9
Dengue,Gurugram,Himachal Pradesh,2019-10-01,3280,186,3094,98,9
Dengue,Gurugram,Himachal Pradesh,2019-11-01,3475,130,3345,82,4
Dengue,Gurugram,Himachal Pradesh,2019-12-01,4112,253,3859,175,8
Dengue,Gurugram,Himachal Pradesh,2020-01-01,2329,53,2276,144,6
Dengue,Gurugram,Himachal Pradesh,2020-02-01,4989,235,4754,103,7
Dengue,Gurugram,Himachal Pradesh,2020-03-01,1807,60,1747,195,2
Dengue,Gurugram,Himachal Pradesh,2020-04-01,2912,337,2575,156,5
Dengue,Gurugram,Himachal Pradesh,2020-05-01,2926,271,2655,65,10
Dengue,Gurugram,Himachal Pradesh,2020-06-01,1092,88,1004,11,9
Dengue,Gurugram,Himachal Pradesh,2020-07-01,2214,14,2200,112,7
Dengue,Gurugram,Himachal Pradesh,2020-08-01,2814,211,2603,177,8
Dengue,Gurugram,Himachal Pradesh,2020-09-01,2018,112,1906,137,10
Dengue,Gurugram,Himachal Pradesh,2020-10-01,4989,427,4562,186,7
Dengue,Gurugram,Himachal Pradesh,2020-11-01,1472,87,1385,76,3
Dengue,Gurugram,Himachal Pradesh,2020-12-01,4180,208,3972,100,8
Dengue,Gurugram,Himachal Pradesh,2021-01-01,3746,213,3533,101,5
Dengue,Gurugram,Himachal Pradesh,2021-02-01,2579,0,2579,118,6
Dengue,Gurugram,Himachal Pradesh,2021-03-01,1437,39,1398,145,5
Dengue,Gurugram,Himachal Pradesh,2021-04-01,1567,95,1472,189,3
Dengue,Gurugram,Himachal Pradesh,2021-05-01,1903,158,1745,200,6
Dengue,Gurugram,Himachal Pradesh,2021-06-01,202,6,196,191,8
Dengue,Gurugram,Himachal Pradesh,2021-07-01,1251,61,1190,140,7
Dengue,Gurugram,Himachal Pradesh,2021-08-01,609,2,607,89,6
Dengue,Gurugram,Himachal Pradesh,2021-09-01,4403,407,3996,118,4
Dengue,Gurugram,Himachal Pradesh,2021-10-01,3427,282,3145,140,1
Dengue,Gurugram,Himachal Pradesh,2021-11-01,3652,252,3400,113,5
Dengue,Gurugram,Himachal Pradesh,2021-12-01,3387,209,3178,60,6
Dengue,Gurugram,Himachal Pradesh,2022-01-01,2821,268,2553,83,1
Dengue,Gurugram,Himachal Pradesh,2022-02-01,4557,121,4436,150,5
Dengue,Gurugram,Himachal Pradesh,2022-03-01,1778,41,1737,94,5
Dengue,Gurugram,Himachal Pradesh,2022-04-01,2741,221,2520,107,2
Dengue,Gurugram,Himachal Pradesh,2022-05-01,3600,284,3316,102,7
Dengue,Gurugram,Himachal Pradesh,2022-06-01,825,12,813,61,8
Dengue,Gurugram,Himachal Pradesh,2022-07-01,4989,172,4817,97,10
Dengue,Gurugram,Himachal Pradesh,2022-08-01,2636,261,2375,83,5
Dengue,Gurugram,Himachal Pradesh,2022-09-01,2788,173,2615,71,9
Dengue,Gurugram,Himachal Pradesh,2022-10-01,4284,312,3972,52,2
Dengue,Gurugram,Himachal Pradesh,2022-11-01,3825,62,3763,101,4
Dengue,Gurugram,Himachal Pradesh,2022-12-01,2648,183,2465,138,7
Dengue,Gurugram,Himachal Pradesh,2023-01-01,2772,24,2748,163,3
Dengue,Gurugram,Himachal Pradesh,2023-02-01,580,0,580,35,4
Dengue,Gurugram,Himachal Pradesh,2023-03-01,1851,131,1720,188,7
Dengue,Gurugram,Himachal Pradesh,2023-04-01,3291,302,2989,121,5
Dengue,Gurugram,Himachal Pradesh,2023-05-01,3193,136,3057,49,2
Dengue,Gurugram,Himachal Pradesh,2023-06-01,4236,144,4092,86,3
Dengue,Gurugram,Himachal Pradesh,2023-07-01,2436,243,2193,11,4
Dengue,Gurugram,Himachal Pradesh,2023-08-01,736,32,704,24,7
Dengue,Gurugram,Himachal Pradesh,2023-09-01,4015,193,3822,194,4
Dengue,Gurugram,Himachal Pradesh,2023-10-01,4524,442,4082,71,1
Dengue,Gurugram,Himachal Pradesh,2023-11-01,3802,151,3651,134,7
Dengue,Gurugram,Himachal Pradesh,2023-12-01,2378,73,2305,101,7
Dengue,Gurugram,Himachal Pradesh,2024-01-01,3998,295,3703,107,2
Dengue,Gurugram,Himachal Pradesh,2024-02-01,4989,146,4843,125,2
Dengue,Gurugram,Himachal Pradesh,2024-03-01,2752,126,2626,11,9
Dengue,Gurugram,Himachal Pradesh,2024-04-01,838,9,829,173,4
Dengue,Gurugram,Himachal Pradesh,2024-05-01,1811,100,1711,101,7
Dengue,Gurugram,Himachal Pradesh,2024-06-01,3436,178,3258,81,3
Dengue,Gurugram,Himachal Pradesh,2024-07-01,445,34,411,130,7
Dengue,Gurugram,Himachal Pradesh,2024-08-01,2825,211,2614,69,2
Dengue,Gurugram,Himachal Pradesh,2024-09-01,3108,205,2903,117,6
Dengue,Gurugram,Himachal Pradesh,2024-10-01,4657,286,4371,98,6
Dengue,Gurugram,Himachal Pradesh,2024-11-01,4355,208,4147,142,1
Dengue,Gurugram,Himachal Pradesh,2024-12-01,3757,254,3503,95,5
Dengue,Gurugram,Himachal Pradesh,2025-01-01,78,0,78,54,3
Dengue,Gurugram,Himachal Pradesh,2025-02-01,3833,0,3833,125,8
Dengue,Gurugram,Himachal Pradesh,2025-03-01,3544,297,3247,92,6
Dengue,Gurugram,Himachal Pradesh,2025-04-01,2941,204,2737,13,4
Dengue,Gurugram,Himachal Pradesh,2025-05-01,276,12,264,116,9
Dengue,Gurugram,Himachal Pradesh,2025-06-01,1555,126,1429,79,1
Dengue,Gurugram,Himachal Pradesh,2025-07-01,1032,29,1003,124,10
Dengue,Gurugram,Himachal Pradesh,2025-08-01,78,0,78,63,10
Dengue,Gurugram,Himachal Pradesh,2025-09-01,2593,66,2527,45,4
Dengue,Gurugram,Himachal Pradesh,2025-10-01,1527,101,1426,166,7
Dengue,Gurugram,Himachal Pradesh,2025-11-01,4989,20,4969,149,6
Dengue,Gurugram,Himachal Pradesh,2025-12-01,2371,65,2306,106,1
Dengue,Gurugram,Jammu & Kashmir,2018-01-01,4333,253,4080,129,4
Dengue,Gurugram,Jammu & Kashmir,2018-02-01,492,7,485,147,1
Dengue,Gurugram,Jammu & Kashmir,2018-03-01,1886,58,1828,106,1
Dengue,Gurugram,Jammu & Kashmir,2018-04-01,2727,0,2727,45,4
Dengue,Gurugram,Jammu & Kashmir,2018-05-01,1379,93,1286,121,4
Dengue,Gurugram,Jammu & Kashmir,2018-06-01,2031,61,1970,157,8
Dengue,Gurugram,Jammu & Kashmir,2018-07-01,2305,41,2264,136,3
Dengue,Gurugram,Jammu & Kashmir,2018-08-01,2284,28,2256,109,4
Dengue,Gurugram,Jammu & Kashmir,2018-09-01,4989,189,4800,135,9
Dengue,Gurugram,Jammu & Kashmir,2018-10-01,3105,12,3093,95,4
Dengue,Gurugram,Jammu & Kashmir,2018-11-01,3241,345,2896,159,3
Dengue,Gurugram,Jammu & Kashmir,2018-12-01,3321,0,3321,175,7
Dengue,Gurugram,Jammu & Kashmir,2019-01-01,3419,126,3293,40,6
Dengue,Gurugram,Jammu & Kashmir,2019-02-01,2486,132,2354,163,5
Dengue,Gurugram,Jammu & Kashmir,2019-03-01,2167,59,2108,200,8
Dengue,Gurugram,Jammu & Kashmir,2019-04-01,2821,158,2663,133,1
Dengue,Gurugram,Jammu & Kashmir,2019-05-01,4149,111,4038,156,3
Dengue,Gurugram,Jammu & Kashmir,2019-06-01,4108,388,3720,73,10
Dengue,Gurugram,Jammu & Kashmir,2019-07-01,2275,39,2236,81,1
Dengue,Gurugram,Jammu & Kashmir,2019-08-01,3627,0,3627,96,3
Dengue,Gurugram,Jammu & Kashmir,2019-09-01,2336,28,2308,86,1
Dengue,Gurugram,Jammu & Kashmir,2019-10-01,2643,162,2481,39,5
Dengue,Gurugram,Jammu & Kashmir,2019-11-01,1962,91,1871,97,7
Dengue,Gurugram,Jammu & Kashmir,2019-12-01,2354,169,2185,149,8
Dengue,Gurugram,Jammu & Kashmir,2020-01-01,4397,284,4113,40,4
Dengue,Gurugram,Jammu & Kashmir,2020-02-01,2721,85,2636,115,2
Dengue,Gurugram,Jammu & Kashmir,2020-03-01,2779,99,2680,114,1
Dengue,Gurugram,Jammu & Kashmir,2020-04-01,656,25,631,91,5
Dengue,Gurugram,Jammu & Kashmir,2020-05-01,2183,229,1954,132,10
Dengue,Gurugram,Jammu & Kashmir,2020-06-01,2274,159,2115,127,3
Dengue,Gurugram,Jammu & Kashmir,2020-07-01,1485,156,1329,87,5
Dengue,Gurugram,Jammu & Kashmir,2020-08-01,2626,195,2431,160,5
Dengue,Gurugram,Jammu & Kashmir,2020-09-01,2022,97,1925,135,4
Dengue,Gurugram,Jammu & Kashmir,2020-10-01,2705,55,2650,186,9
Dengue,Gurugram,Jammu & Kashmir,2020-11-01,2760,154,2606,103,8
Dengue,Gurugram,Jammu & Kashmir,2020-12-01,1315,63,1252,90,7
Dengue,Gurugram,Jammu & Kashmir,2021-01-01,2063,97,1966,96,8
Dengue,Gurugram,Jammu & Kashmir,2021-02-01,2701,118,2583,166,3
Dengue,Gurugram,Jammu & Kashmir,2021-03-01,4186,0,4186,99,1
Dengue,Gurugram,Jammu & Kashmir,2021-04-01,2942,255,2687,102,3
Dengue,Gurugram,Jammu & Kashmir,2021-05-01,1709,83,1626,200,6
Dengue,Gurugram,Jammu & Kashmir,2021-06-01,3133,27,3106,38,4
Dengue,Gurugram,Jammu & Kashmir,2021-07-01,4888,313,4575,124,6
Dengue,Gurugram,Jammu & Kashmir,2021-08-01,3827,96,3731,103,5
Dengue,Gurugram,Jammu & Kashmir,2021-09-01,3332,221,3111,93,1
Dengue,Gurugram,Jammu & Kashmir,2021-10-01,3571,270,3301,58,8
Dengue,Gurugram,Jammu & Kashmir,2021-11-01,4529,361,4168,72,3
Dengue,Gurugram,Jammu & Kashmir,2021-12-01,4040,183,3857,85,7
Dengue,Gurugram,Jammu & Kashmir,2022-01-01,3358,127,3231,131,2
Dengue,Gurugram,Jammu & Kashmir,2022-02-01,4031,128,3903,150,2
Dengue,Gurugram,Jammu & Kashmir,2022-03-01,1146,33,1113,16,2
Dengue,Gurugram,Jammu & Kashmir,2022-04-01,582,28,554,45,1
Dengue,Gurugram,Jammu & Kashmir,2022-05-01,2808,123,2685,134,1
Dengue,Gurugram,Jammu & Kashmir,2022-06-01,2690,70,2620,138,6
Dengue,Gurugram,Jammu & Kashmir,2022-07-01,1868,31,1837,32,2
Dengue,Gurugram,Jammu & Kashmir,2022-08-01,3705,173,3532,151,6
Dengue,Gurugram,Jammu & Kashmir,2022-09-01,98,3,95,105,5
Dengue,Gurugram,Jammu & Kashmir,2022-10-01,1880,31,1849,144,7
Dengue,Gurugram,Jammu & Kashmir,2022-11-01,1947,144,1803,63,2
Dengue,Gurugram,Jammu & Kashmir,2022-12-01,402,40,362,35,8
Dengue,Gurugram,Jammu & Kashmir,2023-01-01,4603,359,4244,90,2
Dengue,Gurugram,Jammu & Kashmir,2023-02-01,774,22,752,93,1
Dengue,Gurugram,Jammu & Kashmir,2023-03-01,1808,87,1721,90,5
Dengue,Gurugram,Jammu & Kashmir,2023-04-01,3815,362,3453,86,2
Dengue,Gurugram,Jammu & Kashmir,2023-05-01,3464,55,3409,192,9
Dengue,Gurugram,Jammu & Kashmir,2023-06-01,1111,80,1031,20,6
Dengue,Gurugram,Jammu & Kashmir,2023-07-01,3513,27,3486,63,5
Dengue,Gurugram,Jammu & Kashmir,2023-08-01,2986,295,2691,85,5
Dengue,Gurugram,Jammu & Kashmir,2023-09-01,4989,187,4802,107,3
Dengue,Gurugram,Jammu & Kashmir,2023-10-01,3139,360,2779,142,10
Dengue,Gurugram,Jammu & Kashmir,2023-11-01,2408,241,2167,150,3
Dengue,Gurugram,Jammu & Kashmir,2023-12-01,1448,68,1380,161,6
Dengue,Gurugram,Jammu & Kashmir,2024-01-01,1599,46,1553,131,2
Dengue,Gurugram,Jammu & Kashmir,2024-02-01,1490,83,1407,18,5
Dengue,Gurugram,Jammu & Kashmir,2024-03-01,4437,198,4239,21,1
Dengue,Gurugram,Jammu & Kashmir,2024-04-01,2622,100,2522,165,5
Dengue,Gurugram,Jammu & Kashmir,2024-05-01,3356,6,3350,161,5
Dengue,Gurugram,Jammu & Kashmir,2024-06-01,4629,162,4467,139,6
Dengue,Gurugram,Jammu & Kashmir,2024-07-01,78,0,78,64,6
Dengue,Gurugram,Jammu & Kashmir,2024-08-01,4313,285,4028,90,5
Dengue,Gurugram,Jammu & Kashmir,2024-09-01,2672,210,2462,86,10
Dengue,Gurugram,Jammu & Kashmir,2024-10-01,3181,227,2954,54,5
Dengue,Gurugram,Jammu & Kashmir,2024-11-01,1486,89,1397,119,5
Dengue,Gurugram,Jammu & Kashmir,2024-12-01,1584,39,1545,200,5
Dengue,Gurugram,Jammu & Kashmir,2025-01-01,3253,182,3071,81,5
Dengue,Gurugram,Jammu & Kashmir,2025-02-01,4989,364,4625,172,4
Dengue,Gurugram,Jammu & Kashmir,2025-03-01,3943,130,3813,61,4
Dengue,Gurugram,Jammu & Kashmir,2025-04-01,4295,229,4066,28,7
Dengue,Gurugram,Jammu & Kashmir,2025-05-01,2340,107,2233,157,5
Dengue,Gurugram,Jammu & Kashmir,2025-06-01,1792,176,1616,95,8
Dengue,Gurugram,Jammu & Kashmir,2025-07-01,1550,116,1434,171,1
Dengue,Gurugram,Jammu & Kashmir,2025-08-01,1942,131,1811,181,9
Dengue,Gurugram,Jammu & Kashmir,2025-09-01,78,0,78,92,7
Dengue,Gurugram,Jammu & Kashmir,2025-10-01,1625,89,1536,175,5
Dengue,Gurugram,Jammu & Kashmir,2025-11-01,1846,84,1762,62,5
Dengue,Gurugram,Jammu & Kashmir,2025-12-01,2362,107,2255,61,7
Dengue,Gurugram,Haryana,2018-01-01,2774,12,2762,161,2
Dengue,Gurugram,Haryana,2018-02-01,3084,56,3028,27,5
Dengue,Gurugram,Haryana,2018-03-01,2577,123,2454,106,5
Dengue,Gurugram,Haryana,2018-04-01,1817,149,1668,170,1
Dengue,Gurugram,Haryana,2018-05-01,78,0,78,173,6
Dengue,Gurugram,Haryana,2018-06-01,1826,70,1756,84,1
Dengue,Gurugram,Haryana,2018-07-01,1293,131,1162,158,8
Dengue,Gurugram,Haryana,2018-08-01,3223,133,3090,49,9
Dengue,Gurugram,Haryana,2018-09-01,3817,176,3641,72,9
Dengue,Gurugram,Haryana,2018-10-01,3857,180,3677,118,4
Dengue,Gurugram,Haryana,2018-11-01,3613,39,3574,125,4
Dengue,Gurugram,Haryana,2018-12-01,2418,161,2257,53,1
Dengue,Gurugram,Haryana,2019-01-01,1897,58,1839,200,7
Dengue,Gurugram,Haryana,2019-02-01,1595,78,1517,11,1
Dengue,Gurugram,Haryana,2019-03-01,575,36,539,109,1
Dengue,Gurugram,Haryana,2019-04-01,3928,418,3510,116,4
Dengue,Gurugram,Haryana,2019-05-01,2363,27,2336,17,2
Dengue,Gurugram,Haryana,2019-06-01,925,69,856,174,2
Dengue,Gurugram,Haryana,2019-07-01,1489,112,1377,68,5
Dengue,Gurugram,Haryana,2019-08-01,1434,45,1389,111,7
Dengue,Gurugram,Haryana,2019-09-01,2655,179,2476,123,6
Dengue,Gurugram,Haryana,2019-10-01,4029,394,3635,32,5
Dengue,Gurugram,Haryana,2019-11-01,2131,59,2072,52,8
Dengue,Gurugram,Haryana,2019-12-01,78,0,78,186,5
Dengue,Gurugram,Haryana,2020-01-01,2344,144,2200,103,3
Dengue,Gurugram,Haryana,2020-02-01,2388,156,2232,11,3
Dengue,Gurugram,Haryana,2020-03-01,2296,166,2130,91,6
Dengue,Gurugram,Haryana,2020-04-01,1756,96,1660,105,2
Dengue,Gurugram,Haryana,2020-05-01,2889,187,2702,117,6
Dengue,Gurugram,Haryana,2020-06-01,2686,63,2623,11,4
Dengue,Gurugram,Haryana,2020-07-01,2564,140,2424,105,2
Dengue,Gurugram,Haryana,2020-08-01,3151,114,3037,64,2
Dengue,Gurugram,Haryana,2020-09-01,2021,28,1993,117,8
Dengue,Gurugram,Haryana,2020-10-01,1945,68,1877,132,2
Dengue,Gurugram,Haryana,2020-11-01,4449,257,4192,127,4
Dengue,Gurugram,Haryana,2020-12-01,3348,210,3138,178,3
Dengue,Gurugram,Haryana,2021-01-01,3707,48,3659,200,8
Dengue,Gurugram,Haryana,2021-02-01,4242,96,4146,48,9
Dengue,Gurugram,Haryana,2021-03-01,3303,235,3068,87,7
Dengue,Gurugram,Haryana,2021-04-01,3843,249,3594,144,4
Dengue,Gurugram,Haryana,2021-05-01,479,36,443,100,6
Dengue,Gurugram,Haryana,2021-06-01,2871,258,2613,11,2
Dengue,Gurugram,Haryana,2021-07-01,2352,154,2198,96,5
Dengue,Gurugram,Haryana,2021-08-01,4848,184,4664,169,1
Dengue,Gurugram,Haryana,2021-09-01,3842,205,3637,35,6
Dengue,Gurugram,Haryana,2021-10-01,1752,172,1580,117,5
Dengue,Gurugram,Haryana,2021-11-01,3098,404,2694,11,6
Dengue,Gurugram,Haryana,2021-12-01,2822,179,2643,151,5
Dengue,Gurugram,Haryana,2022-01-01,3207,210,2997,119,7
Dengue,Gurugram,Haryana,2022-02-01,1231,87,1144,77,3
Dengue,Gurugram,Haryana,2022-03-01,3080,156,2924,85,7
Dengue,Gurugram,Haryana,2022-04-01,2291,192,2099,30,6
Dengue,Gurugram,Haryana,2022-05-01,2976,236,2740,158,8
Dengue,Gurugram,Haryana,2022-06-01,1626,98,1528,65,8
Dengue,Gurugram,Haryana,2022-07-01,1813,73,1740,132,2
Dengue,Gurugram,Haryana,2022-08-01,4172,24,4148,57,6
Dengue,Gurugram,Haryana,2022-09-01,1187,84,1103,200,1
Dengue,Gurugram,Haryana,2022-10-01,1286,72,1214,186,8
Dengue,Gurugram,Haryana,2022-11-01,2528,72,2456,200,2
Dengue,Gurugram,Haryana,2022-12-01,1562,26,1536,200,4
Dengue,Gurugram,Haryana,2023-01-01,1410,97,1313,74,5
Dengue,Gurugram,Haryana,2023-02-01,2738,9,2729,61,7
Dengue,Gurugram,Haryana,2023-03-01,578,33,545,200,6
Dengue,Gurugram,Haryana,2023-04-01,1245,92,1153,99,7
Dengue,Gurugram,Haryana,2023-05-01,4989,329,4660,149,5
Dengue,Gurugram,Haryana,2023-06-01,3214,124,3090,75,6
Dengue,Gurugram,Haryana,2023-07-01,1596,21,1575,75,1
Dengue,Gurugram,Haryana,2023-08-01,3158,212,2946,148,8
Dengue,Gurugram,Haryana,2023-09-01,3358,285,3073,11,4
Dengue,Gurugram,Haryana,2023-10-01,3931,131,3800,146,4
Dengue,Gurugram,Haryana,2023-11-01,2427,157,2270,133,10
Dengue,Gurugram,Haryana,2023-12-01,3907,375,3532,79,1
Dengue,Gurugram,Haryana,2024-01-01,78,0,78,107,5
Dengue,Gurugram,Haryana,2024-02-01,1180,45,1135,115,1
Dengue,Gurugram,Haryana,2024-03-01,2817,226,2591,118,6
Dengue,Gurugram,Haryana,2024-04-01,3040,86,2954,141,3
Dengue,Gurugram,Haryana,2024-05-01,1374,16,1358,65,1
Dengue,Gurugram,Haryana,2024-06-01,2945,217,2728,200,8
Dengue,Gurugram,Haryana,2024-07-01,1761,67,1694,96,1
Dengue,Gurugram,Haryana,2024-08-01,2226,90,2136,100,8
Dengue,Gurugram,Haryana,2024-09-01,3972,126,3846,200,2
Dengue,Gurugram,Haryana,2024-10-01,3817,138,3679,13,3
Dengue,Gurugram,Haryana,2024-11-01,1260,114,1146,200,1
Dengue,Gurugram,Haryana,2024-12-01,1179,116,1063,111,6
Dengue,Gurugram,Haryana,2025-01-01,2046,209,1837,79,3
Dengue,Gurugram,Haryana,2025-02-01,2562,209,2353,49,4
Dengue,Gurugram,Haryana,2025-03-01,1715,109,1606,42,5
Dengue,Gurugram,Haryana,2025-04-01,3993,33,3960,89,1
Dengue,Gurugram,Haryana,2025-05-01,3063,136,2927,120,7
Dengue,Gurugram,Haryana,2025-06-01,3142,354,2788,138,3
Dengue,Gurugram,Haryana,2025-07-01,898,33,865,120,10
Dengue,Gurugram,Haryana,2025-08-01,4163,391,3772,80,3
Dengue,Gurugram,Haryana,2025-09-01,78,0,78,174,4
Dengue,Gurugram,Haryana,2025-10-01,3716,0,3716,200,1
Dengue,Gurugram,Haryana,2025-11-01,3851,264,3587,182,1
Dengue,Gurugram,Haryana,2025-12-01,2017,175,1842,88,7
Dengue,Faridabad,Punjab,2018-01-01,4305,209,4096,132,8
Dengue,Faridabad,Punjab,2018-02-01,2513,216,2297,135,3
Dengue,Faridabad,Punjab,2018-03-01,2681,4,2677,188,5
Dengue,Faridabad,Punjab,2018-04-01,3053,29,3024,89,8
Dengue,Faridabad,Punjab,2018-05-01,4989,279,4710,57,6
Dengue,Faridabad,Punjab,2018-06-01,4401,281,4120,164,6
Dengue,Faridabad,Punjab,2018-07-01,3538,316,3222,127,5
Dengue,Faridabad,Punjab,2018-08-01,1373,94,1279,50,3
Dengue,Faridabad,Punjab,2018-09-01,2790,42,2748,142,6
Dengue,Faridabad,Punjab,2018-10-01,1507,84,1423,200,10
Dengue,Faridabad,Punjab,2018-11-01,3700,249,3451,71,3
Dengue,Faridabad,Punjab,2018-12-01,2786,0,2786,61,7
Dengue,Faridabad,Punjab,2019-01-01,1089,53,1036,108,5
Dengue,Faridabad,Punjab,2019-02-01,2706,109,2597,141,3
Dengue,Faridabad,Punjab,2019-03-01,1458,45,1413,102,7
Dengue,Faridabad,Punjab,2019-04-01,2800,180,2620,164,7
Dengue,Faridabad,Punjab,2019-05-01,1445,24,1421,119,7
Dengue,Faridabad,Punjab,2019-06-01,2634,163,2471,158,10
Dengue,Faridabad,Punjab,2019-07-01,3604,239,3365,69,10
Dengue,Faridabad,Punjab,2019-08-01,2526,206,2320,44,5
Dengue,Faridabad,Punjab,2019-09-01,2073,36,2037,89,5
Dengue,Faridabad,Punjab,2019-10-01,2870,17,2853,38,1
Dengue,Faridabad,Punjab,2019-11-01,3533,205,3328,127,9
Dengue,Faridabad,Punjab,2019-12-01,1112,46,1066,11,5
Dengue,Faridabad,Punjab,2020-01-01,2947,396,2551,83,3
Dengue,Faridabad,Punjab,2020-02-01,4365,276,4089,92,2
Dengue,Faridabad,Punjab,2020-03-01,3367,174,3193,53,2
Dengue,Faridabad,Punjab,2020-04-01,2675,120,2555,91,10
Dengue,Faridabad,Punjab,2020-05-01,3456,50,3406,106,7
Dengue,Faridabad,Punjab,2020-06-01,3204,213,2991,171,1
Dengue,Faridabad,Punjab,2020-07-01,3608,172,3436,53,1
Dengue,Faridabad,Punjab,2020-08-01,78,0,78,124,5
Dengue,Faridabad,Punjab,2020-09-01,513,27,486,135,2
Dengue,Faridabad,Punjab,2020-10-01,3945,222,3723,105,4
Dengue,Faridabad,Punjab,2020-11-01,578,0,578,81,9
Dengue,Faridabad,Punjab,2020-12-01,3136,233,2903,48,8
Dengue,Faridabad,Punjab,2021-01-01,2125,54,2071,200,1
Dengue,Faridabad,Punjab,2021-02-01,1261,58,1203,110,2
Dengue,Faridabad,Punjab,2021-03-01,3066,268,2798,90,6
Dengue,Faridabad,Punjab,2021-04-01,2867,292,2575,200,8
Dengue,Faridabad,Punjab,2021-05-01,4989,20,4969,118,2
Dengue,Faridabad,Punjab,2021-06-01,1759,89,1670,200,6
Dengue,Faridabad,Punjab,2021-07-01,4529,262,4267,34,3
Dengue,Faridabad,Punjab,2021-08-01,3070,19,3051,94,10
Dengue,Faridabad,Punjab,2021-09-01,1711,125,1586,36,7
Dengue,Faridabad,Punjab,2021-10-01,3670,196,3474,100,4
Dengue,Faridabad,Punjab,2021-11-01,3356,187,3169,100,1
Dengue,Faridabad,Punjab,2021-12-01,2645,61,2584,83,2
Dengue,Faridabad,Punjab,2022-01-01,2955,183,2772,109,1
Dengue,Faridabad,Punjab,2022-02-01,1797,133,1664,85,6
Dengue,Faridabad,Punjab,2022-03-01,1490,80,1410,101,7
Dengue,Faridabad,Punjab,2022-04-01,3616,126,3490,68,7
Dengue,Faridabad,Punjab,2022-05-01,2297,85,2212,180,3
Dengue,Faridabad,Punjab,2022-06-01,2490,140,2350,50,9
Dengue,Faridabad,Punjab,2022-07-01,2973,153,2820,117,9
Dengue,Faridabad,Punjab,2022-08-01,2953,225,2728,45,3
Dengue,Faridabad,Punjab,2022-09-01,680,24,656,64,8
Dengue,Faridabad,Punjab,2022-10-01,4323,63,4260,69,5
Dengue,Faridabad,Punjab,2022-11-01,2760,167,2593,99,3
Dengue,Faridabad,Punjab,2022-12-01,2326,84,2242,115,8
Dengue,Faridabad,Punjab,2023-01-01,3175,231,2944,50,1
Dengue,Faridabad,Punjab,2023-02-01,2915,146,2769,85,1
Dengue,Faridabad,Punjab,2023-03-01,3626,250,3376,56,4
Dengue,Faridabad,Punjab,2023-04-01,3319,68,3251,53,4
Dengue,Faridabad,Punjab,2023-05-01,3560,193,3367,164,1
Dengue,Faridabad,Punjab,2023-06-01,4410,131,4279,35,6
Dengue,Faridabad,Punjab,2023-07-01,3783,55,3728,110,3
Dengue,Faridabad,Punjab,2023-08-01,2382,59,2323,193,1
Dengue,Faridabad,Punjab,2023-09-01,1091,37,1054,168,7
Dengue,Faridabad,Punjab,2023-10-01,4835,417,4418,128,4
Dengue,Faridabad,Punjab,2023-11-01,2278,76,2202,105,8
Dengue,Faridabad,Punjab,2023-12-01,1963,25,1938,144,6
Dengue,Faridabad,Punjab,2024-01-01,268,14,254,125,4
Dengue,Faridabad,Punjab,2024-02-01,3051,155,2896,179,8
Dengue,Faridabad,Punjab,2024-03-01,2797,99,2698,99,6
Dengue,Faridabad,Punjab,2024-04-01,565,25,540,157,5
Dengue,Faridabad,Punjab,2024-05-01,3205,251,2954,90,6
Dengue,Faridabad,Punjab,2024-06-01,1929,134,1795,200,6
Dengue,Faridabad,Punjab,2024-07-01,4989,334,4655,98,2
Dengue,Faridabad,Punjab,2024-08-01,1834,28,1806,24,10
Dengue,Faridabad,Punjab,2024-09-01,2014,270,1744,110,5
Dengue,Faridabad,Punjab,2024-10-01,1424,114,1310,145,5
Dengue,Faridabad,Punjab,2024-11-01,4312,280,4032,189,1
Dengue,Faridabad,Punjab,2024-12-01,2097,33,2064,55,5
Dengue,Faridabad,Punjab,2025-01-01,1625,126,1499,17,5
Dengue,Faridabad,Punjab,2025-02-01,3546,125,3421,132,1
Dengue,Faridabad,Punjab,2025-03-01,746,33,713,130,2
Dengue,Faridabad,Punjab,2025-04-01,3436,3,3433,34,2
Dengue,Faridabad,Punjab,2025-05-01,4987,69,4918,89,4
Dengue,Faridabad,Punjab,2025-06-01,3358,210,3148,92,5
Dengue,Faridabad,Punjab,2025-07-01,3453,274,3179,148,4
Dengue,Faridabad,Punjab,2025-08-01,3765,263,3502,85,6
Dengue,Faridabad,Punjab,2025-09-01,4891,337,4554,84,7
Dengue,Faridabad,Punjab,2025-10-01,4220,203,4017,112,6
Dengue,Faridabad,Punjab,2025-11-01,3187,121,3066,36,6
Dengue,Faridabad,Punjab,2025-12-01,3810,222,3588,200,6
Dengue,Faridabad,Chandigarh,2018-01-01,1409,104,1305,154,6
Dengue,Faridabad,Chandigarh,2018-02-01,3639,182,3457,70,4
Dengue,Faridabad,Chandigarh,2018-03-01,1248,106,1142,49,3
Dengue,Faridabad,Chandigarh,2018-04-01,2105,92,2013,53,5
Dengue,Faridabad,Chandigarh,2018-05-01,78,0,78,136,7
Dengue,Faridabad,Chandigarh,2018-06-01,3136,156,2980,55,7
Dengue,Faridabad,Chandigarh,2018-07-01,1734,92,1642,94,6
Dengue,Faridabad,Chandigarh,2018-08-01,4088,194,3894,20,3
Dengue,Faridabad,Chandigarh,2018-09-01,3121,272,2849,134,4
Dengue,Faridabad,Chandigarh,2018-10-01,4105,301,3804,136,4
Dengue,Faridabad,Chandigarh,2018-11-01,1144,9,1135,97,3
Dengue,Faridabad,Chandigarh,2018-12-01,3990,377,3613,116,7
Dengue,Faridabad,Chandigarh,2019-01-01,4989,20,4969,147,1
Dengue,Faridabad,Chandigarh,2019-02-01,3623,408,3215,115,10
Dengue,Faridabad,Chandigarh,2019-03-01,3658,152,3506,146,10
Dengue,Faridabad,Chandigarh,2019-04-01,2825,125,2700,47,5
Dengue,Faridabad,Chandigarh,2019-05-01,1894,91,1803,126,6
Dengue,Faridabad,Chandigarh,2019-06-01,3619,221,3398,116,7
Dengue,Faridabad,Chandigarh,2019-07-01,577,28,549,167,3
Dengue,Faridabad,Chandigarh,2019-08-01,2037,94,1943,108,6
Dengue,Faridabad,Chandigarh,2019-09-01,222,19,203,101,9
Dengue,Faridabad,Chandigarh,2019-10-01,1653,109,1544,78,1
Dengue,Faridabad,Chandigarh,2019-11-01,3459,76,3383,182,1
Dengue,Faridabad,Chandigarh,2019-12-01,3275,234,3041,11,7
Dengue,Faridabad,Chandigarh,2020-01-01,2666,174,2492,132,4
Dengue,Faridabad,Chandigarh,2020-02-01,2826,96,2730,105,4
Dengue,Faridabad,Chandigarh,2020-03-01,78,0,78,97,4
Dengue,Faridabad,Chandigarh,2020-04-01,2098,95,2003,89,2
Dengue,Faridabad,Chandigarh,2020-05-01,1683,73,1610,103,4
Dengue,Faridabad,Chandigarh,2020-06-01,1713,73,1640,131,1
Dengue,Faridabad,Chandigarh,2020-07-01,3402,0,3402,66,9
Dengue,Faridabad,Chandigarh,2020-08-01,1443,50,1393,113,5
Dengue,Faridabad,Chandigarh,2020-09-01,1786,126,1660,124,5
Dengue,Faridabad,Chandigarh,2020-10-01,78,0,78,58,7
Dengue,Faridabad,Chandigarh,2020-11-01,2203,27,2176,132,10
Dengue,Faridabad,Chandigarh,2020-12-01,1138,88,1050,124,2
Dengue,Faridabad,Chandigarh,2021-01-01,2704,111,2593,66,1
Dengue,Faridabad,Chandigarh,2021-02-01,1321,19,1302,46,5
Dengue,Faridabad,Chandigarh,2021-03-01,2738,312,2426,65,1
Dengue,Faridabad,Chandigarh,2021-04-01,2403,46,2357,113,4
Dengue,Faridabad,Chandigarh,2021-05-01,4840,366,4474,102,7
Dengue,Faridabad,Chandigarh,2021-06-01,3264,90,3174,177,9
Dengue,Faridabad,Chandigarh,2021-07-01,130,7,123,88,1
Dengue,Faridabad,Chandigarh,2021-08-01,901,21,880,61,2
Dengue,Faridabad,Chandigarh,2021-09-01,2671,37,2634,140,6
Dengue,Faridabad,Chandigarh,2021-10-01,1350,88,1262,56,7
Dengue,Faridabad,Chandigarh,2021-11-01,78,0,78,66,7
Dengue,Faridabad,Chandigarh,2021-12-01,4408,367,4041,67,9
Dengue,Faridabad,Chandigarh,2022-01-01,3564,174,3390,11,7
Dengue,Faridabad,Chandigarh,2022-02-01,3296,378,2918,135,4
Dengue,Faridabad,Chandigarh,2022-03-01,1783,103,1680,154,8
Dengue,Faridabad,Chandigarh,2022-04-01,3171,211,2960,153,5
Dengue,Faridabad,Chandigarh,2022-05-01,1653,17,1636,200,6
Dengue,Faridabad,Chandigarh,2022-06-01,2872,92,2780,183,3
Dengue,Faridabad,Chandigarh,2022-07-01,1362,88,1274,89,5
Dengue,Faridabad,Chandigarh,2022-08-01,4632,220,4412,163,1
Dengue,Faridabad,Chandigarh,2022-09-01,491,27,464,101,8
Dengue,Faridabad,Chandigarh,2022-10-01,4251,111,4140,85,2
Dengue,Faridabad,Chandigarh,2022-11-01,2650,142,2508,68,2
Dengue,Faridabad,Chandigarh,2022-12-01,1941,103,1838,93,1
Dengue,Faridabad,Chandigarh,2023-01-01,2821,44,2777,123,2
Dengue,Faridabad,Chandigarh,2023-02-01,3581,246,3335,187,2
Dengue,Faridabad,Chandigarh,2023-03-01,4431,2,4429,143,5
Dengue,Faridabad,Chandigarh,2023-04-01,3017,167,2850,67,1
Dengue,Faridabad,Chandigarh,2023-05-01,1403,142,1261,53,4
Dengue,Faridabad,Chandigarh,2023-06-01,2672,186,2486,135,3
Dengue,Faridabad,Chandigarh,2023-07-01,4989,347,4642,152,1
Dengue,Faridabad,Chandigarh,2023-08-01,4405,105,4300,169,6
Dengue,Faridabad,Chandigarh,2023-09-01,3817,387,3430,93,4
Dengue,Faridabad,Chandigarh,2023-10-01,3665,330,3335,130,5
Dengue,Faridabad,Chandigarh,2023-11-01,3536,90,3446,150,7
Dengue,Faridabad,Chandigarh,2023-12-01,4152,150,4002,37,5
Dengue,Faridabad,Chandigarh,2024-01-01,1985,171,1814,120,4
Dengue,Faridabad,Chandigarh,2024-02-01,780,79,701,152,8
Dengue,Faridabad,Chandigarh,2024-03-01,2690,35,2655,132,4
Dengue,Faridabad,Chandigarh,2024-04-01,1501,31,1470,102,3
Dengue,Faridabad,Chandigarh,2024-05-01,1182,54,1128,200,7
Dengue,Faridabad,Chandigarh,2024-06-01,1631,0,1631,200,3
Dengue,Faridabad,Chandigarh,2024-07-01,4989,252,4737,107,8
Dengue,Faridabad,Chandigarh,2024-08-01,2780,235,2545,97,5
Dengue,Faridabad,Chandigarh,2024-09-01,3083,25,3058,142,9
Dengue,Faridabad,Chandigarh,2024-10-01,958,51,907,103,5
Dengue,Faridabad,Chandigarh,2024-11-01,124,4,120,171,8
Dengue,Faridabad,Chandigarh,2024-12-01,1499,146,1353,42,1
Dengue,Faridabad,Chandigarh,2025-01-01,4527,151,4376,94,9
Dengue,Faridabad,Chandigarh,2025-02-01,3046,287,2759,141,7
Dengue,Faridabad,Chandigarh,2025-03-01,3400,111,3289,157,3
Dengue,Faridabad,Chandigarh,2025-04-01,3588,260,3328,31,7
Dengue,Faridabad,Chandigarh,2025-05-01,1804,103,1701,58,1
Dengue,Faridabad,Chandigarh,2025-06-01,4459,205,4254,21,3
Dengue,Faridabad,Chandigarh,2025-07-01,1748,47,1701,62,2
Dengue,Faridabad,Chandigarh,2025-08-01,4484,266,4218,41,7
Dengue,Faridabad,Chandigarh,2025-09-01,3191,118,3073,134,8
Dengue,Faridabad,Chandigarh,2025-10-01,197,5,192,118,4
Dengue,Faridabad,Chandigarh,2025-11-01,1594,148,1446,98,1
Dengue,Faridabad,Chandigarh,2025-12-01,203,13,190,108,2
Dengue,Faridabad,Himachal Pradesh,2018-01-01,4158,286,3872,167,5
Dengue,Faridabad,Himachal Pradesh,2018-02-01,2564,99,2465,53,5
Dengue,Faridabad,Himachal Pradesh,2018-03-01,78,0,78,11,4
Dengue,Faridabad,Himachal Pradesh,2018-04-01,3101,132,2969,142,2
Dengue,Faridabad,Himachal Pradesh,2018-05-01,1877,112,1765,86,10
Dengue,Faridabad,Himachal Pradesh,2018-06-01,607,41,566,54,3
Dengue,Faridabad,Himachal Pradesh,2018-07-01,4848,238,4610,134,2
Dengue,Faridabad,Himachal Pradesh,2018-08-01,2741,74,2667,11,8
Dengue,Faridabad,Himachal Pradesh,2018-09-01,2204,159,2045,63,4
Dengue,Faridabad,Himachal Pradesh,2018-10-01,2062,105,1957,11,6
Dengue,Faridabad,Himachal Pradesh,2018-11-01,567,4,563,119,2
Dengue,Faridabad,Himachal Pradesh,2018-12-01,847,0,847,186,6
Dengue,Faridabad,Himachal Pradesh,2019-01-01,4321,253,4068,77,7
Dengue,Faridabad,Himachal Pradesh,2019-02-01,1962,50,1912,66,2
Dengue,Faridabad,Himachal Pradesh,2019-03-01,2627,164,2463,197,3
Dengue,Faridabad,Himachal Pradesh,2019-04-01,78,0,78,138,2
Dengue,Faridabad,Himachal Pradesh,2019-05-01,829,44,785,200,3
Dengue,Faridabad,Himachal Pradesh,2019-06-01,3415,133,3282,114,9
Dengue,Faridabad,Himachal Pradesh,2019-07-01,3104,313,2791,118,6
Dengue,Faridabad,Himachal Pradesh,2019-08-01,4950,384,4566,180,10
Dengue,Faridabad,Himachal Pradesh,2019-09-01,4399,392,4007,99,9
Dengue,Faridabad,Himachal Pradesh,2019-10-01,2288,116,2172,119,8
Dengue,Faridabad,Himachal Pradesh,2019-11-01,3232,239,2993,11,9
Dengue,Faridabad,Himachal Pradesh,2019-12-01,2173,114,2059,195,8
Dengue,Faridabad,Himachal Pradesh,2020-01-01,4989,442,4547,126,10
Dengue,Faridabad,Himachal Pradesh,2020-02-01,4139,198,3941,101,6
Dengue,Faridabad,Himachal Pradesh,2020-03-01,2825,26,2799,152,7
Dengue,Faridabad,Himachal Pradesh,2020-04-01,2866,0,2866,46,7
Dengue,Faridabad,Himachal Pradesh,2020-05-01,4536,442,4094,78,4
Dengue,Faridabad,Himachal Pradesh,2020-06-01,3375,215,3160,134,7
Dengue,Faridabad,Himachal Pradesh,2020-07-01,4688,308,4380,108,8
Dengue,Faridabad,Himachal Pradesh,2020-08-01,78,0,78,129,3
Dengue,Faridabad,Himachal Pradesh,2020-09-01,3216,6,3210,119,2
Dengue,Faridabad,Himachal Pradesh,2020-10-01,1906,75,1831,138,3
Dengue,Faridabad,Himachal Pradesh,2020-11-01,4954,214,4740,39,9
Dengue,Faridabad,Himachal Pradesh,2020-12-01,4672,334,4338,171,4
Dengue,Faridabad,Himachal Pradesh,2021-01-01,2641,78,2563,82,2
Dengue,Faridabad,Himachal Pradesh,2021-02-01,4657,70,4587,109,2
Dengue,Faridabad,Himachal Pradesh,2021-03-01,4989,74,4915,76,2
Dengue,Faridabad,Himachal Pradesh,2021-04-01,2697,225,2472,92,3
Dengue,Faridabad,Himachal Pradesh,2021-05-01,4989,141,4848,118,1
Dengue,Faridabad,Himachal Pradesh,2021-06-01,2555,86,2469,144,7
Dengue,Faridabad,Himachal Pradesh,2021-07-01,2310,158,2152,152,4
Dengue,Faridabad,Himachal Pradesh,2021-08-01,3759,111,3648,128,6
Dengue,Faridabad,Himachal Pradesh,2021-09-01,2123,0,2123,76,1
Dengue,Faridabad,Himachal Pradesh,2021-10-01,2712,10,2702,125,8
Dengue,Faridabad,Himachal Pradesh,2021-11-01,4488,217,4271,118,5
Dengue,Faridabad,Himachal Pradesh,2021-12-01,2623,169,2454,109,6
Dengue,Faridabad,Himachal Pradesh,2022-01-01,324,14,310,133,9
Dengue,Faridabad,Himachal Pradesh,2022-02-01,3090,193,2897,41,6
Dengue,Faridabad,Himachal Pradesh,2022-03-01,1663,5,1658,11,10
Dengue,Faridabad,Himachal Pradesh,2022-04-01,3758,19,3739,167,1
Dengue,Faridabad,Himachal Pradesh,2022-05-01,3531,408,3123,100,4
Dengue,Faridabad,Himachal Pradesh,2022-06-01,4571,392,4179,127,1
Dengue,Faridabad,Himachal Pradesh,2022-07-01,3815,276,3539,62,6
Dengue,Faridabad,Himachal Pradesh,2022-08-01,4060,125,3935,171,5
Dengue,Faridabad,Himachal Pradesh,2022-09-01,1700,73,1627,124,2
Dengue,Faridabad,Himachal Pradesh,2022-10-01,3676,183,3493,97,10
Dengue,Faridabad,Himachal Pradesh,2022-11-01,4989,440,4549,121,4
Dengue,Faridabad,Himachal Pradesh,2022-12-01,1674,103,1571,17,1
Dengue,Faridabad,Himachal Pradesh,2023-01-01,4989,326,4663,125,7
Dengue,Faridabad,Himachal Pradesh,2023-02-01,1860,84,1776,182,7
Dengue,Faridabad,Himachal Pradesh,2023-03-01,1454,106,1348,122,3
Dengue,Faridabad,Himachal Pradesh,2023-04-01,2995,176,2819,116,7
Dengue,Faridabad,Himachal Pradesh,2023-05-01,3558,182,3376,90,2
Dengue,Faridabad,Himachal Pradesh,2023-06-01,3821,108,3713,161,4
Dengue,Faridabad,Himachal Pradesh,2023-07-01,1307,61,1246,169,6
Dengue,Faridabad,Himachal Pradesh,2023-08-01,3180,59,3121,84,8
Dengue,Faridabad,Himachal Pradesh,2023-09-01,1678,82,1596,124,4
Dengue,Faridabad,Himachal Pradesh,2023-10-01,600,31,569,118,3
Dengue,Faridabad,Himachal Pradesh,2023-11-01,1351,0,1351,127,5
Dengue,Faridabad,Himachal Pradesh,2023-12-01,1590,68,1522,67,1
Dengue,Faridabad,Himachal Pradesh,2024-01-01,3297,52,3245,164,4
Dengue,Faridabad,Himachal Pradesh,2024-02-01,4143,267,3876,135,1
Dengue,Faridabad,Himachal Pradesh,2024-03-01,621,42,579,167,2
Dengue,Faridabad,Himachal Pradesh,2024-04-01,3070,115,2955,49,1
Dengue,Faridabad,Himachal Pradesh,2024-05-01,1019,67,952,52,6
Dengue,Faridabad,Himachal Pradesh,2024-06-01,3441,231,3210,200,3
Dengue,Faridabad,Himachal Pradesh,2024-07-01,1762,76,1686,165,8
Dengue,Faridabad,Himachal Pradesh,2024-08-01,1187,112,1075,65,1
Dengue,Faridabad,Himachal Pradesh,2024-09-01,3670,106,3564,150,4
Dengue,Faridabad,Himachal Pradesh,2024-10-01,1810,168,1642,82,5
Dengue,Faridabad,Himachal Pradesh,2024-11-01,2174,94,2080,20,6
Dengue,Faridabad,Himachal Pradesh,2024-12-01,78,0,78,11,10
Dengue,Faridabad,Himachal Pradesh,2025-01-01,3867,154,3713,105,1
Dengue,Faridabad,Himachal Pradesh,2025-02-01,3699,66,3633,186,3
Dengue,Faridabad,Himachal Pradesh,2025-03-01,2605,189,2416,184,10
Dengue,Faridabad,Himachal Pradesh,2025-04-01,548,1,547,170,2
Dengue,Faridabad,Himachal Pradesh,2025-05-01,4220,381,3839,148,6
Dengue,Faridabad,Himachal Pradesh,2025-06-01,1704,38,1666,122,2
Dengue,Faridabad,Himachal Pradesh,2025-07-01,1989,148,1841,165,1
Dengue,Faridabad,Himachal Pradesh,2025-08-01,4989,253,4736,11,2
Dengue,Faridabad,Himachal Pradesh,2025-09-01,1653,95,1558,157,10
Dengue,Faridabad,Himachal Pradesh,2025-10-01,3593,118,3475,49,1
Dengue,Faridabad,Himachal Pradesh,2025-11-01,3351,202,3149,60,4
Dengue,Faridabad,Himachal Pradesh,2025-12-01,3121,168,2953,142,4
Dengue,Faridabad,Jammu & Kashmir,2018-01-01,2976,22,2954,154,7
Dengue,Faridabad,Jammu & Kashmir,2018-02-01,3102,68,3034,75,8
Dengue,Faridabad,Jammu & Kashmir,2018-03-01,2962,101,2861,139,5
Dengue,Faridabad,Jammu & Kashmir,2018-04-01,2528,71,2457,135,1
Dengue,Faridabad,Jammu & Kashmir,2018-05-01,4625,400,4225,90,2
Dengue,Faridabad,Jammu & Kashmir,2018-06-01,836,42,794,114,1
Dengue,Faridabad,Jammu & Kashmir,2018-07-01,3968,108,3860,200,8
Dengue,Faridabad,Jammu & Kashmir,2018-08-01,3701,132,3569,92,2
Dengue,Faridabad,Jammu & Kashmir,2018-09-01,3534,125,3409,94,10
Dengue,Faridabad,Jammu & Kashmir,2018-10-01,4096,170,3926,114,6
Dengue,Faridabad,Jammu & Kashmir,2018-11-01,2473,46,2427,97,8
Dengue,Faridabad,Jammu & Kashmir,2018-12-01,90,2,88,146,10
Dengue,Faridabad,Jammu & Kashmir,2019-01-01,2500,180,2320,181,2
Dengue,Faridabad,Jammu & Kashmir,2019-02-01,1268,70,1198,94,1
Dengue,Faridabad,Jammu & Kashmir,2019-03-01,1616,73,1543,63,5
Dengue,Faridabad,Jammu & Kashmir,2019-04-01,931,46,885,200,8
Dengue,Faridabad,Jammu & Kashmir,2019-05-01,1957,95,1862,112,3
Dengue,Faridabad,Jammu & Kashmir,2019-06-01,1797,79,1718,19,5
Dengue,Faridabad,Jammu & Kashmir,2019-07-01,78,0,78,200,8
Dengue,Faridabad,Jammu & Kashmir,2019-08-01,3537,222,3315,164,8
Dengue,Faridabad,Jammu & Kashmir,2019-09-01,4989,21,4968,188,3
Dengue,Faridabad,Jammu & Kashmir,2019-10-01,3411,157,3254,179,6
Dengue,Faridabad,Jammu & Kashmir,2019-11-01,2325,14,2311,200,2
Dengue,Faridabad,Jammu & Kashmir,2019-12-01,2524,173,2351,53,1
Dengue,Faridabad,Jammu & Kashmir,2020-01-01,2033,147,1886,66,9
Dengue,Faridabad,Jammu & Kashmir,2020-02-01,2718,87,2631,81,1
Dengue,Faridabad,Jammu & Kashmir,2020-03-01,2548,118,2430,80,5
Dengue,Faridabad,Jammu & Kashmir,2020-04-01,1469,0,1469,112,4
Dengue,Faridabad,Jammu & Kashmir,2020-05-01,4855,380,4475,81,6
Dengue,Faridabad,Jammu & Kashmir,2020-06-01,602,42,560,46,3
Dengue,Faridabad,Jammu & Kashmir,2020-07-01,3561,297,3264,62,8
Dengue,Faridabad,Jammu & Kashmir,2020-08-01,2462,229,2233,91,4
Dengue,Faridabad,Jammu & Kashmir,2020-09-01,4989,72,4917,165,9
Dengue,Faridabad,Jammu & Kashmir,2020-10-01,3055,231,2824,77,5
Dengue,Faridabad,Jammu & Kashmir,2020-11-01,2115,196,1919,147,2
Dengue,Faridabad,Jammu & Kashmir,2020-12-01,2265,14,2251,39,6
Dengue,Faridabad,Jammu & Kashmir,2021-01-01,2651,119,2532,11,6
Dengue,Faridabad,Jammu & Kashmir,2021-02-01,1064,42,1022,99,5
Dengue,Faridabad,Jammu & Kashmir,2021-03-01,1569,117,1452,75,3
Dengue,Faridabad,Jammu & Kashmir,2021-04-01,203,0,203,61,7
Dengue,Faridabad,Jammu & Kashmir,2021-05-01,1359,139,1220,55,2
Dengue,Faridabad,Jammu & Kashmir,2021-06-01,2723,127,2596,70,2
Dengue,Faridabad,Jammu & Kashmir,2021-07-01,3000,230,2770,56,6
Dengue,Faridabad,Jammu & Kashmir,2021-08-01,78,0,78,61,4
Dengue,Faridabad,Jammu & Kashmir,2021-09-01,2413,155,2258,37,1
Dengue,Faridabad,Jammu & Kashmir,2021-10-01,3353,0,3353,11,2
Dengue,Faridabad,Jammu & Kashmir,2021-11-01,2379,92,2287,11,6
Dengue,Faridabad,Jammu & Kashmir,2021-12-01,1747,130,1617,200,4
Dengue,Faridabad,Jammu & Kashmir,2022-01-01,2044,119,1925,103,5
Dengue,Faridabad,Jammu & Kashmir,2022-02-01,1872,4,1868,184,6
Dengue,Faridabad,Jammu & Kashmir,2022-03-01,1743,90,1653,97,6
Dengue,Faridabad,Jammu & Kashmir,2022-04-01,2831,74,2757,99,5
Dengue,Faridabad,Jammu & Kashmir,2022-05-01,4989,118,4871,122,1
Dengue,Faridabad,Jammu & Kashmir,2022-06-01,1600,9,1591,139,5
Dengue,Faridabad,Jammu & Kashmir,2022-07-01,2171,147,2024,43,3
Dengue,Faridabad,Jammu & Kashmir,2022-08-01,2528,208,2320,87,5
Dengue,Faridabad,Jammu & Kashmir,2022-09-01,1675,187,1488,122,8
Dengue,Faridabad,Jammu & Kashmir,2022-10-01,4071,29,4042,11,2
Dengue,Faridabad,Jammu & Kashmir,2022-11-01,78,0,78,172,5
Dengue,Faridabad,Jammu & Kashmir,2022-12-01,1885,140,1745,160,6
Dengue,Faridabad,Jammu & Kashmir,2023-01-01,3695,122,3573,11,4
Dengue,Faridabad,Jammu & Kashmir,2023-02-01,2203,51,2152,61,1
Dengue,Faridabad,Jammu & Kashmir,2023-03-01,1496,27,1469,112,1
Dengue,Faridabad,Jammu & Kashmir,2023-04-01,3189,110,3079,149,5
Dengue,Faridabad,Jammu & Kashmir,2023-05-01,3813,213,3600,184,3
Dengue,Faridabad,Jammu & Kashmir,2023-06-01,2880,258,2622,74,1
Dengue,Faridabad,Jammu & Kashmir,2023-07-01,1523,125,1398,200,3
Dengue,Faridabad,Jammu & Kashmir,2023-08-01,3209,9,3200,104,1
Dengue,Faridabad,Jammu & Kashmir,2023-09-01,2058,55,2003,95,7
Dengue,Faridabad,Jammu & Kashmir,2023-10-01,3597,316,3281,135,1
Dengue,Faridabad,Jammu & Kashmir,2023-11-01,4587,132,4455,122,9
Dengue,Faridabad,Jammu & Kashmir,2023-12-01,78,0,78,119,10
Dengue,Faridabad,Jammu & Kashmir,2024-01-01,2746,1,2745,200,3
Dengue,Faridabad,Jammu & Kashmir,2024-02-01,269,22,247,119,3
Dengue,Faridabad,Jammu & Kashmir,2024-03-01,4989,20,4969,56,8
Dengue,Faridabad,Jammu & Kashmir,2024-04-01,1969,4,1965,63,8
Dengue,Faridabad,Jammu & Kashmir,2024-05-01,3599,290,3309,181,3
Dengue,Faridabad,Jammu & Kashmir,2024-06-01,2550,270,2280,141,4
Dengue,Faridabad,Jammu & Kashmir,2024-07-01,1520,63,1457,27,4
Dengue,Faridabad,Jammu & Kashmir,2024-08-01,1360,66,1294,24,2
Dengue,Faridabad,Jammu & Kashmir,2024-09-01,4725,361,4364,107,7
Dengue,Faridabad,Jammu & Kashmir,2024-10-01,3880,226,3654,138,5
Dengue,Faridabad,Jammu & Kashmir,2024-11-01,4989,195,4794,72,3
Dengue,Faridabad,Jammu & Kashmir,2024-12-01,2672,96,2576,21,5
Dengue,Faridabad,Jammu & Kashmir,2025-01-01,2984,13,2971,49,4
Dengue,Faridabad,Jammu & Kashmir,2025-02-01,2239,127,2112,190,10
Dengue,Faridabad,Jammu & Kashmir,2025-03-01,2212,104,2108,132,4
Dengue,Faridabad,Jammu & Kashmir,2025-04-01,1200,44,1156,157,7
Dengue,Faridabad,Jammu & Kashmir,2025-05-01,2710,56,2654,166,6
Dengue,Faridabad,Jammu & Kashmir,2025-06-01,1539,36,1503,74,4
Dengue,Faridabad,Jammu & Kashmir,2025-07-01,3190,217,2973,87,6
Dengue,Faridabad,Jammu & Kashmir,2025-08-01,2825,213,2612,98,5
Dengue,Faridabad,Jammu & Kashmir,2025-09-01,2983,120,2863,127,10
Dengue,Faridabad,Jammu & Kashmir,2025-10-01,4845,181,4664,162,5
Dengue,Faridabad,Jammu & Kashmir,2025-11-01,2547,64,2483,200,1
Dengue,Faridabad,Jammu & Kashmir,2025-12-01,3613,279,3334,148,10
Dengue,Faridabad,Haryana,2018-01-01,4989,254,4735,148,3
Dengue,Faridabad,Haryana,2018-02-01,4350,264,4086,200,5
Dengue,Faridabad,Haryana,2018-03-01,4144,250,3894,96,3
Dengue,Faridabad,Haryana,2018-04-01,2186,89,2097,167,3
Dengue,Faridabad,Haryana,2018-05-01,2905,46,2859,136,2
Dengue,Faridabad,Haryana,2018-06-01,829,17,812,138,1
Dengue,Faridabad,Haryana,2018-07-01,3267,270,2997,95,3
Dengue,Faridabad,Haryana,2018-08-01,2966,85,2881,35,6
Dengue,Faridabad,Haryana,2018-09-01,2629,100,2529,124,1
Dengue,Faridabad,Haryana,2018-10-01,3975,67,3908,124,6
Dengue,Faridabad,Haryana,2018-11-01,977,14,963,77,10
Dengue,Faridabad,Haryana,2018-12-01,4791,132,4659,101,6
Dengue,Faridabad,Haryana,2019-01-01,3807,377,3430,61,1
Dengue,Faridabad,Haryana,2019-02-01,2503,173,2330,62,6
Dengue,Faridabad,Haryana,2019-03-01,2398,83,2315,82,8
Dengue,Faridabad,Haryana,2019-04-01,3242,264,2978,39,9
Dengue,Faridabad,Haryana,2019-05-01,4638,211,4427,76,5
Dengue,Faridabad,Haryana,2019-06-01,2734,244,2490,143,7
Dengue,Faridabad,Haryana,2019-07-01,2791,319,2472,180,7
Dengue,Faridabad,Haryana,2019-08-01,2622,209,2413,200,7
Dengue,Faridabad,Haryana,2019-09-01,4988,263,4725,86,6
Dengue,Faridabad,Haryana,2019-10-01,2103,148,1955,167,3
Dengue,Faridabad,Haryana,2019-11-01,2558,129,2429,123,8
Dengue,Faridabad,Haryana,2019-12-01,4561,0,4561,94,3
Dengue,Faridabad,Haryana,2020-01-01,2795,86,2709,127,10
Dengue,Faridabad,Haryana,2020-02-01,4123,92,4031,162,3
Dengue,Faridabad,Haryana,2020-03-01,1375,41,1334,81,7
Dengue,Faridabad,Haryana,2020-04-01,2322,237,2085,80,1
Dengue,Faridabad,Haryana,2020-05-01,4589,379,4210,85,3
Dengue,Faridabad,Haryana,2020-06-01,1690,106,1584,74,3
Dengue,Faridabad,Haryana,2020-07-01,2394,176,2218,167,1
Dengue,Faridabad,Haryana,2020-08-01,2942,0,2942,67,3
Dengue,Faridabad,Haryana,2020-09-01,1270,90,1180,76,6
Dengue,Faridabad,Haryana,2020-10-01,2042,158,1884,122,4
Dengue,Faridabad,Haryana,2020-11-01,2749,0,2749,118,8
Dengue,Faridabad,Haryana,2020-12-01,2660,192,2468,85,2
Dengue,Faridabad,Haryana,2021-01-01,4315,37,4278,192,7
Dengue,Faridabad,Haryana,2021-02-01,4665,0,4665,74,3
Dengue,Faridabad,Haryana,2021-03-01,1449,128,1321,97,8
Dengue,Faridabad,Haryana,2021-04-01,2747,57,2690,11,7
Dengue,Faridabad,Haryana,2021-05-01,3502,102,3400,91,8
Dengue,Faridabad,Haryana,2021-06-01,4632,365,4267,39,4
Dengue,Faridabad,Haryana,2021-07-01,3561,146,3415,60,9
Dengue,Faridabad,Haryana,2021-08-01,2988,133,2855,11,1
Dengue,Faridabad,Haryana,2021-09-01,3492,154,3338,61,6
Dengue,Faridabad,Haryana,2021-10-01,3501,210,3291,102,5
Dengue,Faridabad,Haryana,2021-11-01,1353,58,1295,94,7
Dengue,Faridabad,Haryana,2021-12-01,2856,152,2704,85,5
Dengue,Faridabad,Haryana,2022-01-01,4555,161,4394,90,2
Dengue,Faridabad,Haryana,2022-02-01,2319,139,2180,80,2
Dengue,Faridabad,Haryana,2022-03-01,2771,164,2607,104,5
Dengue,Faridabad,Haryana,2022-04-01,2272,239,2033,101,4
Dengue,Faridabad,Haryana,2022-05-01,78,0,78,120,7
Dengue,Faridabad,Haryana,2022-06-01,2625,117,2508,96,8
Dengue,Faridabad,Haryana,2022-07-01,3002,171,2831,84,5
Dengue,Faridabad,Haryana,2022-08-01,1910,149,1761,146,5
Dengue,Faridabad,Haryana,2022-09-01,1048,19,1029,137,8
Dengue,Faridabad,Haryana,2022-10-01,1416,75,1341,105,4
Dengue,Faridabad,Haryana,2022-11-01,3623,0,3623,167,4
Dengue,Faridabad,Haryana,2022-12-01,4989,210,4779,110,1
Dengue,Faridabad,Haryana,2023-01-01,4452,361,4091,98,7
Dengue,Faridabad,Haryana,2023-02-01,794,22,772,103,5
Dengue,Faridabad,Haryana,2023-03-01,3744,206,3538,115,8
Dengue,Faridabad,Haryana,2023-04-01,1708,59,1649,59,1
Dengue,Faridabad,Haryana,2023-05-01,1816,45,1771,11,3
Dengue,Faridabad,Haryana,2023-06-01,1978,154,1824,121,8
Dengue,Faridabad,Haryana,2023-07-01,3545,69,3476,149,6
Dengue,Faridabad,Haryana,2023-08-01,3884,227,3657,55,1
Dengue,Faridabad,Haryana,2023-09-01,2466,145,2321,161,8
Dengue,Faridabad,Haryana,2023-10-01,2489,62,2427,22,1
Dengue,Faridabad,Haryana,2023-11-01,3220,175,3045,78,7
Dengue,Faridabad,Haryana,2023-12-01,3359,76,3283,193,2
Dengue,Faridabad,Haryana,2024-01-01,4175,272,3903,124,8
Dengue,Faridabad,Haryana,2024-02-01,874,10,864,91,5
Dengue,Faridabad,Haryana,2024-03-01,2624,105,2519,119,6
Dengue,Faridabad,Haryana,2024-04-01,1165,49,1116,167,5
Dengue,Faridabad,Haryana,2024-05-01,2529,208,2321,33,5
Dengue,Faridabad,Haryana,2024-06-01,2294,124,2170,173,5
Dengue,Faridabad,Haryana,2024-07-01,2535,197,2338,81,7
Dengue,Faridabad,Haryana,2024-08-01,1525,100,1425,142,5
Dengue,Faridabad,Haryana,2024-09-01,602,39,563,75,9
Dengue,Faridabad,Haryana,2024-10-01,78,0,78,192,3
Dengue,Faridabad,Haryana,2024-11-01,2421,193,2228,105,7
Dengue,Faridabad,Haryana,2024-12-01,2019,80,1939,39,6
Dengue,Faridabad,Haryana,2025-01-01,1691,0,1691,130,8
Dengue,Faridabad,Haryana,2025-02-01,4372,191,4181,173,5
Dengue,Faridabad,Haryana,2025-03-01,1444,91,1353,167,6
Dengue,Faridabad,Haryana,2025-04-01,4498,14,4484,111,6
Dengue,Faridabad,Haryana,2025-05-01,4776,116,4660,148,1
Dengue,Faridabad,Haryana,2025-06-01,78,0,78,85,6
Dengue,Faridabad,Haryana,2025-07-01,2721,198,2523,136,10
Dengue,Faridabad,Haryana,2025-08-01,2061,203,1858,125,9
Dengue,Faridabad,Haryana,2025-09-01,78,0,78,11,3
Dengue,Faridabad,Haryana,2025-10-01,659,43,616,55,1
Dengue,Faridabad,Haryana,2025-11-01,3637,235,3402,117,5
Dengue,Faridabad,Haryana,2025-12-01,4989,442,4547,115,8
Dengue,Panchkula,Punjab,2018-01-01,3808,118,3690,105,5
Dengue,Panchkula,Punjab,2018-02-01,3032,132,2900,111,10
Dengue,Panchkula,Punjab,2018-03-01,2569,103,2466,168,3
Dengue,Panchkula,Punjab,2018-04-01,4855,253,4602,124,5
Dengue,Panchkula,Punjab,2018-05-01,4989,442,4547,11,5
Dengue,Panchkula,Punjab,2018-06-01,1810,92,1718,200,7
Dengue,Panchkula,Punjab,2018-07-01,78,0,78,11,7
Dengue,Panchkula,Punjab,2018-08-01,78,0,78,155,8
Dengue,Panchkula,Punjab,2018-09-01,4371,378,3993,27,4
Dengue,Panchkula,Punjab,2018-10-01,2534,63,2471,179,8
Dengue,Panchkula,Punjab,2018-11-01,2843,197,2646,92,6
Dengue,Panchkula,Punjab,2018-12-01,195,5,190,126,9
Dengue,Panchkula,Punjab,2019-01-01,1587,20,1567,11,9
Dengue,Panchkula,Punjab,2019-02-01,2201,148,2053,143,5
Dengue,Panchkula,Punjab,2019-03-01,2876,91,2785,127,3
Dengue,Panchkula,Punjab,2019-04-01,2063,128,1935,138,5
Dengue,Panchkula,Punjab,2019-05-01,1206,77,1129,155,8
Dengue,Panchkula,Punjab,2019-06-01,1545,101,1444,115,1
Dengue,Panchkula,Punjab,2019-07-01,4218,178,4040,95,3
Dengue,Panchkula,Punjab,2019-08-01,2926,204,2722,65,7
Dengue,Panchkula,Punjab,2019-09-01,3419,79,3340,84,1
Dengue,Panchkula,Punjab,2019-10-01,1392,0,1392,168,2
Dengue,Panchkula,Punjab,2019-11-01,78,0,78,64,3
Dengue,Panchkula,Punjab,2019-12-01,1896,104,1792,12,5
Dengue,Panchkula,Punjab,2020-01-01,1435,46,1389,56,4
Dengue,Panchkula,Punjab,2020-02-01,3066,22,3044,137,4
Dengue,Panchkula,Punjab,2020-03-01,4989,20,4969,91,1
Dengue,Panchkula,Punjab,2020-04-01,3530,182,3348,137,10
Dengue,Panchkula,Punjab,2020-05-01,4989,442,4547,11,3
Dengue,Panchkula,Punjab,2020-06-01,3360,154,3206,11,1
Dengue,Panchkula,Punjab,2020-07-01,1752,69,1683,120,8
Dengue,Panchkula,Punjab,2020-08-01,3064,151,2913,157,3
Dengue,Panchkula,Punjab,2020-09-01,4986,442,4544,19,1
Dengue,Panchkula,Punjab,2020-10-01,4989,358,4631,133,7
Dengue,Panchkula,Punjab,2020-11-01,1826,41,1785,167,3
Dengue,Panchkula,Punjab,2020-12-01,2937,149,2788,106,5
Dengue,Panchkula,Punjab,2021-01-01,680,40,640,152,3
Dengue,Panchkula,Punjab,2021-02-01,3704,71,3633,116,3
Dengue,Panchkula,Punjab,2021-03-01,4681,337,4344,93,2
Dengue,Panchkula,Punjab,2021-04-01,2651,69,2582,148,1
Dengue,Panchkula,Punjab,2021-05-01,1702,10,1692,200,10
Dengue,Panchkula,Punjab,2021-06-01,3081,161,2920,78,2
Dengue,Panchkula,Punjab,2021-07-01,3157,150,3007,102,1
Dengue,Panchkula,Punjab,2021-08-01,2706,135,2571,56,8
Dengue,Panchkula,Punjab,2021-09-01,2837,78,2759,114,6
Dengue,Panchkula,Punjab,2021-10-01,2364,75,2289,98,5
Dengue,Panchkula,Punjab,2021-11-01,3933,326,3607,165,3
Dengue,Panchkula,Punjab,2021-12-01,3585,225,3360,179,4
Dengue,Panchkula,Punjab,2022-01-01,1279,28,1251,146,4
Dengue,Panchkula,Punjab,2022-02-01,1242,0,1242,160,8
Dengue,Panchkula,Punjab,2022-03-01,2256,52,2204,70,4
Dengue,Panchkula,Punjab,2022-04-01,3586,195,3391,58,8
Dengue,Panchkula,Punjab,2022-05-01,2796,88,2708,128,5
Dengue,Panchkula,Punjab,2022-06-01,1735,51,1684,107,4
Dengue,Panchkula,Punjab,2022-07-01,2948,97,2851,200,2
Dengue,Panchkula,Punjab,2022-08-01,2154,103,2051,11,10
Dengue,Panchkula,Punjab,2022-09-01,3779,275,3504,138,5
Dengue,Panchkula,Punjab,2022-10-01,3044,152,2892,137,5
Dengue,Panchkula,Punjab,2022-11-01,2174,112,2062,67,10
Dengue,Panchkula,Punjab,2022-12-01,2908,126,2782,57,6
Dengue,Panchkula,Punjab,2023-01-01,4362,155,4207,89,6
Dengue,Panchkula,Punjab,2023-02-01,1833,139,1694,23,5
Dengue,Panchkula,Punjab,2023-03-01,3138,224,2914,180,3
Dengue,Panchkula,Punjab,2023-04-01,2503,274,2229,200,8
Dengue,Panchkula,Punjab,2023-05-01,3170,215,2955,89,1
Dengue,Panchkula,Punjab,2023-06-01,1719,61,1658,74,2
Dengue,Panchkula,Punjab,2023-07-01,2745,65,2680,39,3
Dengue,Panchkula,Punjab,2023-08-01,4084,317,3767,50,6
Dengue,Panchkula,Punjab,2023-09-01,1340,35,1305,76,5
Dengue,Panchkula,Punjab,2023-10-01,814,59,755,168,1
Dengue,Panchkula,Punjab,2023-11-01,865,24,841,200,10
Dengue,Panchkula,Punjab,2023-12-01,1027,61,966,69,7
Dengue,Panchkula,Punjab,2024-01-01,3396,65,3331,60,3
Dengue,Panchkula,Punjab,2024-02-01,711,51,660,47,6
Dengue,Panchkula,Punjab,2024-03-01,2198,31,2167,129,6
Dengue,Panchkula,Punjab,2024-04-01,3427,198,3229,124,4
Dengue,Panchkula,Punjab,2024-05-01,3156,139,3017,111,6
Dengue,Panchkula,Punjab,2024-06-01,2080,110,1970,84,6
Dengue,Panchkula,Punjab,2024-07-01,2854,110,2744,175,8
Dengue,Panchkula,Punjab,2024-08-01,2741,103,2638,145,5
Dengue,Panchkula,Punjab,2024-09-01,2297,125,2172,143,6
Dengue,Panchkula,Punjab,2024-10-01,2315,48,2267,125,4
Dengue,Panchkula,Punjab,2024-11-01,4989,103,4886,97,4
Dengue,Panchkula,Punjab,2024-12-01,3683,145,3538,70,3
Dengue,Panchkula,Punjab,2025-01-01,4989,192,4797,133,2
Dengue,Panchkula,Punjab,2025-02-01,1931,40,1891,128,3
Dengue,Panchkula,Punjab,2025-03-01,2483,191,2292,135,4
Dengue,Panchkula,Punjab,2025-04-01,810,32,778,27,8
Dengue,Panchkula,Punjab,2025-05-01,1511,65,1446,123,4
Dengue,Panchkula,Punjab,2025-06-01,4989,57,4932,90,4
Dengue,Panchkula,Punjab,2025-07-01,1897,209,1688,61,4
Dengue,Panchkula,Punjab,2025-08-01,4989,442,4547,143,5
Dengue,Panchkula,Punjab,2025-09-01,929,25,904,115,10
Dengue,Panchkula,Punjab,2025-10-01,1184,101,1083,200,4
Dengue,Panchkula,Punjab,2025-11-01,2140,101,2039,131,6
Dengue,Panchkula,Punjab,2025-12-01,2512,243,2269,91,6
Dengue,Panchkula,Chandigarh,2018-01-01,3836,229,3607,101,5
Dengue,Panchkula,Chandigarh,2018-02-01,3202,169,3033,47,2
Dengue,Panchkula,Chandigarh,2018-03-01,2039,0,2039,169,6
Dengue,Panchkula,Chandigarh,2018-04-01,2419,59,2360,122,1
Dengue,Panchkula,Chandigarh,2018-05-01,2169,109,2060,123,2
Dengue,Panchkula,Chandigarh,2018-06-01,1370,76,1294,52,3
Dengue,Panchkula,Chandigarh,2018-07-01,1406,20,1386,146,4
Dengue,Panchkula,Chandigarh,2018-08-01,3976,114,3862,59,5
Dengue,Panchkula,Chandigarh,2018-09-01,145,9,136,78,9
Dengue,Panchkula,Chandigarh,2018-10-01,4767,46,4721,113,7
Dengue,Panchkula,Chandigarh,2018-11-01,2137,115,2022,77,5
Dengue,Panchkula,Chandigarh,2018-12-01,1561,134,1427,66,4
Dengue,Panchkula,Chandigarh,2019-01-01,3590,220,3370,104,4
Dengue,Panchkula,Chandigarh,2019-02-01,4590,274,4316,158,2
Dengue,Panchkula,Chandigarh,2019-03-01,4097,0,4097,152,1
Dengue,Panchkula,Chandigarh,2019-04-01,3271,85,3186,142,1
Dengue,Panchkula,Chandigarh,2019-05-01,4055,442,3613,131,8
Dengue,Panchkula,Chandigarh,2019-06-01,295,9,286,82,3
Dengue,Panchkula,Chandigarh,2019-07-01,1897,164,1733,163,3
Dengue,Panchkula,Chandigarh,2019-08-01,1375,44,1331,18,8
Dengue,Panchkula,Chandigarh,2019-09-01,4240,178,4062,128,1
Dengue,Panchkula,Chandigarh,2019-10-01,2083,135,1948,149,3
Dengue,Panchkula,Chandigarh,2019-11-01,3732,197,3535,102,2
Dengue,Panchkula,Chandigarh,2019-12-01,3316,202,3114,69,6
Dengue,Panchkula,Chandigarh,2020-01-01,1441,37,1404,104,6
Dengue,Panchkula,Chandigarh,2020-02-01,1810,30,1780,68,6
Dengue,Panchkula,Chandigarh,2020-03-01,4333,105,4228,132,9
Dengue,Panchkula,Chandigarh,2020-04-01,1557,53,1504,154,6
Dengue,Panchkula,Chandigarh,2020-05-01,2765,119,2646,129,6
Dengue,Panchkula,Chandigarh,2020-06-01,1548,124,1424,126,10
Dengue,Panchkula,Chandigarh,2020-07-01,2176,114,2062,145,1
Dengue,Panchkula,Chandigarh,2020-08-01,2535,162,2373,151,10
Dengue,Panchkula,Chandigarh,2020-09-01,1547,83,1464,67,10
Dengue,Panchkula,Chandigarh,2020-10-01,1309,23,1286,28,4
Dengue,Panchkula,Chandigarh,2020-11-01,2981,150,2831,120,3
Dengue,Panchkula,Chandigarh,2020-12-01,1464,78,1386,153,3
Dengue,Panchkula,Chandigarh,2021-01-01,1510,109,1401,26,4
Dengue,Panchkula,Chandigarh,2021-02-01,1338,25,1313,110,8
Dengue,Panchkula,Chandigarh,2021-03-01,2493,0,2493,164,1
Dengue,Panchkula,Chandigarh,2021-04-01,3863,213,3650,100,10
Dengue,Panchkula,Chandigarh,2021-05-01,4618,278,4340,184,5
Dengue,Panchkula,Chandigarh,2021-06-01,1624,72,1552,174,8
Dengue,Panchkula,Chandigarh,2021-07-01,4989,253,4736,97,1
Dengue,Panchkula,Chandigarh,2021-08-01,1250,94,1156,87,7
Dengue,Panchkula,Chandigarh,2021-09-01,4051,148,3903,88,6
Dengue,Panchkula,Chandigarh,2021-10-01,1629,68,1561,113,6
Dengue,Panchkula,Chandigarh,2021-11-01,1429,74,1355,46,3
Dengue,Panchkula,Chandigarh,2021-12-01,1598,23,1575,37,4
Dengue,Panchkula,Chandigarh,2022-01-01,2527,115,2412,11,1
Dengue,Panchkula,Chandigarh,2022-02-01,3375,162,3213,105,7
Dengue,Panchkula,Chandigarh,2022-03-01,3496,341,3155,200,9
Dengue,Panchkula,Chandigarh,2022-04-01,1331,55,1276,11,6
Dengue,Panchkula,Chandigarh,2022-05-01,1270,70,1200,97,1
Dengue,Panchkula,Chandigarh,2022-06-01,1368,105,1263,95,9
Dengue,Panchkula,Chandigarh,2022-07-01,2448,62,2386,98,5
Dengue,Panchkula,Chandigarh,2022-08-01,2315,208,2107,170,1
Dengue,Panchkula,Chandigarh,2022-09-01,1323,134,1189,61,1
Dengue,Panchkula,Chandigarh,2022-10-01,2959,145,2814,11,2
Dengue,Panchkula,Chandigarh,2022-11-01,4989,171,4818,79,5
Dengue,Panchkula,Chandigarh,2022-12-01,1920,187,1733,72,2
Dengue,Panchkula,Chandigarh,2023-01-01,2016,147,1869,11,2
Dengue,Panchkula,Chandigarh,2023-02-01,3348,175,3173,119,7
Dengue,Panchkula,Chandigarh,2023-03-01,1848,169,1679,46,8
Dengue,Panchkula,Chandigarh,2023-04-01,3495,309,3186,102,8
Dengue,Panchkula,Chandigarh,2023-05-01,1633,65,1568,88,1
Dengue,Panchkula,Chandigarh,2023-06-01,4989,285,4704,51,8
Dengue,Panchkula,Chandigarh,2023-07-01,3060,204,2856,152,3
Dengue,Panchkula,Chandigarh,2023-08-01,1766,89,1677,92,10
Dengue,Panchkula,Chandigarh,2023-09-01,1808,17,1791,109,6
Dengue,Panchkula,Chandigarh,2023-10-01,1908,43,1865,136,8
Dengue,Panchkula,Chandigarh,2023-11-01,4439,46,4393,121,6
Dengue,Panchkula,Chandigarh,2023-12-01,895,57,838,114,6
Dengue,Panchkula,Chandigarh,2024-01-01,1701,26,1675,64,4
Dengue,Panchkula,Chandigarh,2024-02-01,1844,102,1742,50,8
Dengue,Panchkula,Chandigarh,2024-03-01,2576,266,2310,114,8
Dengue,Panchkula,Chandigarh,2024-04-01,2234,204,2030,57,4
Dengue,Panchkula,Chandigarh,2024-05-01,597,0,597,147,4
Dengue,Panchkula,Chandigarh,2024-06-01,2061,26,2035,100,3
Dengue,Panchkula,Chandigarh,2024-07-01,2464,67,2397,139,7
Dengue,Panchkula,Chandigarh,2024-08-01,1755,28,1727,56,6
Dengue,Panchkula,Chandigarh,2024-09-01,3519,6,3513,48,6
Dengue,Panchkula,Chandigarh,2024-10-01,3831,190,3641,192,4
Dengue,Panchkula,Chandigarh,2024-11-01,2492,175,2317,99,9
Dengue,Panchkula,Chandigarh,2024-12-01,2907,226,2681,153,1
Dengue,Panchkula,Chandigarh,2025-01-01,78,0,78,34,7
Dengue,Panchkula,Chandigarh,2025-02-01,2032,85,1947,92,8
Dengue,Panchkula,Chandigarh,2025-03-01,3945,238,3707,173,4
Dengue,Panchkula,Chandigarh,2025-04-01,2029,95,1934,26,1
Dengue,Panchkula,Chandigarh,2025-05-01,1608,118,1490,200,6
Dengue,Panchkula,Chandigarh,2025-06-01,4989,312,4677,117,8
Dengue,Panchkula,Chandigarh,2025-07-01,4989,195,4794,64,10
Dengue,Panchkula,Chandigarh,2025-08-01,3225,0,3225,124,7
Dengue,Panchkula,Chandigarh,2025-09-01,4125,386,3739,163,3
Dengue,Panchkula,Chandigarh,2025-10-01,78,0,78,64,7
Dengue,Panchkula,Chandigarh,2025-11-01,1541,93,1448,71,6
Dengue,Panchkula,Chandigarh,2025-12-01,1967,0,1967,119,6
Dengue,Panchkula,Himachal Pradesh,2018-01-01,2281,113,2168,130,2
Dengue,Panchkula,Himachal Pradesh,2018-02-01,1940,102,1838,96,7
Dengue,Panchkula,Himachal Pradesh,2018-03-01,78,0,78,127,6
Dengue,Panchkula,Himachal Pradesh,2018-04-01,3115,429,2686,150,10
Dengue,Panchkula,Himachal Pradesh,2018-05-01,3327,105,3222,115,5
Dengue,Panchkula,Himachal Pradesh,2018-06-01,4746,350,4396,71,10
Dengue,Panchkula,Himachal Pradesh,2018-07-01,1540,100,1440,105,9
Dengue,Panchkula,Himachal Pradesh,2018-08-01,1430,43,1387,196,5
Dengue,Panchkula,Himachal Pradesh,2018-09-01,78,0,78,123,8
Dengue,Panchkula,Himachal Pradesh,2018-10-01,2204,99,2105,169,3
Dengue,Panchkula,Himachal Pradesh,2018-11-01,3806,287,3519,80,4
Dengue,Panchkula,Himachal Pradesh,2018-12-01,1777,190,1587,120,3
Dengue,Panchkula,Himachal Pradesh,2019-01-01,4989,271,4718,147,4
Dengue,Panchkula,Himachal Pradesh,2019-02-01,2253,94,2159,183,1
Dengue,Panchkula,Himachal Pradesh,2019-03-01,2795,225,2570,169,10
Dengue,Panchkula,Himachal Pradesh,2019-04-01,769,69,700,49,4
Dengue,Panchkula,Himachal Pradesh,2019-05-01,2983,72,2911,165,7
Dengue,Panchkula,Himachal Pradesh,2019-06-01,78,0,78,192,6
Dengue,Panchkula,Himachal Pradesh,2019-07-01,3528,246,3282,77,4
Dengue,Panchkula,Himachal Pradesh,2019-08-01,3569,164,3405,61,1
Dengue,Panchkula,Himachal Pradesh,2019-09-01,4421,98,4323,105,2
Dengue,Panchkula,Himachal Pradesh,2019-10-01,1229,80,1149,115,4
Dengue,Panchkula,Himachal Pradesh,2019-11-01,2813,195,2618,88,3
Dengue,Panchkula,Himachal Pradesh,2019-12-01,3354,135,3219,46,2
Dengue,Panchkula,Himachal Pradesh,2020-01-01,3191,165,3026,181,3
Dengue,Panchkula,Himachal Pradesh,2020-02-01,1437,47,1390,62,6
Dengue,Panchkula,Himachal Pradesh,2020-03-01,78,0,78,80,7
Dengue,Panchkula,Himachal Pradesh,2020-04-01,3063,109,2954,112,1
Dengue,Panchkula,Himachal Pradesh,2020-05-01,2393,124,2269,31,2
Dengue,Panchkula,Himachal Pradesh,2020-06-01,1837,13,1824,27,5
Dengue,Panchkula,Himachal Pradesh,2020-07-01,3622,136,3486,84,4
Dengue,Panchkula,Himachal Pradesh,2020-08-01,2537,133,2404,148,4
Dengue,Panchkula,Himachal Pradesh,2020-09-01,828,70,758,116,7
Dengue,Panchkula,Himachal Pradesh,2020-10-01,78,0,78,11,5
Dengue,Panchkula,Himachal Pradesh,2020-11-01,1083,14,1069,177,1
Dengue,Panchkula,Himachal Pradesh,2020-12-01,4989,219,4770,147,2
Dengue,Panchkula,Himachal Pradesh,2021-01-01,3567,119,3448,116,1
Dengue,Panchkula,Himachal Pradesh,2021-02-01,2850,188,2662,115,4
Dengue,Panchkula,Himachal Pradesh,2021-03-01,2354,94,2260,141,1
Dengue,Panchkula,Himachal Pradesh,2021-04-01,2266,0,2266,200,1
Dengue,Panchkula,Himachal Pradesh,2021-05-01,4163,442,3721,151,1
Dengue,Panchkula,Himachal Pradesh,2021-06-01,1939,105,1834,121,10
Dengue,Panchkula,Himachal Pradesh,2021-07-01,3371,177,3194,44,1
Dengue,Panchkula,Himachal Pradesh,2021-08-01,2130,11,2119,115,4
Dengue,Panchkula,Himachal Pradesh,2021-09-01,4989,37,4952,146,5
Dengue,Panchkula,Himachal Pradesh,2021-10-01,3593,170,3423,100,5
Dengue,Panchkula,Himachal Pradesh,2021-11-01,4268,255,4013,80,7
Dengue,Panchkula,Himachal Pradesh,2021-12-01,1813,127,1686,134,5
Dengue,Panchkula,Himachal Pradesh,2022-01-01,4017,228,3789,56,4
Dengue,Panchkula,Himachal Pradesh,2022-02-01,2178,33,2145,150,5
Dengue,Panchkula,Himachal Pradesh,2022-03-01,2745,0,2745,84,5
Dengue,Panchkula,Himachal Pradesh,2022-04-01,4791,225,4566,11,5
Dengue,Panchkula,Himachal Pradesh,2022-05-01,1199,41,1158,83,7
Dengue,Panchkula,Himachal Pradesh,2022-06-01,2870,38,2832,103,3
Dengue,Panchkula,Himachal Pradesh,2022-07-01,3185,236,2949,134,4
Dengue,Panchkula,Himachal Pradesh,2022-08-01,3295,13,3282,128,1
Dengue,Panchkula,Himachal Pradesh,2022-09-01,1993,135,1858,40,4
Dengue,Panchkula,Himachal Pradesh,2022-10-01,4989,45,4944,112,3
Dengue,Panchkula,Himachal Pradesh,2022-11-01,860,46,814,79,8
Dengue,Panchkula,Himachal Pradesh,2022-12-01,4555,351,4204,88,1
Dengue,Panchkula,Himachal Pradesh,2023-01-01,4227,170,4057,55,3
Dengue,Panchkula,Himachal Pradesh,2023-02-01,4989,442,4547,104,3
Dengue,Panchkula,Himachal Pradesh,2023-03-01,467,49,418,200,7
Dengue,Panchkula,Himachal Pradesh,2023-04-01,1432,81,1351,200,1
Dengue,Panchkula,Himachal Pradesh,2023-05-01,4599,302,4297,55,5
Dengue,Panchkula,Himachal Pradesh,2023-06-01,79,1,78,110,5
Dengue,Panchkula,Himachal Pradesh,2023-07-01,442,29,413,90,8
Dengue,Panchkula,Himachal Pradesh,2023-08-01,1942,121,1821,113,2
Dengue,Panchkula,Himachal Pradesh,2023-09-01,2855,99,2756,153,1
Dengue,Panchkula,Himachal Pradesh,2023-10-01,4733,4,4729,100,6
Dengue,Panchkula,Himachal Pradesh,2023-11-01,2349,22,2327,70,1
Dengue,Panchkula,Himachal Pradesh,2023-12-01,1781,212,1569,165,3
Dengue,Panchkula,Himachal Pradesh,2024-01-01,3015,179,2836,43,4
Dengue,Panchkula,Himachal Pradesh,2024-02-01,3227,138,3089,116,7
Dengue,Panchkula,Himachal Pradesh,2024-03-01,3189,276,2913,30,1
Dengue,Panchkula,Himachal Pradesh,2024-04-01,2359,66,2293,54,4
Dengue,Panchkula,Himachal Pradesh,2024-05-01,78,0,78,144,5
Dengue,Panchkula,Himachal Pradesh,2024-06-01,1366,71,1295,72,2
Dengue,Panchkula,Himachal Pradesh,2024-07-01,4503,285,4218,11,4
Dengue,Panchkula,Himachal Pradesh,2024-08-01,2848,114,2734,69,7
Dengue,Panchkula,Himachal Pradesh,2024-09-01,2165,47,2118,64,3
Dengue,Panchkula,Himachal Pradesh,2024-10-01,4097,107,3990,42,4
Dengue,Panchkula,Himachal Pradesh,2024-11-01,1081,29,1052,134,7
Dengue,Panchkula,Himachal Pradesh,2024-12-01,2295,114,2181,27,4
Dengue,Panchkula,Himachal Pradesh,2025-01-01,2782,13,2769,76,9
Dengue,Panchkula,Himachal Pradesh,2025-02-01,2005,27,1978,113,1
Dengue,Panchkula,Himachal Pradesh,2025-03-01,2733,147,2586,89,4
Dengue,Panchkula,Himachal Pradesh,2025-04-01,2346,108,2238,86,7
Dengue,Panchkula,Himachal Pradesh,2025-05-01,720,40,680,69,3
Dengue,Panchkula,Himachal Pradesh,2025-06-01,2841,138,2703,44,4
Dengue,Panchkula,Himachal Pradesh,2025-07-01,815,100,715,74,8
Dengue,Panchkula,Himachal Pradesh,2025-08-01,2820,151,2669,140,3
Dengue,Panchkula,Himachal Pradesh,2025-09-01,4441,173,4268,84,6
Dengue,Panchkula,Himachal Pradesh,2025-10-01,2220,117,2103,115,7
Dengue,Panchkula,Himachal Pradesh,2025-11-01,1026,81,945,163,5
Dengue,Panchkula,Himachal Pradesh,2025-12-01,2427,118,2309,137,5
Dengue,Panchkula,Jammu & Kashmir,2018-01-01,1481,103,1378,41,2
Dengue,Panchkula,Jammu & Kashmir,2018-02-01,3395,209,3186,129,7
Dengue,Panchkula,Jammu & Kashmir,2018-03-01,2399,99,2300,160,1
Dengue,Panchkula,Jammu & Kashmir,2018-04-01,4891,260,4631,77,6
Dengue,Panchkula,Jammu & Kashmir,2018-05-01,4158,401,3757,25,3
Dengue,Panchkula,Jammu & Kashmir,2018-06-01,2392,136,2256,84,4
Dengue,Panchkula,Jammu & Kashmir,2018-07-01,3557,76,3481,116,4
Dengue,Panchkula,Jammu & Kashmir,2018-08-01,2070,84,1986,136,6
Dengue,Panchkula,Jammu & Kashmir,2018-09-01,2643,0,2643,80,9
Dengue,Panchkula,Jammu & Kashmir,2018-10-01,2113,114,1999,11,5
Dengue,Panchkula,Jammu & Kashmir,2018-11-01,3626,320,3306,41,3
Dengue,Panchkula,Jammu & Kashmir,2018-12-01,4520,49,4471,125,1
Dengue,Panchkula,Jammu & Kashmir,2019-01-01,3669,199,3470,200,8
Dengue,Panchkula,Jammu & Kashmir,2019-02-01,3834,301,3533,105,5
Dengue,Panchkula,Jammu & Kashmir,2019-03-01,3836,313,3523,173,4
Dengue,Panchkula,Jammu & Kashmir,2019-04-01,3337,291,3046,52,5
Dengue,Panchkula,Jammu & Kashmir,2019-05-01,1069,0,1069,73,7
Dengue,Panchkula,Jammu & Kashmir,2019-06-01,4879,315,4564,11,4
Dengue,Panchkula,Jammu & Kashmir,2019-07-01,4989,31,4958,125,3
Dengue,Panchkula,Jammu & Kashmir,2019-08-01,2284,47,2237,61,1
Dengue,Panchkula,Jammu & Kashmir,2019-09-01,2100,155,1945,137,2
Dengue,Panchkula,Jammu & Kashmir,2019-10-01,3419,186,3233,81,4
Dengue,Panchkula,Jammu & Kashmir,2019-11-01,3336,237,3099,200,8
Dengue,Panchkula,Jammu & Kashmir,2019-12-01,2326,53,2273,198,3
Dengue,Panchkula,Jammu & Kashmir,2020-01-01,920,85,835,11,6
Dengue,Panchkula,Jammu & Kashmir,2020-02-01,3008,210,2798,136,8
Dengue,Panchkula,Jammu & Kashmir,2020-03-01,3337,253,3084,68,6
Dengue,Panchkula,Jammu & Kashmir,2020-04-01,3571,66,3505,139,10
Dengue,Panchkula,Jammu & Kashmir,2020-05-01,3066,258,2808,38,5
Dengue,Panchkula,Jammu & Kashmir,2020-06-01,2234,91,2143,180,4
Dengue,Panchkula,Jammu & Kashmir,2020-07-01,3931,126,3805,159,4
Dengue,Panchkula,Jammu & Kashmir,2020-08-01,2686,183,2503,34,10
Dengue,Panchkula,Jammu & Kashmir,2020-09-01,1974,132,1842,97,8
Dengue,Panchkula,Jammu & Kashmir,2020-10-01,2355,59,2296,114,1
Dengue,Panchkula,Jammu & Kashmir,2020-11-01,255,28,227,143,10
Dengue,Panchkula,Jammu & Kashmir,2020-12-01,2353,242,2111,106,6
Dengue,Panchkula,Jammu & Kashmir,2021-01-01,3521,238,3283,146,5
Dengue,Panchkula,Jammu & Kashmir,2021-02-01,3053,191,2862,103,6
Dengue,Panchkula,Jammu & Kashmir,2021-03-01,4637,276,4361,137,2
Dengue,Panchkula,Jammu & Kashmir,2021-04-01,2245,11,2234,37,5
Dengue,Panchkula,Jammu & Kashmir,2021-05-01,3251,173,3078,105,4
Dengue,Panchkula,Jammu & Kashmir,2021-06-01,3661,193,3468,165,4
Dengue,Panchkula,Jammu & Kashmir,2021-07-01,4989,166,4823,178,8
Dengue,Panchkula,Jammu & Kashmir,2021-08-01,2792,114,2678,115,4
Dengue,Panchkula,Jammu & Kashmir,2021-09-01,1197,0,1197,101,5
Dengue,Panchkula,Jammu & Kashmir,2021-10-01,3735,67,3668,176,6
Dengue,Panchkula,Jammu & Kashmir,2021-11-01,4989,383,4606,101,8
Dengue,Panchkula,Jammu & Kashmir,2021-12-01,2165,217,1948,165,9
Dengue,Panchkula,Jammu & Kashmir,2022-01-01,3726,84,3642,101,5
Dengue,Panchkula,Jammu & Kashmir,2022-02-01,4246,235,4011,108,4
Dengue,Panchkula,Jammu & Kashmir,2022-03-01,3962,325,3637,50,10
Dengue,Panchkula,Jammu & Kashmir,2022-04-01,2766,96,2670,43,1
Dengue,Panchkula,Jammu & Kashmir,2022-05-01,1660,115,1545,156,7
Dengue,Panchkula,Jammu & Kashmir,2022-06-01,2488,122,2366,194,4
Dengue,Panchkula,Jammu & Kashmir,2022-07-01,3213,272,2941,112,6
Dengue,Panchkula,Jammu & Kashmir,2022-08-01,3816,48,3768,98,5
Dengue,Panchkula,Jammu & Kashmir,2022-09-01,3045,54,2991,158,9
Dengue,Panchkula,Jammu & Kashmir,2022-10-01,2088,121,1967,123,6
Dengue,Panchkula,Jammu & Kashmir,2022-11-01,3342,176,3166,11,1
Dengue,Panchkula,Jammu & Kashmir,2022-12-01,3751,181,3570,157,1
Dengue,Panchkula,Jammu & Kashmir,2023-01-01,3107,207,2900,38,4
Dengue,Panchkula,Jammu & Kashmir,2023-02-01,1476,33,1443,106,7
Dengue,Panchkula,Jammu & Kashmir,2023-03-01,2354,24,2330,84,9
Dengue,Panchkula,Jammu & Kashmir,2023-04-01,3869,137,3732,74,3
Dengue,Panchkula,Jammu & Kashmir,2023-05-01,742,28,714,109,1
Dengue,Panchkula,Jammu & Kashmir,2023-06-01,78,0,78,152,6
Dengue,Panchkula,Jammu & Kashmir,2023-07-01,4621,402,4219,108,5
Dengue,Panchkula,Jammu & Kashmir,2023-08-01,3283,237,3046,178,5
Dengue,Panchkula,Jammu & Kashmir,2023-09-01,3411,223,3188,184,2
Dengue,Panchkula,Jammu & Kashmir,2023-10-01,1153,65,1088,184,8
Dengue,Panchkula,Jammu & Kashmir,2023-11-01,3587,134,3453,103,2
Dengue,Panchkula,Jammu & Kashmir,2023-12-01,2967,74,2893,82,6
Dengue,Panchkula,Jammu & Kashmir,2024-01-01,472,7,465,104,6
Dengue,Panchkula,Jammu & Kashmir,2024-02-01,4508,134,4374,164,6
Dengue,Panchkula,Jammu & Kashmir,2024-03-01,2810,137,2673,160,3
Dengue,Panchkula,Jammu & Kashmir,2024-04-01,2066,33,2033,11,2
Dengue,Panchkula,Jammu & Kashmir,2024-05-01,2090,114,1976,122,7
Dengue,Panchkula,Jammu & Kashmir,2024-06-01,78,0,78,11,6
Dengue,Panchkula,Jammu & Kashmir,2024-07-01,3393,130,3263,105,6
Dengue,Panchkula,Jammu & Kashmir,2024-08-01,2949,247,2702,79,8
Dengue,Panchkula,Jammu & Kashmir,2024-09-01,2337,0,2337,64,6
Dengue,Panchkula,Jammu & Kashmir,2024-10-01,4313,167,4146,149,4
Dengue,Panchkula,Jammu & Kashmir,2024-11-01,741,0,741,73,6
Dengue,Panchkula,Jammu & Kashmir,2024-12-01,1797,102,1695,106,6
Dengue,Panchkula,Jammu & Kashmir,2025-01-01,1457,105,1352,59,6
Dengue,Panchkula,Jammu & Kashmir,2025-02-01,2223,23,2200,110,2
Dengue,Panchkula,Jammu & Kashmir,2025-03-01,2688,38,2650,155,2
Dengue,Panchkula,Jammu & Kashmir,2025-04-01,3174,2,3172,61,7
Dengue,Panchkula,Jammu & Kashmir,2025-05-01,2132,110,2022,139,4
Dengue,Panchkula,Jammu & Kashmir,2025-06-01,1420,57,1363,109,1
Dengue,Panchkula,Jammu & Kashmir,2025-07-01,4859,203,4656,109,1
Dengue,Panchkula,Jammu & Kashmir,2025-08-01,4989,196,4793,88,1
Dengue,Panchkula,Jammu & Kashmir,2025-09-01,2790,60,2730,146,8
Dengue,Panchkula,Jammu & Kashmir,2025-10-01,1582,131,1451,140,5
Dengue,Panchkula,Jammu & Kashmir,2025-11-01,4577,265,4312,99,5
Dengue,Panchkula,Jammu & Kashmir,2025-12-01,657,10,647,117,4
Dengue,Panchkula,Haryana,2018-01-01,2148,63,2085,144,2
Dengue,Panchkula,Haryana,2018-02-01,1664,41,1623,134,7
Dengue,Panchkula,Haryana,2018-03-01,1042,94,948,91,7
Dengue,Panchkula,Haryana,2018-04-01,2222,157,2065,166,3
Dengue,Panchkula,Haryana,2018-05-01,1438,66,1372,150,9
Dengue,Panchkula,Haryana,2018-06-01,2614,260,2354,200,7
Dengue,Panchkula,Haryana,2018-07-01,2634,243,2391,26,2
Dengue,Panchkula,Haryana,2018-08-01,1764,76,1688,142,4
Dengue,Panchkula,Haryana,2018-09-01,2100,80,2020,165,4
Dengue,Panchkula,Haryana,2018-10-01,2288,90,2198,157,6
Dengue,Panchkula,Haryana,2018-11-01,3684,82,3602,93,1
Dengue,Panchkula,Haryana,2018-12-01,2398,241,2157,37,3
Dengue,Panchkula,Haryana,2019-01-01,3704,76,3628,185,7
Dengue,Panchkula,Haryana,2019-02-01,3383,254,3129,82,1
Dengue,Panchkula,Haryana,2019-03-01,3364,236,3128,91,4
Dengue,Panchkula,Haryana,2019-04-01,4459,183,4276,200,1
Dengue,Panchkula,Haryana,2019-05-01,1096,112,984,41,7
Dengue,Panchkula,Haryana,2019-06-01,1963,9,1954,148,6
Dengue,Panchkula,Haryana,2019-07-01,4963,236,4727,68,1
Dengue,Panchkula,Haryana,2019-08-01,2252,80,2172,67,2
Dengue,Panchkula,Haryana,2019-09-01,78,0,78,115,5
Dengue,Panchkula,Haryana,2019-10-01,2325,140,2185,141,1
Dengue,Panchkula,Haryana,2019-11-01,2778,0,2778,155,2
Dengue,Panchkula,Haryana,2019-12-01,78,0,78,161,2
Dengue,Panchkula,Haryana,2020-01-01,4387,281,4106,70,9
Dengue,Panchkula,Haryana,2020-02-01,1640,32,1608,48,3
Dengue,Panchkula,Haryana,2020-03-01,3038,121,2917,89,7
Dengue,Panchkula,Haryana,2020-04-01,2294,28,2266,124,3
Dengue,Panchkula,Haryana,2020-05-01,869,39,830,96,7
Dengue,Panchkula,Haryana,2020-06-01,1161,63,1098,11,1
Dengue,Panchkula,Haryana,2020-07-01,1343,54,1289,13,3
Dengue,Panchkula,Haryana,2020-08-01,4054,149,3905,94,5
Dengue,Panchkula,Haryana,2020-09-01,2399,7,2392,150,5
Dengue,Panchkula,Haryana,2020-10-01,1897,113,1784,60,6
Dengue,Panchkula,Haryana,2020-11-01,1344,0,1344,144,5
Dengue,Panchkula,Haryana,2020-12-01,4202,214,3988,30,6
Dengue,Panchkula,Haryana,2021-01-01,4562,0,4562,119,5
Dengue,Panchkula,Haryana,2021-02-01,4187,215,3972,120,5
Dengue,Panchkula,Haryana,2021-03-01,3258,162,3096,130,2
Dengue,Panchkula,Haryana,2021-04-01,2986,184,2802,55,1
Dengue,Panchkula,Haryana,2021-05-01,966,72,894,27,2
Dengue,Panchkula,Haryana,2021-06-01,2268,182,2086,143,1
Dengue,Panchkula,Haryana,2021-07-01,1680,5,1675,28,5
Dengue,Panchkula,Haryana,2021-08-01,148,7,141,67,8
Dengue,Panchkula,Haryana,2021-09-01,4015,436,3579,177,2
Dengue,Panchkula,Haryana,2021-10-01,1664,89,1575,115,8
Dengue,Panchkula,Haryana,2021-11-01,4202,108,4094,125,6
Dengue,Panchkula,Haryana,2021-12-01,3780,180,3600,138,3
Dengue,Panchkula,Haryana,2022-01-01,3344,130,3214,136,4
Dengue,Panchkula,Haryana,2022-02-01,3420,54,3366,105,8
Dengue,Panchkula,Haryana,2022-03-01,1772,133,1639,60,1
Dengue,Panchkula,Haryana,2022-04-01,4989,334,4655,200,8
Dengue,Panchkula,Haryana,2022-05-01,2655,29,2626,91,7
Dengue,Panchkula,Haryana,2022-06-01,3002,142,2860,123,3
Dengue,Panchkula,Haryana,2022-07-01,1727,58,1669,129,5
Dengue,Panchkula,Haryana,2022-08-01,1348,4,1344,79,10
Dengue,Panchkula,Haryana,2022-09-01,3238,28,3210,85,1
Dengue,Panchkula,Haryana,2022-10-01,2889,38,2851,182,4
Dengue,Panchkula,Haryana,2022-11-01,1538,74,1464,69,7
Dengue,Panchkula,Haryana,2022-12-01,668,24,644,127,5
Dengue,Panchkula,Haryana,2023-01-01,894,19,875,152,5
Dengue,Panchkula,Haryana,2023-02-01,4202,162,4040,95,10
Dengue,Panchkula,Haryana,2023-03-01,1775,127,1648,101,2
Dengue,Panchkula,Haryana,2023-04-01,2143,129,2014,155,2
Dengue,Panchkula,Haryana,2023-05-01,4543,359,4184,99,1
Dengue,Panchkula,Haryana,2023-06-01,1092,47,1045,11,2
Dengue,Panchkula,Haryana,2023-07-01,1622,156,1466,183,3
Dengue,Panchkula,Haryana,2023-08-01,1566,94,1472,57,6
Dengue,Panchkula,Haryana,2023-09-01,4768,170,4598,117,8
Dengue,Panchkula,Haryana,2023-10-01,4989,263,4726,39,2
Dengue,Panchkula,Haryana,2023-11-01,3606,49,3557,80,4
Dengue,Panchkula,Haryana,2023-12-01,3648,150,3498,84,9
Dengue,Panchkula,Haryana,2024-01-01,1819,113,1706,115,4
Dengue,Panchkula,Haryana,2024-02-01,4989,338,4651,62,6
Dengue,Panchkula,Haryana,2024-03-01,2957,112,2845,200,8
Dengue,Panchkula,Haryana,2024-04-01,3742,442,3300,107,2
Dengue,Panchkula,Haryana,2024-05-01,2456,110,2346,151,2
Dengue,Panchkula,Haryana,2024-06-01,2238,2,2236,106,10
Dengue,Panchkula,Haryana,2024-07-01,4828,412,4416,157,7
Dengue,Panchkula,Haryana,2024-08-01,3321,224,3097,11,1
Dengue,Panchkula,Haryana,2024-09-01,4544,258,4286,70,2
Dengue,Panchkula,Haryana,2024-10-01,2940,107,2833,80,4
Dengue,Panchkula,Haryana,2024-11-01,1459,89,1370,79,9
Dengue,Panchkula,Haryana,2024-12-01,1815,176,1639,133,8
Dengue,Panchkula,Haryana,2025-01-01,2736,153,2583,136,8
Dengue,Panchkula,Haryana,2025-02-01,1757,12,1745,102,4
Dengue,Panchkula,Haryana,2025-03-01,1112,0,1112,104,5
Dengue,Panchkula,Haryana,2025-04-01,4209,257,3952,200,3
Dengue,Panchkula,Haryana,2025-05-01,1866,39,1827,123,4
Dengue,Panchkula,Haryana,2025-06-01,2783,131,2652,11,2
Dengue,Panchkula,Haryana,2025-07-01,2995,79,2916,145,2
Dengue,Panchkula,Haryana,2025-08-01,1808,44,1764,135,3
Dengue,Panchkula,Haryana,2025-09-01,4544,126,4418,165,4
Dengue,Panchkula,Haryana,2025-10-01,1099,33,1066,137,6
Dengue,Panchkula,Haryana,2025-11-01,2948,214,2734,60,10
Dengue,Panchkula,Haryana,2025-12-01,2928,195,2733,152,4
